,id,round_number,owner,name,timestamp,body,balance,tick_number,n_transactions,participant_code,session_code,treatment,player.intermediary_payoff,player.inner_name,round_starts,price,price_shift,trade_direction,capital_gains,trades_within_tick,prev_name,duplicate_order,first_trade,filtered_prob,optimal_trade_count,red_alert,green_alert,player.block_name,player.age,player.payoff,player.gender,player.course_financial,player.trading_experience,player.online_trading_experience,round_block,gamified,salient,ingame_experience,accuracy_pred_zero,player.knowledge,overconfidence,PGR,PLR,PGR_alerts,PLR_alerts,prediction,prediction_accuracy,prediction_confidence,player.sr_prefs,player.sr_better_decs,player.sr_better_have_option,player.sr_notifications,player.sr_badges,player.sr_confetti
0,5293,2,Player object (1525),sell,2023-03-10 13:33:41.744346+00:00,"{""priceA"": 85, ""sharesA"": 0, ""secs_since_round_starts"": 52, ""market"": ""A""}",135.0,8.0,1.0,0nyvn1ih,t7od4xlw,FULL STUDY,215.0,s1,1,85,,1,,1,,0,sell,0.4422758127435268,16,1,0,block 1 (G first),23.0,12.0,Male,1.0,1.0,1.0,"[2, 'block 1 (G first)']",1,0,0,1.0,7.0,-0.30000000000000004,0.3,0.16666666666666666,0.0,0.5,4,1.0,1.0,Design 1,Design 1,Only trade on Design #1,,2.0,2.0
1,5295,2,Player object (1525),buy,2023-03-10 13:33:54.010008+00:00,"{""priceA"": 75, ""sharesA"": 1, ""secs_since_round_starts"": 64, ""market"": ""A""}",60.0,10.0,2.0,0nyvn1ih,t7od4xlw,FULL STUDY,215.0,s1,1,75,85.0,-1,,1,sell,0,sell,0.4825575314143953,16,0,0,block 1 (G first),23.0,12.0,Male,1.0,1.0,1.0,"[2, 'block 1 (G first)']",1,0,0,1.0,7.0,-0.30000000000000004,0.3,0.16666666666666666,0.0,0.5,4,1.0,1.0,Design 1,Design 1,Only trade on Design #1,,2.0,2.0
2,5301,2,Player object (1525),sell,2023-03-10 13:34:24.307743+00:00,"{""priceA"": 105, ""sharesA"": 0, ""secs_since_round_starts"": 95, ""market"": ""A""}",165.0,16.0,3.0,0nyvn1ih,t7od4xlw,FULL STUDY,215.0,s1,1,105,75.0,1,30.0,1,buy,0,sell,0.5185790363913291,16,0,0,block 1 (G first),23.0,12.0,Male,1.0,1.0,1.0,"[2, 'block 1 (G first)']",1,0,0,1.0,7.0,-0.30000000000000004,0.3,0.16666666666666666,0.0,0.5,4,1.0,1.0,Design 1,Design 1,Only trade on Design #1,,2.0,2.0
3,5304,2,Player object (1525),buy,2023-03-10 13:34:43.918100+00:00,"{""priceA"": 130, ""sharesA"": 1, ""secs_since_round_starts"": 114, ""market"": ""A""}",35.0,19.0,4.0,0nyvn1ih,t7od4xlw,FULL STUDY,215.0,s1,1,130,105.0,-1,,1,sell,0,sell,0.5813773703663461,16,0,1,block 1 (G first),23.0,12.0,Male,1.0,1.0,1.0,"[2, 'block 1 (G first)']",1,0,0,1.0,7.0,-0.30000000000000004,0.3,0.16666666666666666,0.0,0.5,4,1.0,1.0,Design 1,Design 1,Only trade on Design #1,,2.0,2.0
4,5307,2,Player object (1525),sell,2023-03-10 13:35:16.056969+00:00,"{""priceA"": 145, ""sharesA"": 0, ""secs_since_round_starts"": 147, ""market"": ""A""}",180.0,25.0,5.0,0nyvn1ih,t7od4xlw,FULL STUDY,215.0,s1,1,145,130.0,1,15.0,1,buy,0,sell,0.5294358264188312,16,0,0,block 1 (G first),23.0,12.0,Male,1.0,1.0,1.0,"[2, 'block 1 (G first)']",1,0,0,1.0,7.0,-0.30000000000000004,0.3,0.16666666666666666,0.0,0.5,4,1.0,1.0,Design 1,Design 1,Only trade on Design #1,,2.0,2.0
5,5311,2,Player object (1525),buy,2023-03-10 13:35:41.656167+00:00,"{""priceA"": 125, ""sharesA"": 1, ""secs_since_round_starts"": 172, ""market"": ""A""}",55.0,30.0,6.0,0nyvn1ih,t7od4xlw,FULL STUDY,215.0,s1,1,125,145.0,-1,,1,sell,0,sell,0.4785999259850118,16,0,0,block 1 (G first),23.0,12.0,Male,1.0,1.0,1.0,"[2, 'block 1 (G first)']",1,0,0,1.0,7.0,-0.30000000000000004,0.3,0.16666666666666666,0.0,0.5,4,1.0,1.0,Design 1,Design 1,Only trade on Design #1,,2.0,2.0
6,5314,2,Player object (1525),sell,2023-03-10 13:36:04.692250+00:00,"{""priceA"": 125, ""sharesA"": 0, ""secs_since_round_starts"": 195, ""market"": ""A""}",180.0,34.0,7.0,0nyvn1ih,t7od4xlw,FULL STUDY,215.0,s1,1,125,125.0,1,0.0,1,buy,0,sell,0.4644502626891607,16,0,0,block 1 (G first),23.0,12.0,Male,1.0,1.0,1.0,"[2, 'block 1 (G first)']",1,0,0,1.0,7.0,-0.30000000000000004,0.3,0.16666666666666666,0.0,0.5,4,1.0,1.0,Design 1,Design 1,Only trade on Design #1,,2.0,2.0
7,5315,2,Player object (1525),buy,2023-03-10 13:36:12.452502+00:00,"{""priceA"": 140, ""sharesA"": 1, ""secs_since_round_starts"": 203, ""market"": ""A""}",40.0,35.0,8.0,0nyvn1ih,t7od4xlw,FULL STUDY,215.0,s1,1,140,125.0,-1,,1,sell,0,sell,0.5101876173062244,16,0,0,block 1 (G first),23.0,12.0,Male,1.0,1.0,1.0,"[2, 'block 1 (G first)']",1,0,0,1.0,7.0,-0.30000000000000004,0.3,0.16666666666666666,0.0,0.5,4,1.0,1.0,Design 1,Design 1,Only trade on Design #1,,2.0,2.0
8,5317,2,Player object (1525),sell,2023-03-10 13:36:21.360675+00:00,"{""priceA"": 145, ""sharesA"": 0, ""secs_since_round_starts"": 212, ""market"": ""A""}",185.0,37.0,9.0,0nyvn1ih,t7od4xlw,FULL STUDY,215.0,s1,1,145,140.0,1,5.0,1,buy,0,sell,0.494384744736363,16,0,0,block 1 (G first),23.0,12.0,Male,1.0,1.0,1.0,"[2, 'block 1 (G first)']",1,0,0,1.0,7.0,-0.30000000000000004,0.3,0.16666666666666666,0.0,0.5,4,1.0,1.0,Design 1,Design 1,Only trade on Design #1,,2.0,2.0
9,5319,2,Player object (1525),buy,2023-03-10 13:36:54.092388+00:00,"{""priceA"": 125, ""sharesA"": 1, ""secs_since_round_starts"": 244, ""market"": ""A""}",60.0,43.0,10.0,0nyvn1ih,t7od4xlw,FULL STUDY,215.0,s1,1,125,145.0,-1,,1,sell,0,sell,0.4218732662739463,16,1,0,block 1 (G first),23.0,12.0,Male,1.0,1.0,1.0,"[2, 'block 1 (G first)']",1,0,0,1.0,7.0,-0.30000000000000004,0.3,0.16666666666666666,0.0,0.5,4,1.0,1.0,Design 1,Design 1,Only trade on Design #1,,2.0,2.0
10,5321,2,Player object (1525),sell,2023-03-10 13:37:03.674339+00:00,"{""priceA"": 130, ""sharesA"": 0, ""secs_since_round_starts"": 254, ""market"": ""A""}",190.0,44.0,11.0,0nyvn1ih,t7od4xlw,FULL STUDY,215.0,s1,1,130,125.0,1,5.0,1,buy,0,sell,0.4799987600827208,16,0,0,block 1 (G first),23.0,12.0,Male,1.0,1.0,1.0,"[2, 'block 1 (G first)']",1,0,0,1.0,7.0,-0.30000000000000004,0.3,0.16666666666666666,0.0,0.5,4,1.0,1.0,Design 1,Design 1,Only trade on Design #1,,2.0,2.0
11,5323,2,Player object (1525),buy,2023-03-10 13:37:08.845605+00:00,"{""priceA"": 140, ""sharesA"": 1, ""secs_since_round_starts"": 259, ""market"": ""A""}",50.0,45.0,12.0,0nyvn1ih,t7od4xlw,FULL STUDY,215.0,s1,1,140,130.0,-1,,1,sell,0,sell,0.5210834711709403,16,0,0,block 1 (G first),23.0,12.0,Male,1.0,1.0,1.0,"[2, 'block 1 (G first)']",1,0,0,1.0,7.0,-0.30000000000000004,0.3,0.16666666666666666,0.0,0.5,4,1.0,1.0,Design 1,Design 1,Only trade on Design #1,,2.0,2.0
12,5326,2,Player object (1525),sell,2023-03-10 13:37:25.692355+00:00,"{""priceA"": 155, ""sharesA"": 0, ""secs_since_round_starts"": 276, ""market"": ""A""}",205.0,48.0,13.0,0nyvn1ih,t7od4xlw,FULL STUDY,215.0,s1,1,155,140.0,1,15.0,1,buy,0,sell,0.5347792584548927,16,0,0,block 1 (G first),23.0,12.0,Male,1.0,1.0,1.0,"[2, 'block 1 (G first)']",1,0,0,1.0,7.0,-0.30000000000000004,0.3,0.16666666666666666,0.0,0.5,4,1.0,1.0,Design 1,Design 1,Only trade on Design #1,,2.0,2.0
13,5327,2,Player object (1525),buy,2023-03-10 13:37:47.651306+00:00,"{""priceA"": 125, ""sharesA"": 1, ""secs_since_round_starts"": 298, ""market"": ""A""}",80.0,52.0,14.0,0nyvn1ih,t7od4xlw,FULL STUDY,215.0,s1,1,125,155.0,-1,,1,sell,0,sell,0.4439176376077041,16,1,0,block 1 (G first),23.0,12.0,Male,1.0,1.0,1.0,"[2, 'block 1 (G first)']",1,0,0,1.0,7.0,-0.30000000000000004,0.3,0.16666666666666666,0.0,0.5,4,1.0,1.0,Design 1,Design 1,Only trade on Design #1,,2.0,2.0
14,5329,2,Player object (1525),sell,2023-03-10 13:37:53.379953+00:00,"{""priceA"": 135, ""sharesA"": 0, ""secs_since_round_starts"": 304, ""market"": ""A""}",215.0,53.0,15.0,0nyvn1ih,t7od4xlw,FULL STUDY,215.0,s1,1,135,125.0,1,10.0,1,buy,0,sell,0.4956940487416096,16,0,0,block 1 (G first),23.0,12.0,Male,1.0,1.0,1.0,"[2, 'block 1 (G first)']",1,0,0,1.0,7.0,-0.30000000000000004,0.3,0.16666666666666666,0.0,0.5,4,1.0,1.0,Design 1,Design 1,Only trade on Design #1,,2.0,2.0
15,5331,2,Player object (1525),buy,2023-03-10 13:38:13.284002+00:00,"{""priceA"": 125, ""sharesA"": 1, ""secs_since_round_starts"": 324, ""market"": ""A""}",90.0,56.0,16.0,0nyvn1ih,t7od4xlw,FULL STUDY,215.0,s1,1,125,135.0,-1,,1,sell,0,sell,0.4562406760637778,16,0,0,block 1 (G first),23.0,12.0,Male,1.0,1.0,1.0,"[2, 'block 1 (G first)']",1,0,0,1.0,7.0,-0.30000000000000004,0.3,0.16666666666666666,0.0,0.5,4,1.0,1.0,Design 1,Design 1,Only trade on Design #1,,2.0,2.0
16,5343,3,Player object (1705),sell,2023-03-10 13:39:37.470517+00:00,"{""priceA"": 110, ""sharesA"": 0, ""secs_since_round_starts"": 54, ""market"": ""A""}",160.0,11.0,1.0,0nyvn1ih,t7od4xlw,FULL STUDY,195.0,s1,1,110,,1,,1,,0,sell,0.5295922419004607,19,0,0,block 1 (G first),23.0,12.0,Male,1.0,1.0,1.0,"[3, 'block 1 (G first)']",1,1,0,1.0,7.0,-0.30000000000000004,0.23529411764705882,0.0,0.0,0.0,5,0.75,1.0,Design 1,Design 1,Only trade on Design #1,,2.0,2.0
17,5347,3,Player object (1705),buy,2023-03-10 13:40:03.463624+00:00,"{""priceA"": 100, ""sharesA"": 1, ""secs_since_round_starts"": 80, ""market"": ""A""}",60.0,16.0,2.0,0nyvn1ih,t7od4xlw,FULL STUDY,195.0,s1,1,100,110.0,-1,,1,sell,0,sell,0.4486815727575955,19,1,0,block 1 (G first),23.0,12.0,Male,1.0,1.0,1.0,"[3, 'block 1 (G first)']",1,1,0,1.0,7.0,-0.30000000000000004,0.23529411764705882,0.0,0.0,0.0,5,0.75,1.0,Design 1,Design 1,Only trade on Design #1,,2.0,2.0
18,5356,3,Player object (1705),sell,2023-03-10 13:41:13.243740+00:00,"{""priceA"": 110, ""sharesA"": 0, ""secs_since_round_starts"": 150, ""market"": ""A""}",170.0,28.0,3.0,0nyvn1ih,t7od4xlw,FULL STUDY,195.0,s1,1,110,100.0,1,10.0,1,buy,0,sell,0.5233413838959273,19,0,0,block 1 (G first),23.0,12.0,Male,1.0,1.0,1.0,"[3, 'block 1 (G first)']",1,1,0,1.0,7.0,-0.30000000000000004,0.23529411764705882,0.0,0.0,0.0,5,0.75,1.0,Design 1,Design 1,Only trade on Design #1,,2.0,2.0
19,5363,3,Player object (1705),buy,2023-03-10 13:41:37.096391+00:00,"{""priceA"": 100, ""sharesA"": 1, ""secs_since_round_starts"": 174, ""market"": ""A""}",70.0,33.0,4.0,0nyvn1ih,t7od4xlw,FULL STUDY,195.0,s1,1,100,110.0,-1,,1,sell,0,sell,0.4476889957041811,19,1,0,block 1 (G first),23.0,12.0,Male,1.0,1.0,1.0,"[3, 'block 1 (G first)']",1,1,0,1.0,7.0,-0.30000000000000004,0.23529411764705882,0.0,0.0,0.0,5,0.75,1.0,Design 1,Design 1,Only trade on Design #1,,2.0,2.0
20,5371,3,Player object (1705),sell,2023-03-10 13:42:31.990745+00:00,"{""priceA"": 120, ""sharesA"": 0, ""secs_since_round_starts"": 229, ""market"": ""A""}",190.0,43.0,5.0,0nyvn1ih,t7od4xlw,FULL STUDY,195.0,s1,1,120,100.0,1,20.0,1,buy,0,sell,0.5357259670782416,19,0,0,block 1 (G first),23.0,12.0,Male,1.0,1.0,1.0,"[3, 'block 1 (G first)']",1,1,0,1.0,7.0,-0.30000000000000004,0.23529411764705882,0.0,0.0,0.0,5,0.75,1.0,Design 1,Design 1,Only trade on Design #1,,2.0,2.0
21,5379,3,Player object (1705),buy,2023-03-10 13:43:22.447269+00:00,"{""priceA"": 115, ""sharesA"": 1, ""secs_since_round_starts"": 279, ""market"": ""A""}",75.0,52.0,6.0,0nyvn1ih,t7od4xlw,FULL STUDY,195.0,s1,1,115,120.0,-1,,1,sell,0,sell,0.4367228334197354,19,0,0,block 1 (G first),23.0,12.0,Male,1.0,1.0,1.0,"[3, 'block 1 (G first)']",1,1,0,1.0,7.0,-0.30000000000000004,0.23529411764705882,0.0,0.0,0.0,5,0.75,1.0,Design 1,Design 1,Only trade on Design #1,,2.0,2.0
22,5381,3,Player object (1705),sell,2023-03-10 13:43:25.772417+00:00,"{""priceA"": 130, ""sharesA"": 0, ""secs_since_round_starts"": 283, ""market"": ""A""}",205.0,53.0,7.0,0nyvn1ih,t7od4xlw,FULL STUDY,195.0,s1,1,130,115.0,1,15.0,1,buy,0,sell,0.4905868559773416,19,0,0,block 1 (G first),23.0,12.0,Male,1.0,1.0,1.0,"[3, 'block 1 (G first)']",1,1,0,1.0,7.0,-0.30000000000000004,0.23529411764705882,0.0,0.0,0.0,5,0.75,1.0,Design 1,Design 1,Only trade on Design #1,,2.0,2.0
23,5384,3,Player object (1705),buy,2023-03-10 13:44:00.252421+00:00,"{""priceA"": 125, ""sharesA"": 1, ""secs_since_round_starts"": 317, ""market"": ""A""}",80.0,59.0,8.0,0nyvn1ih,t7od4xlw,FULL STUDY,195.0,s1,1,125,130.0,-1,,1,sell,0,sell,0.4946618842475483,19,0,0,block 1 (G first),23.0,12.0,Male,1.0,1.0,1.0,"[3, 'block 1 (G first)']",1,1,0,1.0,7.0,-0.30000000000000004,0.23529411764705882,0.0,0.0,0.0,5,0.75,1.0,Design 1,Design 1,Only trade on Design #1,,2.0,2.0
24,5390,4,Player object (1885),sell,2023-03-10 13:45:19.528519+00:00,"{""priceA"": 75, ""sharesA"": 0, ""secs_since_round_starts"": 67, ""market"": ""A""}",125.0,13.0,1.0,0nyvn1ih,t7od4xlw,FULL STUDY,190.0,s1,1,75,,1,,1,,0,sell,0.479681559969247,14,0,0,block 1 (G first),23.0,12.0,Male,1.0,1.0,1.0,"[4, 'block 1 (G first)']",0,0,0,1.0,7.0,-0.30000000000000004,0.4444444444444444,0.041666666666666664,0.5,0.0,5,0.25,1.0,Design 1,Design 1,Only trade on Design #1,,2.0,2.0
25,5392,4,Player object (1885),buy,2023-03-10 13:45:46.274788+00:00,"{""priceA"": 70, ""sharesA"": 1, ""secs_since_round_starts"": 93, ""market"": ""A""}",55.0,18.0,2.0,0nyvn1ih,t7od4xlw,FULL STUDY,190.0,s1,1,70,75.0,-1,,1,sell,0,sell,0.4407118028401492,14,1,0,block 1 (G first),23.0,12.0,Male,1.0,1.0,1.0,"[4, 'block 1 (G first)']",0,0,0,1.0,7.0,-0.30000000000000004,0.4444444444444444,0.041666666666666664,0.5,0.0,5,0.25,1.0,Design 1,Design 1,Only trade on Design #1,,2.0,2.0
26,5393,4,Player object (1885),sell,2023-03-10 13:45:51.160543+00:00,"{""priceA"": 85, ""sharesA"": 0, ""secs_since_round_starts"": 98, ""market"": ""A""}",140.0,19.0,3.0,0nyvn1ih,t7od4xlw,FULL STUDY,190.0,s1,1,85,70.0,1,15.0,1,buy,0,sell,0.4934202415852731,14,0,0,block 1 (G first),23.0,12.0,Male,1.0,1.0,1.0,"[4, 'block 1 (G first)']",0,0,0,1.0,7.0,-0.30000000000000004,0.4444444444444444,0.041666666666666664,0.5,0.0,5,0.25,1.0,Design 1,Design 1,Only trade on Design #1,,2.0,2.0
27,5394,4,Player object (1885),buy,2023-03-10 13:45:56.459836+00:00,"{""priceA"": 70, ""sharesA"": 1, ""secs_since_round_starts"": 104, ""market"": ""A""}",70.0,20.0,4.0,0nyvn1ih,t7od4xlw,FULL STUDY,190.0,s1,1,70,85.0,-1,,1,sell,0,sell,0.4604462199730844,14,0,0,block 1 (G first),23.0,12.0,Male,1.0,1.0,1.0,"[4, 'block 1 (G first)']",0,0,0,1.0,7.0,-0.30000000000000004,0.4444444444444444,0.041666666666666664,0.5,0.0,5,0.25,1.0,Design 1,Design 1,Only trade on Design #1,,2.0,2.0
28,5398,4,Player object (1885),sell,2023-03-10 13:47:02.530280+00:00,"{""priceA"": 95, ""sharesA"": 0, ""secs_since_round_starts"": 170, ""market"": ""A""}",165.0,32.0,6.0,0nyvn1ih,t7od4xlw,FULL STUDY,190.0,s1,1,95,55.0,1,40.0,1,buy,0,sell,0.5179404569050043,14,0,0,block 1 (G first),23.0,12.0,Male,1.0,1.0,1.0,"[4, 'block 1 (G first)']",0,0,0,1.0,7.0,-0.30000000000000004,0.4444444444444444,0.041666666666666664,0.5,0.0,5,0.25,1.0,Design 1,Design 1,Only trade on Design #1,,2.0,2.0
29,5399,4,Player object (1885),buy,2023-03-10 13:47:34.944968+00:00,"{""priceA"": 65, ""sharesA"": 1, ""secs_since_round_starts"": 202, ""market"": ""A""}",100.0,38.0,7.0,0nyvn1ih,t7od4xlw,FULL STUDY,190.0,s1,1,65,95.0,-1,,1,sell,0,sell,0.4355009867455686,14,1,0,block 1 (G first),23.0,12.0,Male,1.0,1.0,1.0,"[4, 'block 1 (G first)']",0,0,0,1.0,7.0,-0.30000000000000004,0.4444444444444444,0.041666666666666664,0.5,0.0,5,0.25,1.0,Design 1,Design 1,Only trade on Design #1,,2.0,2.0
30,5400,4,Player object (1885),sell,2023-03-10 13:47:40.112838+00:00,"{""priceA"": 80, ""sharesA"": 0, ""secs_since_round_starts"": 207, ""market"": ""A""}",180.0,39.0,8.0,0nyvn1ih,t7od4xlw,FULL STUDY,190.0,s1,1,80,65.0,1,15.0,1,buy,0,sell,0.4897180556691627,14,0,0,block 1 (G first),23.0,12.0,Male,1.0,1.0,1.0,"[4, 'block 1 (G first)']",0,0,0,1.0,7.0,-0.30000000000000004,0.4444444444444444,0.041666666666666664,0.5,0.0,5,0.25,1.0,Design 1,Design 1,Only trade on Design #1,,2.0,2.0
31,5401,4,Player object (1885),buy,2023-03-10 13:48:15.035905+00:00,"{""priceA"": 100, ""sharesA"": 1, ""secs_since_round_starts"": 242, ""market"": ""A""}",80.0,45.0,9.0,0nyvn1ih,t7od4xlw,FULL STUDY,190.0,s1,1,100,80.0,-1,,1,sell,0,sell,0.5193741863096629,14,0,0,block 1 (G first),23.0,12.0,Male,1.0,1.0,1.0,"[4, 'block 1 (G first)']",0,0,0,1.0,7.0,-0.30000000000000004,0.4444444444444444,0.041666666666666664,0.5,0.0,5,0.25,1.0,Design 1,Design 1,Only trade on Design #1,,2.0,2.0
32,5402,4,Player object (1885),sell,2023-03-10 13:48:45.187571+00:00,"{""priceA"": 120, ""sharesA"": 0, ""secs_since_round_starts"": 272, ""market"": ""A""}",200.0,50.0,10.0,0nyvn1ih,t7od4xlw,FULL STUDY,190.0,s1,1,120,100.0,1,20.0,1,buy,0,sell,0.5591364702939366,14,0,1,block 1 (G first),23.0,12.0,Male,1.0,1.0,1.0,"[4, 'block 1 (G first)']",0,0,0,1.0,7.0,-0.30000000000000004,0.4444444444444444,0.041666666666666664,0.5,0.0,5,0.25,1.0,Design 1,Design 1,Only trade on Design #1,,2.0,2.0
33,5403,4,Player object (1885),buy,2023-03-10 13:49:06.714391+00:00,"{""priceA"": 85, ""sharesA"": 1, ""secs_since_round_starts"": 294, ""market"": ""A""}",115.0,54.0,11.0,0nyvn1ih,t7od4xlw,FULL STUDY,190.0,s1,1,85,120.0,-1,,1,sell,0,sell,0.4957421237757241,14,0,0,block 1 (G first),23.0,12.0,Male,1.0,1.0,1.0,"[4, 'block 1 (G first)']",0,0,0,1.0,7.0,-0.30000000000000004,0.4444444444444444,0.041666666666666664,0.5,0.0,5,0.25,1.0,Design 1,Design 1,Only trade on Design #1,,2.0,2.0
34,5407,5,Player object (2065),sell,2023-03-10 13:51:32.560397+00:00,"{""priceA"": 105, ""sharesA"": 0, ""secs_since_round_starts"": 106, ""market"": ""A""}",155.0,21.0,1.0,0nyvn1ih,t7od4xlw,FULL STUDY,225.0,s1,1,105,,1,,1,,0,sell,0.5510362930796925,17,0,1,block 1 (G first),23.0,12.0,Male,1.0,1.0,1.0,"[5, 'block 1 (G first)']",0,1,0,1.0,7.0,-0.30000000000000004,0.2857142857142857,0.0,0.6666666666666666,0.0,5,0.25,1.0,Design 1,Design 1,Only trade on Design #1,,2.0,2.0
35,5408,5,Player object (2065),buy,2023-03-10 13:52:16.484726+00:00,"{""priceA"": 80, ""sharesA"": 1, ""secs_since_round_starts"": 150, ""market"": ""A""}",75.0,29.0,2.0,0nyvn1ih,t7od4xlw,FULL STUDY,225.0,s1,1,80,105.0,-1,,1,sell,0,sell,0.4304345659865384,17,0,0,block 1 (G first),23.0,12.0,Male,1.0,1.0,1.0,"[5, 'block 1 (G first)']",0,1,0,1.0,7.0,-0.30000000000000004,0.2857142857142857,0.0,0.6666666666666666,0.0,5,0.25,1.0,Design 1,Design 1,Only trade on Design #1,,2.0,2.0
36,5410,5,Player object (2065),sell,2023-03-10 13:52:44.757031+00:00,"{""priceA"": 110, ""sharesA"": 0, ""secs_since_round_starts"": 178, ""market"": ""A""}",185.0,33.0,3.0,0nyvn1ih,t7od4xlw,FULL STUDY,225.0,s1,1,110,80.0,1,30.0,1,buy,0,sell,0.5480287979668599,17,0,1,block 1 (G first),23.0,12.0,Male,1.0,1.0,1.0,"[5, 'block 1 (G first)']",0,1,0,1.0,7.0,-0.30000000000000004,0.2857142857142857,0.0,0.6666666666666666,0.0,5,0.25,1.0,Design 1,Design 1,Only trade on Design #1,,2.0,2.0
37,5411,5,Player object (2065),buy,2023-03-10 13:53:17.141333+00:00,"{""priceA"": 70, ""sharesA"": 1, ""secs_since_round_starts"": 210, ""market"": ""A""}",115.0,39.0,4.0,0nyvn1ih,t7od4xlw,FULL STUDY,225.0,s1,1,70,110.0,-1,,1,sell,0,sell,0.4317803147869401,17,0,0,block 1 (G first),23.0,12.0,Male,1.0,1.0,1.0,"[5, 'block 1 (G first)']",0,1,0,1.0,7.0,-0.30000000000000004,0.2857142857142857,0.0,0.6666666666666666,0.0,5,0.25,1.0,Design 1,Design 1,Only trade on Design #1,,2.0,2.0
38,5412,5,Player object (2065),sell,2023-03-10 13:53:56.600833+00:00,"{""priceA"": 95, ""sharesA"": 0, ""secs_since_round_starts"": 250, ""market"": ""A""}",210.0,46.0,5.0,0nyvn1ih,t7od4xlw,FULL STUDY,225.0,s1,1,95,70.0,1,25.0,1,buy,0,sell,0.4967862103563366,17,0,0,block 1 (G first),23.0,12.0,Male,1.0,1.0,1.0,"[5, 'block 1 (G first)']",0,1,0,1.0,7.0,-0.30000000000000004,0.2857142857142857,0.0,0.6666666666666666,0.0,5,0.25,1.0,Design 1,Design 1,Only trade on Design #1,,2.0,2.0
39,5413,5,Player object (2065),buy,2023-03-10 13:54:07.606989+00:00,"{""priceA"": 75, ""sharesA"": 1, ""secs_since_round_starts"": 261, ""market"": ""A""}",135.0,48.0,6.0,0nyvn1ih,t7od4xlw,FULL STUDY,225.0,s1,1,75,95.0,-1,,1,sell,0,sell,0.4393932183506925,17,1,0,block 1 (G first),23.0,12.0,Male,1.0,1.0,1.0,"[5, 'block 1 (G first)']",0,1,0,1.0,7.0,-0.30000000000000004,0.2857142857142857,0.0,0.6666666666666666,0.0,5,0.25,1.0,Design 1,Design 1,Only trade on Design #1,,2.0,2.0
40,5414,5,Player object (2065),sell,2023-03-10 13:54:30.544402+00:00,"{""priceA"": 95, ""sharesA"": 0, ""secs_since_round_starts"": 284, ""market"": ""A""}",230.0,52.0,7.0,0nyvn1ih,t7od4xlw,FULL STUDY,225.0,s1,1,95,75.0,1,20.0,1,buy,0,sell,0.5397855680881701,17,0,0,block 1 (G first),23.0,12.0,Male,1.0,1.0,1.0,"[5, 'block 1 (G first)']",0,1,0,1.0,7.0,-0.30000000000000004,0.2857142857142857,0.0,0.6666666666666666,0.0,5,0.25,1.0,Design 1,Design 1,Only trade on Design #1,,2.0,2.0
41,5415,5,Player object (2065),buy,2023-03-10 13:55:06.657188+00:00,"{""priceA"": 70, ""sharesA"": 1, ""secs_since_round_starts"": 320, ""market"": ""A""}",160.0,59.0,8.0,0nyvn1ih,t7od4xlw,FULL STUDY,225.0,s1,1,70,95.0,-1,,1,sell,0,sell,0.4327023062729965,17,1,0,block 1 (G first),23.0,12.0,Male,1.0,1.0,1.0,"[5, 'block 1 (G first)']",0,1,0,1.0,7.0,-0.30000000000000004,0.2857142857142857,0.0,0.6666666666666666,0.0,5,0.25,1.0,Design 1,Design 1,Only trade on Design #1,,2.0,2.0
42,5223,2,Player object (1518),sell,2023-03-10 13:20:15.032401+00:00,"{""priceA"": 85, ""sharesA"": 0, ""secs_since_round_starts"": 118, ""market"": ""A""}",135.0,11.0,1.0,0ysr1j7s,t7od4xlw,FULL STUDY,185.0,s4,1,85,,1,,1,,0,sell,0.5,0,0,0,block 3 (G second),19.0,8.0,Male,0.0,0.0,0.0,"[2, 'block 3 (G second)']",0,0,1,0.5,2.0,-0.4666666666666666,0.21428571428571427,0.045454545454545456,0.3333333333333333,0.0,4,0.75,0.25,Design 2,Design 2,"Have an option between Design #1 and Design #2,",1.0,,
43,5226,2,Player object (1518),buy,2023-03-10 13:20:29.431898+00:00,"{""priceA"": 70, ""sharesA"": 1, ""secs_since_round_starts"": 133, ""market"": ""A""}",65.0,14.0,2.0,0ysr1j7s,t7od4xlw,FULL STUDY,185.0,s4,1,70,85.0,-1,,1,sell,0,sell,0.5,0,0,0,block 3 (G second),19.0,8.0,Male,0.0,0.0,0.0,"[2, 'block 3 (G second)']",0,0,1,0.5,2.0,-0.4666666666666666,0.21428571428571427,0.045454545454545456,0.3333333333333333,0.0,4,0.75,0.25,Design 2,Design 2,"Have an option between Design #1 and Design #2,",1.0,,
44,5229,2,Player object (1518),sell,2023-03-10 13:21:14.400399+00:00,"{""priceA"": 75, ""sharesA"": 0, ""secs_since_round_starts"": 178, ""market"": ""A""}",140.0,22.0,3.0,0ysr1j7s,t7od4xlw,FULL STUDY,185.0,s4,1,75,70.0,1,5.0,1,buy,0,sell,0.5,0,0,0,block 3 (G second),19.0,8.0,Male,0.0,0.0,0.0,"[2, 'block 3 (G second)']",0,0,1,0.5,2.0,-0.4666666666666666,0.21428571428571427,0.045454545454545456,0.3333333333333333,0.0,4,0.75,0.25,Design 2,Design 2,"Have an option between Design #1 and Design #2,",1.0,,
45,5232,2,Player object (1518),buy,2023-03-10 13:21:31.000206+00:00,"{""priceA"": 70, ""sharesA"": 1, ""secs_since_round_starts"": 194, ""market"": ""A""}",70.0,25.0,4.0,0ysr1j7s,t7od4xlw,FULL STUDY,185.0,s4,1,70,75.0,-1,,1,sell,0,sell,0.5,0,0,0,block 3 (G second),19.0,8.0,Male,0.0,0.0,0.0,"[2, 'block 3 (G second)']",0,0,1,0.5,2.0,-0.4666666666666666,0.21428571428571427,0.045454545454545456,0.3333333333333333,0.0,4,0.75,0.25,Design 2,Design 2,"Have an option between Design #1 and Design #2,",1.0,,
46,5236,2,Player object (1518),sell,2023-03-10 13:21:56.948415+00:00,"{""priceA"": 95, ""sharesA"": 0, ""secs_since_round_starts"": 220, ""market"": ""A""}",165.0,30.0,5.0,0ysr1j7s,t7od4xlw,FULL STUDY,185.0,s4,1,95,70.0,1,25.0,1,buy,0,sell,0.5,0,0,1,block 3 (G second),19.0,8.0,Male,0.0,0.0,0.0,"[2, 'block 3 (G second)']",0,0,1,0.5,2.0,-0.4666666666666666,0.21428571428571427,0.045454545454545456,0.3333333333333333,0.0,4,0.75,0.25,Design 2,Design 2,"Have an option between Design #1 and Design #2,",1.0,,
47,5240,2,Player object (1518),buy,2023-03-10 13:22:42.617071+00:00,"{""priceA"": 75, ""sharesA"": 1, ""secs_since_round_starts"": 266, ""market"": ""A""}",90.0,34.0,6.0,0ysr1j7s,t7od4xlw,FULL STUDY,185.0,s4,1,75,95.0,-1,,1,sell,0,sell,0.5,0,1,0,block 3 (G second),19.0,8.0,Male,0.0,0.0,0.0,"[2, 'block 3 (G second)']",0,0,1,0.5,2.0,-0.4666666666666666,0.21428571428571427,0.045454545454545456,0.3333333333333333,0.0,4,0.75,0.25,Design 2,Design 2,"Have an option between Design #1 and Design #2,",1.0,,
48,5246,2,Player object (1518),sell,2023-03-10 13:24:32.848284+00:00,"{""priceA"": 95, ""sharesA"": 0, ""secs_since_round_starts"": 376, ""market"": ""A""}",185.0,54.0,7.0,0ysr1j7s,t7od4xlw,FULL STUDY,185.0,s4,1,95,75.0,1,20.0,1,buy,0,sell,0.5,0,0,0,block 3 (G second),19.0,8.0,Male,0.0,0.0,0.0,"[2, 'block 3 (G second)']",0,0,1,0.5,2.0,-0.4666666666666666,0.21428571428571427,0.045454545454545456,0.3333333333333333,0.0,4,0.75,0.25,Design 2,Design 2,"Have an option between Design #1 and Design #2,",1.0,,
49,5305,4,Player object (1878),sell,2023-03-10 13:35:10.437543+00:00,"{""priceA"": 140, ""sharesA"": 0, ""secs_since_round_starts"": 51, ""market"": ""A""}",190.0,9.0,1.0,0ysr1j7s,t7od4xlw,FULL STUDY,200.0,s4,1,140,,1,,1,,0,sell,0.5,0,0,0,block 3 (G second),19.0,8.0,Male,0.0,0.0,0.0,"[4, 'block 3 (G second)']",1,0,1,0.5,2.0,-0.4666666666666666,0.2857142857142857,0.023255813953488372,,0.0,5,0.5,1.0,Design 2,Design 2,"Have an option between Design #1 and Design #2,",1.0,,
50,5308,4,Player object (1878),buy,2023-03-10 13:35:16.860366+00:00,"{""priceA"": 135, ""sharesA"": 1, ""secs_since_round_starts"": 58, ""market"": ""A""}",55.0,10.0,2.0,0ysr1j7s,t7od4xlw,FULL STUDY,200.0,s4,1,135,140.0,-1,,1,sell,0,sell,0.5,0,0,0,block 3 (G second),19.0,8.0,Male,0.0,0.0,0.0,"[4, 'block 3 (G second)']",1,0,1,0.5,2.0,-0.4666666666666666,0.2857142857142857,0.023255813953488372,,0.0,5,0.5,1.0,Design 2,Design 2,"Have an option between Design #1 and Design #2,",1.0,,
51,5340,4,Player object (1878),sell,2023-03-10 13:39:22.210003+00:00,"{""priceA"": 130, ""sharesA"": 0, ""secs_since_round_starts"": 303, ""market"": ""A""}",185.0,54.0,3.0,0ysr1j7s,t7od4xlw,FULL STUDY,200.0,s4,1,130,135.0,1,-5.0,1,buy,0,sell,0.5,0,0,0,block 3 (G second),19.0,8.0,Male,0.0,0.0,0.0,"[4, 'block 3 (G second)']",1,0,1,0.5,2.0,-0.4666666666666666,0.2857142857142857,0.023255813953488372,,0.0,5,0.5,1.0,Design 2,Design 2,"Have an option between Design #1 and Design #2,",1.0,,
52,5341,4,Player object (1878),buy,2023-03-10 13:39:31.286887+00:00,"{""priceA"": 120, ""sharesA"": 1, ""secs_since_round_starts"": 312, ""market"": ""A""}",65.0,56.0,4.0,0ysr1j7s,t7od4xlw,FULL STUDY,200.0,s4,1,120,130.0,-1,,1,sell,0,sell,0.5,0,0,0,block 3 (G second),19.0,8.0,Male,0.0,0.0,0.0,"[4, 'block 3 (G second)']",1,0,1,0.5,2.0,-0.4666666666666666,0.2857142857142857,0.023255813953488372,,0.0,5,0.5,1.0,Design 2,Design 2,"Have an option between Design #1 and Design #2,",1.0,,
53,5342,4,Player object (1878),sell,2023-03-10 13:39:36.874591+00:00,"{""priceA"": 135, ""sharesA"": 0, ""secs_since_round_starts"": 318, ""market"": ""A""}",200.0,57.0,5.0,0ysr1j7s,t7od4xlw,FULL STUDY,200.0,s4,1,135,120.0,1,15.0,1,buy,0,sell,0.5,0,0,0,block 3 (G second),19.0,8.0,Male,0.0,0.0,0.0,"[4, 'block 3 (G second)']",1,0,1,0.5,2.0,-0.4666666666666666,0.2857142857142857,0.023255813953488372,,0.0,5,0.5,1.0,Design 2,Design 2,"Have an option between Design #1 and Design #2,",1.0,,
54,5344,4,Player object (1878),buy,2023-03-10 13:39:54.004405+00:00,"{""priceA"": 160, ""sharesA"": 1, ""secs_since_round_starts"": 335, ""market"": ""A""}",40.0,60.0,6.0,0ysr1j7s,t7od4xlw,FULL STUDY,200.0,s4,1,160,135.0,-1,,1,sell,0,sell,0.5,0,0,0,block 3 (G second),19.0,8.0,Male,0.0,0.0,0.0,"[4, 'block 3 (G second)']",1,0,1,0.5,2.0,-0.4666666666666666,0.2857142857142857,0.023255813953488372,,0.0,5,0.5,1.0,Design 2,Design 2,"Have an option between Design #1 and Design #2,",1.0,,
55,5350,5,Player object (2058),sell,2023-03-10 13:40:40.129146+00:00,"{""priceA"": 125, ""sharesA"": 0, ""secs_since_round_starts"": 39, ""market"": ""A""}",175.0,7.0,1.0,0ysr1j7s,t7od4xlw,FULL STUDY,205.0,s4,1,125,,1,,1,,0,sell,0.5,0,0,0,block 3 (G second),19.0,8.0,Male,0.0,0.0,0.0,"[5, 'block 3 (G second)']",1,1,1,1.0,2.0,-0.4666666666666666,0.7272727272727273,0.038461538461538464,0.5,0.2,5,0.5,0.5,Design 2,Design 2,"Have an option between Design #1 and Design #2,",1.0,,
56,5351,5,Player object (2058),buy,2023-03-10 13:40:46.924721+00:00,"{""priceA"": 135, ""sharesA"": 1, ""secs_since_round_starts"": 46, ""market"": ""A""}",40.0,8.0,2.0,0ysr1j7s,t7od4xlw,FULL STUDY,205.0,s4,1,135,125.0,-1,,1,sell,0,sell,0.5,0,0,0,block 3 (G second),19.0,8.0,Male,0.0,0.0,0.0,"[5, 'block 3 (G second)']",1,1,1,1.0,2.0,-0.4666666666666666,0.7272727272727273,0.038461538461538464,0.5,0.2,5,0.5,0.5,Design 2,Design 2,"Have an option between Design #1 and Design #2,",1.0,,
57,5352,5,Player object (2058),sell,2023-03-10 13:40:57.107708+00:00,"{""priceA"": 135, ""sharesA"": 0, ""secs_since_round_starts"": 56, ""market"": ""A""}",175.0,10.0,3.0,0ysr1j7s,t7od4xlw,FULL STUDY,205.0,s4,1,135,135.0,1,0.0,1,buy,0,sell,0.5,0,0,0,block 3 (G second),19.0,8.0,Male,0.0,0.0,0.0,"[5, 'block 3 (G second)']",1,1,1,1.0,2.0,-0.4666666666666666,0.7272727272727273,0.038461538461538464,0.5,0.2,5,0.5,0.5,Design 2,Design 2,"Have an option between Design #1 and Design #2,",1.0,,
58,5354,5,Player object (2058),buy,2023-03-10 13:41:04.544409+00:00,"{""priceA"": 130, ""sharesA"": 1, ""secs_since_round_starts"": 64, ""market"": ""A""}",45.0,11.0,4.0,0ysr1j7s,t7od4xlw,FULL STUDY,205.0,s4,1,130,135.0,-1,,1,sell,0,sell,0.5,0,0,0,block 3 (G second),19.0,8.0,Male,0.0,0.0,0.0,"[5, 'block 3 (G second)']",1,1,1,1.0,2.0,-0.4666666666666666,0.7272727272727273,0.038461538461538464,0.5,0.2,5,0.5,0.5,Design 2,Design 2,"Have an option between Design #1 and Design #2,",1.0,,
59,5357,5,Player object (2058),sell,2023-03-10 13:41:13.896037+00:00,"{""priceA"": 135, ""sharesA"": 0, ""secs_since_round_starts"": 73, ""market"": ""A""}",180.0,13.0,5.0,0ysr1j7s,t7od4xlw,FULL STUDY,205.0,s4,1,135,130.0,1,5.0,1,buy,0,sell,0.5,0,0,0,block 3 (G second),19.0,8.0,Male,0.0,0.0,0.0,"[5, 'block 3 (G second)']",1,1,1,1.0,2.0,-0.4666666666666666,0.7272727272727273,0.038461538461538464,0.5,0.2,5,0.5,0.5,Design 2,Design 2,"Have an option between Design #1 and Design #2,",1.0,,
60,5358,5,Player object (2058),buy,2023-03-10 13:41:20.124517+00:00,"{""priceA"": 140, ""sharesA"": 1, ""secs_since_round_starts"": 79, ""market"": ""A""}",40.0,14.0,6.0,0ysr1j7s,t7od4xlw,FULL STUDY,205.0,s4,1,140,135.0,-1,,1,sell,0,sell,0.5,0,0,0,block 3 (G second),19.0,8.0,Male,0.0,0.0,0.0,"[5, 'block 3 (G second)']",1,1,1,1.0,2.0,-0.4666666666666666,0.7272727272727273,0.038461538461538464,0.5,0.2,5,0.5,0.5,Design 2,Design 2,"Have an option between Design #1 and Design #2,",1.0,,
61,5359,5,Player object (2058),sell,2023-03-10 13:41:24.916371+00:00,"{""priceA"": 145, ""sharesA"": 0, ""secs_since_round_starts"": 84, ""market"": ""A""}",185.0,15.0,7.0,0ysr1j7s,t7od4xlw,FULL STUDY,205.0,s4,1,145,140.0,1,5.0,1,buy,0,sell,0.5,0,0,1,block 3 (G second),19.0,8.0,Male,0.0,0.0,0.0,"[5, 'block 3 (G second)']",1,1,1,1.0,2.0,-0.4666666666666666,0.7272727272727273,0.038461538461538464,0.5,0.2,5,0.5,0.5,Design 2,Design 2,"Have an option between Design #1 and Design #2,",1.0,,
62,5361,5,Player object (2058),buy,2023-03-10 13:41:32.231866+00:00,"{""priceA"": 140, ""sharesA"": 1, ""secs_since_round_starts"": 91, ""market"": ""A""}",45.0,16.0,8.0,0ysr1j7s,t7od4xlw,FULL STUDY,205.0,s4,1,140,145.0,-1,,1,sell,0,sell,0.5,0,0,0,block 3 (G second),19.0,8.0,Male,0.0,0.0,0.0,"[5, 'block 3 (G second)']",1,1,1,1.0,2.0,-0.4666666666666666,0.7272727272727273,0.038461538461538464,0.5,0.2,5,0.5,0.5,Design 2,Design 2,"Have an option between Design #1 and Design #2,",1.0,,
63,5365,5,Player object (2058),sell,2023-03-10 13:42:03.100396+00:00,"{""priceA"": 135, ""sharesA"": 0, ""secs_since_round_starts"": 122, ""market"": ""A""}",180.0,22.0,9.0,0ysr1j7s,t7od4xlw,FULL STUDY,205.0,s4,1,135,140.0,1,-5.0,1,buy,0,sell,0.5,0,0,1,block 3 (G second),19.0,8.0,Male,0.0,0.0,0.0,"[5, 'block 3 (G second)']",1,1,1,1.0,2.0,-0.4666666666666666,0.7272727272727273,0.038461538461538464,0.5,0.2,5,0.5,0.5,Design 2,Design 2,"Have an option between Design #1 and Design #2,",1.0,,
64,5366,5,Player object (2058),buy,2023-03-10 13:42:09.281303+00:00,"{""priceA"": 150, ""sharesA"": 1, ""secs_since_round_starts"": 128, ""market"": ""A""}",30.0,23.0,10.0,0ysr1j7s,t7od4xlw,FULL STUDY,205.0,s4,1,150,135.0,-1,,1,sell,0,sell,0.5,0,0,0,block 3 (G second),19.0,8.0,Male,0.0,0.0,0.0,"[5, 'block 3 (G second)']",1,1,1,1.0,2.0,-0.4666666666666666,0.7272727272727273,0.038461538461538464,0.5,0.2,5,0.5,0.5,Design 2,Design 2,"Have an option between Design #1 and Design #2,",1.0,,
65,5367,5,Player object (2058),sell,2023-03-10 13:42:14.143591+00:00,"{""priceA"": 155, ""sharesA"": 0, ""secs_since_round_starts"": 133, ""market"": ""A""}",185.0,24.0,11.0,0ysr1j7s,t7od4xlw,FULL STUDY,205.0,s4,1,155,150.0,1,5.0,1,buy,0,sell,0.5,0,0,0,block 3 (G second),19.0,8.0,Male,0.0,0.0,0.0,"[5, 'block 3 (G second)']",1,1,1,1.0,2.0,-0.4666666666666666,0.7272727272727273,0.038461538461538464,0.5,0.2,5,0.5,0.5,Design 2,Design 2,"Have an option between Design #1 and Design #2,",1.0,,
66,5369,5,Player object (2058),buy,2023-03-10 13:42:24.429327+00:00,"{""priceA"": 140, ""sharesA"": 1, ""secs_since_round_starts"": 144, ""market"": ""A""}",45.0,26.0,12.0,0ysr1j7s,t7od4xlw,FULL STUDY,205.0,s4,1,140,155.0,-1,,1,sell,0,sell,0.5,0,0,0,block 3 (G second),19.0,8.0,Male,0.0,0.0,0.0,"[5, 'block 3 (G second)']",1,1,1,1.0,2.0,-0.4666666666666666,0.7272727272727273,0.038461538461538464,0.5,0.2,5,0.5,0.5,Design 2,Design 2,"Have an option between Design #1 and Design #2,",1.0,,
67,5370,5,Player object (2058),sell,2023-03-10 13:42:30.494129+00:00,"{""priceA"": 145, ""sharesA"": 0, ""secs_since_round_starts"": 150, ""market"": ""A""}",190.0,27.0,13.0,0ysr1j7s,t7od4xlw,FULL STUDY,205.0,s4,1,145,140.0,1,5.0,1,buy,0,sell,0.5,0,0,0,block 3 (G second),19.0,8.0,Male,0.0,0.0,0.0,"[5, 'block 3 (G second)']",1,1,1,1.0,2.0,-0.4666666666666666,0.7272727272727273,0.038461538461538464,0.5,0.2,5,0.5,0.5,Design 2,Design 2,"Have an option between Design #1 and Design #2,",1.0,,
68,5372,5,Player object (2058),buy,2023-03-10 13:42:41.070860+00:00,"{""priceA"": 135, ""sharesA"": 1, ""secs_since_round_starts"": 160, ""market"": ""A""}",55.0,29.0,14.0,0ysr1j7s,t7od4xlw,FULL STUDY,205.0,s4,1,135,145.0,-1,,1,sell,0,sell,0.5,0,0,0,block 3 (G second),19.0,8.0,Male,0.0,0.0,0.0,"[5, 'block 3 (G second)']",1,1,1,1.0,2.0,-0.4666666666666666,0.7272727272727273,0.038461538461538464,0.5,0.2,5,0.5,0.5,Design 2,Design 2,"Have an option between Design #1 and Design #2,",1.0,,
69,5375,5,Player object (2058),sell,2023-03-10 13:43:05.072109+00:00,"{""priceA"": 140, ""sharesA"": 0, ""secs_since_round_starts"": 184, ""market"": ""A""}",195.0,32.0,15.0,0ysr1j7s,t7od4xlw,FULL STUDY,205.0,s4,1,140,135.0,1,5.0,1,buy,0,sell,0.5,0,0,0,block 3 (G second),19.0,8.0,Male,0.0,0.0,0.0,"[5, 'block 3 (G second)']",1,1,1,1.0,2.0,-0.4666666666666666,0.7272727272727273,0.038461538461538464,0.5,0.2,5,0.5,0.5,Design 2,Design 2,"Have an option between Design #1 and Design #2,",1.0,,
70,5376,5,Player object (2058),buy,2023-03-10 13:43:07.848821+00:00,"{""priceA"": 125, ""sharesA"": 1, ""secs_since_round_starts"": 187, ""market"": ""A""}",70.0,33.0,16.0,0ysr1j7s,t7od4xlw,FULL STUDY,205.0,s4,1,125,140.0,-1,,1,sell,0,sell,0.5,0,0,0,block 3 (G second),19.0,8.0,Male,0.0,0.0,0.0,"[5, 'block 3 (G second)']",1,1,1,1.0,2.0,-0.4666666666666666,0.7272727272727273,0.038461538461538464,0.5,0.2,5,0.5,0.5,Design 2,Design 2,"Have an option between Design #1 and Design #2,",1.0,,
71,5377,5,Player object (2058),sell,2023-03-10 13:43:13.172460+00:00,"{""priceA"": 140, ""sharesA"": 0, ""secs_since_round_starts"": 192, ""market"": ""A""}",210.0,34.0,17.0,0ysr1j7s,t7od4xlw,FULL STUDY,205.0,s4,1,140,125.0,1,15.0,1,buy,0,sell,0.5,0,0,0,block 3 (G second),19.0,8.0,Male,0.0,0.0,0.0,"[5, 'block 3 (G second)']",1,1,1,1.0,2.0,-0.4666666666666666,0.7272727272727273,0.038461538461538464,0.5,0.2,5,0.5,0.5,Design 2,Design 2,"Have an option between Design #1 and Design #2,",1.0,,
72,5378,5,Player object (2058),buy,2023-03-10 13:43:18.844794+00:00,"{""priceA"": 125, ""sharesA"": 1, ""secs_since_round_starts"": 198, ""market"": ""A""}",85.0,35.0,18.0,0ysr1j7s,t7od4xlw,FULL STUDY,205.0,s4,1,125,140.0,-1,,1,sell,0,sell,0.5,0,0,0,block 3 (G second),19.0,8.0,Male,0.0,0.0,0.0,"[5, 'block 3 (G second)']",1,1,1,1.0,2.0,-0.4666666666666666,0.7272727272727273,0.038461538461538464,0.5,0.2,5,0.5,0.5,Design 2,Design 2,"Have an option between Design #1 and Design #2,",1.0,,
73,5380,5,Player object (2058),sell,2023-03-10 13:43:24.454439+00:00,"{""priceA"": 140, ""sharesA"": 0, ""secs_since_round_starts"": 204, ""market"": ""A""}",225.0,36.0,19.0,0ysr1j7s,t7od4xlw,FULL STUDY,205.0,s4,1,140,125.0,1,15.0,1,buy,0,sell,0.5,0,0,0,block 3 (G second),19.0,8.0,Male,0.0,0.0,0.0,"[5, 'block 3 (G second)']",1,1,1,1.0,2.0,-0.4666666666666666,0.7272727272727273,0.038461538461538464,0.5,0.2,5,0.5,0.5,Design 2,Design 2,"Have an option between Design #1 and Design #2,",1.0,,
74,5382,5,Player object (2058),buy,2023-03-10 13:43:34.927994+00:00,"{""priceA"": 130, ""sharesA"": 1, ""secs_since_round_starts"": 214, ""market"": ""A""}",95.0,38.0,20.0,0ysr1j7s,t7od4xlw,FULL STUDY,205.0,s4,1,130,140.0,-1,,1,sell,0,sell,0.5,0,0,0,block 3 (G second),19.0,8.0,Male,0.0,0.0,0.0,"[5, 'block 3 (G second)']",1,1,1,1.0,2.0,-0.4666666666666666,0.7272727272727273,0.038461538461538464,0.5,0.2,5,0.5,0.5,Design 2,Design 2,"Have an option between Design #1 and Design #2,",1.0,,
75,5387,5,Player object (2058),sell,2023-03-10 13:44:19.296835+00:00,"{""priceA"": 130, ""sharesA"": 0, ""secs_since_round_starts"": 258, ""market"": ""A""}",225.0,46.0,21.0,0ysr1j7s,t7od4xlw,FULL STUDY,205.0,s4,1,130,130.0,1,0.0,1,buy,0,sell,0.5,0,0,0,block 3 (G second),19.0,8.0,Male,0.0,0.0,0.0,"[5, 'block 3 (G second)']",1,1,1,1.0,2.0,-0.4666666666666666,0.7272727272727273,0.038461538461538464,0.5,0.2,5,0.5,0.5,Design 2,Design 2,"Have an option between Design #1 and Design #2,",1.0,,
76,5389,5,Player object (2058),buy,2023-03-10 13:44:24.772793+00:00,"{""priceA"": 115, ""sharesA"": 1, ""secs_since_round_starts"": 264, ""market"": ""A""}",110.0,47.0,22.0,0ysr1j7s,t7od4xlw,FULL STUDY,205.0,s4,1,115,130.0,-1,,1,sell,0,sell,0.5,0,0,0,block 3 (G second),19.0,8.0,Male,0.0,0.0,0.0,"[5, 'block 3 (G second)']",1,1,1,1.0,2.0,-0.4666666666666666,0.7272727272727273,0.038461538461538464,0.5,0.2,5,0.5,0.5,Design 2,Design 2,"Have an option between Design #1 and Design #2,",1.0,,
77,3719,2,Player object (938),sell,2023-03-09 18:07:04.346506+00:00,"{""priceA"": 100, ""sharesA"": 0, ""secs_since_round_starts"": 39, ""market"": ""A""}",150.0,7.0,1.0,1c9lzru0,vmu7c279,FULL STUDY,180.0,s1,1,100,,1,,1,,0,sell,0.4669924949471701,16,0,0,block 1 (G first),23.0,12.0,Male,1.0,1.0,0.0,"[2, 'block 1 (G first)']",1,0,0,0.0,7.0,-0.30000000000000004,0.375,0.8,0.0,1.0,4,1.0,0.5,Design 2,Design 2,"Have an option between Design #1 and Design #2,",,5.0,4.0
78,3720,2,Player object (938),buy,2023-03-09 18:07:14.861561+00:00,"{""priceA"": 70, ""sharesA"": 1, ""secs_since_round_starts"": 50, ""market"": ""A""}",80.0,9.0,2.0,1c9lzru0,vmu7c279,FULL STUDY,180.0,s1,1,70,100.0,-1,,1,sell,0,sell,0.4254536939069079,16,0,0,block 1 (G first),23.0,12.0,Male,1.0,1.0,0.0,"[2, 'block 1 (G first)']",1,0,0,0.0,7.0,-0.30000000000000004,0.375,0.8,0.0,1.0,4,1.0,0.5,Design 2,Design 2,"Have an option between Design #1 and Design #2,",,5.0,4.0
79,3721,2,Player object (938),sell,2023-03-09 18:07:40.171501+00:00,"{""priceA"": 90, ""sharesA"": 0, ""secs_since_round_starts"": 75, ""market"": ""A""}",170.0,13.0,3.0,1c9lzru0,vmu7c279,FULL STUDY,180.0,s1,1,90,70.0,1,20.0,1,buy,0,sell,0.5364461838942041,16,0,0,block 1 (G first),23.0,12.0,Male,1.0,1.0,0.0,"[2, 'block 1 (G first)']",1,0,0,0.0,7.0,-0.30000000000000004,0.375,0.8,0.0,1.0,4,1.0,0.5,Design 2,Design 2,"Have an option between Design #1 and Design #2,",,5.0,4.0
80,3722,2,Player object (938),buy,2023-03-09 18:07:41.716724+00:00,"{""priceA"": 105, ""sharesA"": 1, ""secs_since_round_starts"": 76, ""market"": ""A""}",65.0,14.0,4.0,1c9lzru0,vmu7c279,FULL STUDY,180.0,s1,1,105,90.0,-1,,1,sell,0,sell,0.5600744319669811,16,0,1,block 1 (G first),23.0,12.0,Male,1.0,1.0,0.0,"[2, 'block 1 (G first)']",1,0,0,0.0,7.0,-0.30000000000000004,0.375,0.8,0.0,1.0,4,1.0,0.5,Design 2,Design 2,"Have an option between Design #1 and Design #2,",,5.0,4.0
81,3723,2,Player object (938),sell,2023-03-09 18:08:02.104141+00:00,"{""priceA"": 110, ""sharesA"": 0, ""secs_since_round_starts"": 97, ""market"": ""A""}",175.0,17.0,5.0,1c9lzru0,vmu7c279,FULL STUDY,180.0,s1,1,110,105.0,1,5.0,1,buy,0,sell,0.5478276073026133,16,0,0,block 1 (G first),23.0,12.0,Male,1.0,1.0,0.0,"[2, 'block 1 (G first)']",1,0,0,0.0,7.0,-0.30000000000000004,0.375,0.8,0.0,1.0,4,1.0,0.5,Design 2,Design 2,"Have an option between Design #1 and Design #2,",,5.0,4.0
82,3724,2,Player object (938),buy,2023-03-09 18:08:03.874099+00:00,"{""priceA"": 125, ""sharesA"": 1, ""secs_since_round_starts"": 99, ""market"": ""A""}",50.0,18.0,6.0,1c9lzru0,vmu7c279,FULL STUDY,180.0,s1,1,125,110.0,-1,,1,sell,0,sell,0.5678304910935957,16,0,0,block 1 (G first),23.0,12.0,Male,1.0,1.0,0.0,"[2, 'block 1 (G first)']",1,0,0,0.0,7.0,-0.30000000000000004,0.375,0.8,0.0,1.0,4,1.0,0.5,Design 2,Design 2,"Have an option between Design #1 and Design #2,",,5.0,4.0
83,3725,2,Player object (938),sell,2023-03-09 18:08:20.643392+00:00,"{""priceA"": 130, ""sharesA"": 0, ""secs_since_round_starts"": 115, ""market"": ""A""}",180.0,21.0,7.0,1c9lzru0,vmu7c279,FULL STUDY,180.0,s1,1,130,125.0,1,5.0,1,buy,0,sell,0.5504042050217014,16,0,0,block 1 (G first),23.0,12.0,Male,1.0,1.0,0.0,"[2, 'block 1 (G first)']",1,0,0,0.0,7.0,-0.30000000000000004,0.375,0.8,0.0,1.0,4,1.0,0.5,Design 2,Design 2,"Have an option between Design #1 and Design #2,",,5.0,4.0
84,3726,2,Player object (938),buy,2023-03-09 18:08:49.945942+00:00,"{""priceA"": 140, ""sharesA"": 1, ""secs_since_round_starts"": 145, ""market"": ""A""}",40.0,26.0,8.0,1c9lzru0,vmu7c279,FULL STUDY,180.0,s1,1,140,130.0,-1,,1,sell,0,sell,0.4855198313469848,16,0,0,block 1 (G first),23.0,12.0,Male,1.0,1.0,0.0,"[2, 'block 1 (G first)']",1,0,0,0.0,7.0,-0.30000000000000004,0.375,0.8,0.0,1.0,4,1.0,0.5,Design 2,Design 2,"Have an option between Design #1 and Design #2,",,5.0,4.0
85,3727,2,Player object (938),sell,2023-03-09 18:08:54.509658+00:00,"{""priceA"": 125, ""sharesA"": 0, ""secs_since_round_starts"": 149, ""market"": ""A""}",165.0,27.0,9.0,1c9lzru0,vmu7c279,FULL STUDY,180.0,s1,1,125,140.0,1,-15.0,1,buy,0,sell,0.4549942201992644,16,1,0,block 1 (G first),23.0,12.0,Male,1.0,1.0,0.0,"[2, 'block 1 (G first)']",1,0,0,0.0,7.0,-0.30000000000000004,0.375,0.8,0.0,1.0,4,1.0,0.5,Design 2,Design 2,"Have an option between Design #1 and Design #2,",,5.0,4.0
86,3729,2,Player object (938),buy,2023-03-09 18:09:48.446558+00:00,"{""priceA"": 125, ""sharesA"": 1, ""secs_since_round_starts"": 203, ""market"": ""A""}",40.0,34.0,10.0,1c9lzru0,vmu7c279,FULL STUDY,180.0,s1,1,125,125.0,-1,,1,sell,0,sell,0.4644502626891607,16,0,0,block 1 (G first),23.0,12.0,Male,1.0,1.0,0.0,"[2, 'block 1 (G first)']",1,0,0,0.0,7.0,-0.30000000000000004,0.375,0.8,0.0,1.0,4,1.0,0.5,Design 2,Design 2,"Have an option between Design #1 and Design #2,",,5.0,4.0
87,3731,2,Player object (938),sell,2023-03-09 18:10:07.080789+00:00,"{""priceA"": 150, ""sharesA"": 0, ""secs_since_round_starts"": 222, ""market"": ""A""}",190.0,36.0,11.0,1c9lzru0,vmu7c279,FULL STUDY,180.0,s1,1,150,125.0,1,25.0,1,buy,0,sell,0.542045663089369,16,0,0,block 1 (G first),23.0,12.0,Male,1.0,1.0,0.0,"[2, 'block 1 (G first)']",1,0,0,0.0,7.0,-0.30000000000000004,0.375,0.8,0.0,1.0,4,1.0,0.5,Design 2,Design 2,"Have an option between Design #1 and Design #2,",,5.0,4.0
88,3732,2,Player object (938),buy,2023-03-09 18:10:41.614308+00:00,"{""priceA"": 125, ""sharesA"": 1, ""secs_since_round_starts"": 256, ""market"": ""A""}",65.0,43.0,12.0,1c9lzru0,vmu7c279,FULL STUDY,180.0,s1,1,125,150.0,-1,,1,sell,0,sell,0.4218732662739463,16,1,0,block 1 (G first),23.0,12.0,Male,1.0,1.0,0.0,"[2, 'block 1 (G first)']",1,0,0,0.0,7.0,-0.30000000000000004,0.375,0.8,0.0,1.0,4,1.0,0.5,Design 2,Design 2,"Have an option between Design #1 and Design #2,",,5.0,4.0
89,3733,2,Player object (938),sell,2023-03-09 18:10:50.625366+00:00,"{""priceA"": 130, ""sharesA"": 0, ""secs_since_round_starts"": 265, ""market"": ""A""}",195.0,44.0,13.0,1c9lzru0,vmu7c279,FULL STUDY,180.0,s1,1,130,125.0,1,5.0,1,buy,0,sell,0.4799987600827208,16,0,0,block 1 (G first),23.0,12.0,Male,1.0,1.0,0.0,"[2, 'block 1 (G first)']",1,0,0,0.0,7.0,-0.30000000000000004,0.375,0.8,0.0,1.0,4,1.0,0.5,Design 2,Design 2,"Have an option between Design #1 and Design #2,",,5.0,4.0
90,3734,2,Player object (938),buy,2023-03-09 18:11:00.028939+00:00,"{""priceA"": 155, ""sharesA"": 1, ""secs_since_round_starts"": 275, ""market"": ""A""}",40.0,46.0,14.0,1c9lzru0,vmu7c279,FULL STUDY,180.0,s1,1,155,130.0,-1,,1,sell,0,sell,0.5495494947508355,16,0,1,block 1 (G first),23.0,12.0,Male,1.0,1.0,0.0,"[2, 'block 1 (G first)']",1,0,0,0.0,7.0,-0.30000000000000004,0.375,0.8,0.0,1.0,4,1.0,0.5,Design 2,Design 2,"Have an option between Design #1 and Design #2,",,5.0,4.0
91,3735,2,Player object (938),sell,2023-03-09 18:11:05.350288+00:00,"{""priceA"": 140, ""sharesA"": 0, ""secs_since_round_starts"": 280, ""market"": ""A""}",180.0,47.0,15.0,1c9lzru0,vmu7c279,FULL STUDY,180.0,s1,1,140,155.0,1,-15.0,1,buy,0,sell,0.4996814899229063,16,0,0,block 1 (G first),23.0,12.0,Male,1.0,1.0,0.0,"[2, 'block 1 (G first)']",1,0,0,0.0,7.0,-0.30000000000000004,0.375,0.8,0.0,1.0,4,1.0,0.5,Design 2,Design 2,"Have an option between Design #1 and Design #2,",,5.0,4.0
92,3737,2,Player object (938),buy,2023-03-09 18:11:15.780369+00:00,"{""priceA"": 155, ""sharesA"": 1, ""secs_since_round_starts"": 290, ""market"": ""A""}",25.0,48.0,16.0,1c9lzru0,vmu7c279,FULL STUDY,180.0,s1,1,155,140.0,-1,,1,sell,0,sell,0.5347792584548927,16,0,0,block 1 (G first),23.0,12.0,Male,1.0,1.0,0.0,"[2, 'block 1 (G first)']",1,0,0,0.0,7.0,-0.30000000000000004,0.375,0.8,0.0,1.0,4,1.0,0.5,Design 2,Design 2,"Have an option between Design #1 and Design #2,",,5.0,4.0
93,3738,2,Player object (938),sell,2023-03-09 18:11:23.068126+00:00,"{""priceA"": 170, ""sharesA"": 0, ""secs_since_round_starts"": 298, ""market"": ""A""}",195.0,49.0,17.0,1c9lzru0,vmu7c279,FULL STUDY,180.0,s1,1,170,155.0,1,15.0,1,buy,0,sell,0.5589355340840079,16,0,0,block 1 (G first),23.0,12.0,Male,1.0,1.0,0.0,"[2, 'block 1 (G first)']",1,0,0,0.0,7.0,-0.30000000000000004,0.375,0.8,0.0,1.0,4,1.0,0.5,Design 2,Design 2,"Have an option between Design #1 and Design #2,",,5.0,4.0
94,3739,2,Player object (938),buy,2023-03-09 18:11:34.697536+00:00,"{""priceA"": 140, ""sharesA"": 1, ""secs_since_round_starts"": 309, ""market"": ""A""}",55.0,51.0,18.0,1c9lzru0,vmu7c279,FULL STUDY,180.0,s1,1,140,170.0,-1,,1,sell,0,sell,0.4693918893964308,16,0,0,block 1 (G first),23.0,12.0,Male,1.0,1.0,0.0,"[2, 'block 1 (G first)']",1,0,0,0.0,7.0,-0.30000000000000004,0.375,0.8,0.0,1.0,4,1.0,0.5,Design 2,Design 2,"Have an option between Design #1 and Design #2,",,5.0,4.0
95,3740,2,Player object (938),sell,2023-03-09 18:11:37.327727+00:00,"{""priceA"": 125, ""sharesA"": 0, ""secs_since_round_starts"": 312, ""market"": ""A""}",180.0,52.0,19.0,1c9lzru0,vmu7c279,FULL STUDY,180.0,s1,1,125,140.0,1,-15.0,1,buy,0,sell,0.4439176376077041,16,1,0,block 1 (G first),23.0,12.0,Male,1.0,1.0,0.0,"[2, 'block 1 (G first)']",1,0,0,0.0,7.0,-0.30000000000000004,0.375,0.8,0.0,1.0,4,1.0,0.5,Design 2,Design 2,"Have an option between Design #1 and Design #2,",,5.0,4.0
96,3741,2,Player object (938),buy,2023-03-09 18:11:45.074272+00:00,"{""priceA"": 135, ""sharesA"": 1, ""secs_since_round_starts"": 320, ""market"": ""A""}",45.0,53.0,20.0,1c9lzru0,vmu7c279,FULL STUDY,180.0,s1,1,135,125.0,-1,,1,sell,0,sell,0.4956940487416096,16,0,0,block 1 (G first),23.0,12.0,Male,1.0,1.0,0.0,"[2, 'block 1 (G first)']",1,0,0,0.0,7.0,-0.30000000000000004,0.375,0.8,0.0,1.0,4,1.0,0.5,Design 2,Design 2,"Have an option between Design #1 and Design #2,",,5.0,4.0
97,3743,2,Player object (938),sell,2023-03-09 18:12:07.284192+00:00,"{""priceA"": 125, ""sharesA"": 0, ""secs_since_round_starts"": 342, ""market"": ""A""}",170.0,56.0,21.0,1c9lzru0,vmu7c279,FULL STUDY,180.0,s1,1,125,135.0,1,-10.0,1,buy,0,sell,0.4562406760637778,16,0,0,block 1 (G first),23.0,12.0,Male,1.0,1.0,0.0,"[2, 'block 1 (G first)']",1,0,0,0.0,7.0,-0.30000000000000004,0.375,0.8,0.0,1.0,4,1.0,0.5,Design 2,Design 2,"Have an option between Design #1 and Design #2,",,5.0,4.0
98,3745,2,Player object (938),buy,2023-03-09 18:12:20.107314+00:00,"{""priceA"": 115, ""sharesA"": 1, ""secs_since_round_starts"": 355, ""market"": ""A""}",55.0,58.0,22.0,1c9lzru0,vmu7c279,FULL STUDY,180.0,s1,1,115,125.0,-1,,1,sell,0,sell,0.4893175166503174,16,0,0,block 1 (G first),23.0,12.0,Male,1.0,1.0,0.0,"[2, 'block 1 (G first)']",1,0,0,0.0,7.0,-0.30000000000000004,0.375,0.8,0.0,1.0,4,1.0,0.5,Design 2,Design 2,"Have an option between Design #1 and Design #2,",,5.0,4.0
99,3749,3,Player object (1058),sell,2023-03-09 18:13:05.547438+00:00,"{""priceA"": 90, ""sharesA"": 0, ""secs_since_round_starts"": 31, ""market"": ""A""}",140.0,7.0,1.0,1c9lzru0,vmu7c279,FULL STUDY,220.0,s1,1,90,,1,,1,,0,sell,0.4580966810292103,19,0,0,block 1 (G first),23.0,12.0,Male,1.0,1.0,0.0,"[3, 'block 1 (G first)']",1,1,0,0.5,7.0,-0.30000000000000004,0.36363636363636365,0.25,1.0,0.0,1,0.25,0.5,Design 2,Design 2,"Have an option between Design #1 and Design #2,",,5.0,4.0
100,3753,3,Player object (1058),buy,2023-03-09 18:14:28.592197+00:00,"{""priceA"": 85, ""sharesA"": 1, ""secs_since_round_starts"": 114, ""market"": ""A""}",55.0,22.0,2.0,1c9lzru0,vmu7c279,FULL STUDY,220.0,s1,1,85,90.0,-1,,1,sell,0,sell,0.443819468959905,19,1,0,block 1 (G first),23.0,12.0,Male,1.0,1.0,0.0,"[3, 'block 1 (G first)']",1,1,0,0.5,7.0,-0.30000000000000004,0.36363636363636365,0.25,1.0,0.0,1,0.25,0.5,Design 2,Design 2,"Have an option between Design #1 and Design #2,",,5.0,4.0
101,3754,3,Player object (1058),sell,2023-03-09 18:14:39.336967+00:00,"{""priceA"": 115, ""sharesA"": 0, ""secs_since_round_starts"": 125, ""market"": ""A""}",170.0,24.0,3.0,1c9lzru0,vmu7c279,FULL STUDY,220.0,s1,1,115,85.0,1,30.0,1,buy,0,sell,0.5319650978870379,19,0,0,block 1 (G first),23.0,12.0,Male,1.0,1.0,0.0,"[3, 'block 1 (G first)']",1,1,0,0.5,7.0,-0.30000000000000004,0.36363636363636365,0.25,1.0,0.0,1,0.25,0.5,Design 2,Design 2,"Have an option between Design #1 and Design #2,",,5.0,4.0
102,3755,3,Player object (1058),buy,2023-03-09 18:14:56.395126+00:00,"{""priceA"": 105, ""sharesA"": 1, ""secs_since_round_starts"": 142, ""market"": ""A""}",65.0,27.0,4.0,1c9lzru0,vmu7c279,FULL STUDY,220.0,s1,1,105,115.0,-1,,1,sell,0,sell,0.4832330156747784,19,0,0,block 1 (G first),23.0,12.0,Male,1.0,1.0,0.0,"[3, 'block 1 (G first)']",1,1,0,0.5,7.0,-0.30000000000000004,0.36363636363636365,0.25,1.0,0.0,1,0.25,0.5,Design 2,Design 2,"Have an option between Design #1 and Design #2,",,5.0,4.0
103,3756,3,Player object (1058),sell,2023-03-09 18:15:10.395998+00:00,"{""priceA"": 115, ""sharesA"": 0, ""secs_since_round_starts"": 156, ""market"": ""A""}",180.0,29.0,5.0,1c9lzru0,vmu7c279,FULL STUDY,220.0,s1,1,115,105.0,1,10.0,1,buy,0,sell,0.5511004178331719,19,0,0,block 1 (G first),23.0,12.0,Male,1.0,1.0,0.0,"[3, 'block 1 (G first)']",1,1,0,0.5,7.0,-0.30000000000000004,0.36363636363636365,0.25,1.0,0.0,1,0.25,0.5,Design 2,Design 2,"Have an option between Design #1 and Design #2,",,5.0,4.0
104,3758,3,Player object (1058),buy,2023-03-09 18:15:33.829305+00:00,"{""priceA"": 100, ""sharesA"": 1, ""secs_since_round_starts"": 179, ""market"": ""A""}",80.0,33.0,6.0,1c9lzru0,vmu7c279,FULL STUDY,220.0,s1,1,100,115.0,-1,,1,sell,0,sell,0.4476889957041811,19,1,0,block 1 (G first),23.0,12.0,Male,1.0,1.0,0.0,"[3, 'block 1 (G first)']",1,1,0,0.5,7.0,-0.30000000000000004,0.36363636363636365,0.25,1.0,0.0,1,0.25,0.5,Design 2,Design 2,"Have an option between Design #1 and Design #2,",,5.0,4.0
105,3761,3,Player object (1058),sell,2023-03-09 18:15:50.217968+00:00,"{""priceA"": 100, ""sharesA"": 0, ""secs_since_round_starts"": 196, ""market"": ""A""}",180.0,36.0,7.0,1c9lzru0,vmu7c279,FULL STUDY,220.0,s1,1,100,100.0,1,0.0,1,buy,0,sell,0.440139794868048,19,0,0,block 1 (G first),23.0,12.0,Male,1.0,1.0,0.0,"[3, 'block 1 (G first)']",1,1,0,0.5,7.0,-0.30000000000000004,0.36363636363636365,0.25,1.0,0.0,1,0.25,0.5,Design 2,Design 2,"Have an option between Design #1 and Design #2,",,5.0,4.0
106,3764,3,Player object (1058),buy,2023-03-09 18:15:59.338919+00:00,"{""priceA"": 100, ""sharesA"": 1, ""secs_since_round_starts"": 205, ""market"": ""A""}",80.0,38.0,8.0,1c9lzru0,vmu7c279,FULL STUDY,220.0,s1,1,100,100.0,-1,,1,sell,0,sell,0.4815245494229145,19,0,0,block 1 (G first),23.0,12.0,Male,1.0,1.0,0.0,"[3, 'block 1 (G first)']",1,1,0,0.5,7.0,-0.30000000000000004,0.36363636363636365,0.25,1.0,0.0,1,0.25,0.5,Design 2,Design 2,"Have an option between Design #1 and Design #2,",,5.0,4.0
107,3766,3,Player object (1058),sell,2023-03-09 18:16:12.790863+00:00,"{""priceA"": 100, ""sharesA"": 0, ""secs_since_round_starts"": 218, ""market"": ""A""}",180.0,40.0,9.0,1c9lzru0,vmu7c279,FULL STUDY,220.0,s1,1,100,100.0,1,0.0,1,buy,0,sell,0.4804175727303482,19,0,0,block 1 (G first),23.0,12.0,Male,1.0,1.0,0.0,"[3, 'block 1 (G first)']",1,1,0,0.5,7.0,-0.30000000000000004,0.36363636363636365,0.25,1.0,0.0,1,0.25,0.5,Design 2,Design 2,"Have an option between Design #1 and Design #2,",,5.0,4.0
108,3769,3,Player object (1058),buy,2023-03-09 18:16:23.774489+00:00,"{""priceA"": 105, ""sharesA"": 1, ""secs_since_round_starts"": 229, ""market"": ""A""}",75.0,42.0,10.0,1c9lzru0,vmu7c279,FULL STUDY,220.0,s1,1,105,100.0,-1,,1,sell,0,sell,0.5010477910686952,19,0,0,block 1 (G first),23.0,12.0,Male,1.0,1.0,0.0,"[3, 'block 1 (G first)']",1,1,0,0.5,7.0,-0.30000000000000004,0.36363636363636365,0.25,1.0,0.0,1,0.25,0.5,Design 2,Design 2,"Have an option between Design #1 and Design #2,",,5.0,4.0
109,3772,3,Player object (1058),sell,2023-03-09 18:16:39.576106+00:00,"{""priceA"": 135, ""sharesA"": 0, ""secs_since_round_starts"": 245, ""market"": ""A""}",210.0,44.0,11.0,1c9lzru0,vmu7c279,FULL STUDY,220.0,s1,1,135,105.0,1,30.0,1,buy,0,sell,0.5595824488336746,19,0,1,block 1 (G first),23.0,12.0,Male,1.0,1.0,0.0,"[3, 'block 1 (G first)']",1,1,0,0.5,7.0,-0.30000000000000004,0.36363636363636365,0.25,1.0,0.0,1,0.25,0.5,Design 2,Design 2,"Have an option between Design #1 and Design #2,",,5.0,4.0
110,3775,3,Player object (1058),buy,2023-03-09 18:17:19.374443+00:00,"{""priceA"": 120, ""sharesA"": 1, ""secs_since_round_starts"": 285, ""market"": ""A""}",90.0,51.0,12.0,1c9lzru0,vmu7c279,FULL STUDY,220.0,s1,1,120,135.0,-1,,1,sell,0,sell,0.4588602748157505,19,0,0,block 1 (G first),23.0,12.0,Male,1.0,1.0,0.0,"[3, 'block 1 (G first)']",1,1,0,0.5,7.0,-0.30000000000000004,0.36363636363636365,0.25,1.0,0.0,1,0.25,0.5,Design 2,Design 2,"Have an option between Design #1 and Design #2,",,5.0,4.0
111,3778,3,Player object (1058),sell,2023-03-09 18:17:28.282081+00:00,"{""priceA"": 130, ""sharesA"": 0, ""secs_since_round_starts"": 294, ""market"": ""A""}",220.0,53.0,13.0,1c9lzru0,vmu7c279,FULL STUDY,220.0,s1,1,130,120.0,1,10.0,1,buy,0,sell,0.4905868559773416,19,0,0,block 1 (G first),23.0,12.0,Male,1.0,1.0,0.0,"[3, 'block 1 (G first)']",1,1,0,0.5,7.0,-0.30000000000000004,0.36363636363636365,0.25,1.0,0.0,1,0.25,0.5,Design 2,Design 2,"Have an option between Design #1 and Design #2,",,5.0,4.0
112,3780,3,Player object (1058),buy,2023-03-09 18:17:55.968325+00:00,"{""priceA"": 115, ""sharesA"": 1, ""secs_since_round_starts"": 321, ""market"": ""A""}",105.0,58.0,14.0,1c9lzru0,vmu7c279,FULL STUDY,220.0,s1,1,115,130.0,-1,,1,sell,0,sell,0.442461876115205,19,1,0,block 1 (G first),23.0,12.0,Male,1.0,1.0,0.0,"[3, 'block 1 (G first)']",1,1,0,0.5,7.0,-0.30000000000000004,0.36363636363636365,0.25,1.0,0.0,1,0.25,0.5,Design 2,Design 2,"Have an option between Design #1 and Design #2,",,5.0,4.0
113,3787,4,Player object (1178),sell,2023-03-09 18:18:39.723894+00:00,"{""priceA"": 40, ""sharesA"": 0, ""secs_since_round_starts"": 26, ""market"": ""A""}",90.0,6.0,1.0,1c9lzru0,vmu7c279,FULL STUDY,80.0,s1,1,40,,1,,1,,0,sell,0.4060600996068529,14,0,0,block 1 (G first),23.0,12.0,Male,1.0,1.0,0.0,"[4, 'block 1 (G first)']",0,0,0,0.5,7.0,-0.30000000000000004,0.42857142857142855,0.2,1.0,0.25,2,1.0,0.75,Design 2,Design 2,"Have an option between Design #1 and Design #2,",,5.0,4.0
114,3788,4,Player object (1178),buy,2023-03-09 18:18:44.466399+00:00,"{""priceA"": 45, ""sharesA"": 1, ""secs_since_round_starts"": 31, ""market"": ""A""}",45.0,7.0,2.0,1c9lzru0,vmu7c279,FULL STUDY,80.0,s1,1,45,40.0,-1,,1,sell,0,sell,0.4686531252667821,14,0,0,block 1 (G first),23.0,12.0,Male,1.0,1.0,0.0,"[4, 'block 1 (G first)']",0,0,0,0.5,7.0,-0.30000000000000004,0.42857142857142855,0.2,1.0,0.25,2,1.0,0.75,Design 2,Design 2,"Have an option between Design #1 and Design #2,",,5.0,4.0
115,3789,4,Player object (1178),sell,2023-03-09 18:18:58.847845+00:00,"{""priceA"": 70, ""sharesA"": 0, ""secs_since_round_starts"": 45, ""market"": ""A""}",115.0,9.0,3.0,1c9lzru0,vmu7c279,FULL STUDY,80.0,s1,1,70,45.0,1,25.0,1,buy,0,sell,0.5440818519127735,14,0,1,block 1 (G first),23.0,12.0,Male,1.0,1.0,0.0,"[4, 'block 1 (G first)']",0,0,0,0.5,7.0,-0.30000000000000004,0.42857142857142855,0.2,1.0,0.25,2,1.0,0.75,Design 2,Design 2,"Have an option between Design #1 and Design #2,",,5.0,4.0
116,3790,4,Player object (1178),buy,2023-03-09 18:19:06.262447+00:00,"{""priceA"": 95, ""sharesA"": 1, ""secs_since_round_starts"": 52, ""market"": ""A""}",20.0,11.0,4.0,1c9lzru0,vmu7c279,FULL STUDY,80.0,s1,1,95,70.0,-1,,1,sell,0,sell,0.5796571916404338,14,0,0,block 1 (G first),23.0,12.0,Male,1.0,1.0,0.0,"[4, 'block 1 (G first)']",0,0,0,0.5,7.0,-0.30000000000000004,0.42857142857142855,0.2,1.0,0.25,2,1.0,0.75,Design 2,Design 2,"Have an option between Design #1 and Design #2,",,5.0,4.0
117,3794,4,Player object (1178),sell,2023-03-09 18:19:18.672807+00:00,"{""priceA"": 75, ""sharesA"": 0, ""secs_since_round_starts"": 65, ""market"": ""A""}",95.0,13.0,5.0,1c9lzru0,vmu7c279,FULL STUDY,80.0,s1,1,75,95.0,1,-20.0,1,buy,0,sell,0.479681559969247,14,0,0,block 1 (G first),23.0,12.0,Male,1.0,1.0,0.0,"[4, 'block 1 (G first)']",0,0,0,0.5,7.0,-0.30000000000000004,0.42857142857142855,0.2,1.0,0.25,2,1.0,0.75,Design 2,Design 2,"Have an option between Design #1 and Design #2,",,5.0,4.0
118,3795,4,Player object (1178),buy,2023-03-09 18:19:24.141319+00:00,"{""priceA"": 90, ""sharesA"": 1, ""secs_since_round_starts"": 70, ""market"": ""A""}",5.0,14.0,6.0,1c9lzru0,vmu7c279,FULL STUDY,80.0,s1,1,90,75.0,-1,,1,sell,0,sell,0.5208618681016636,14,0,0,block 1 (G first),23.0,12.0,Male,1.0,1.0,0.0,"[4, 'block 1 (G first)']",0,0,0,0.5,7.0,-0.30000000000000004,0.42857142857142855,0.2,1.0,0.25,2,1.0,0.75,Design 2,Design 2,"Have an option between Design #1 and Design #2,",,5.0,4.0
119,3797,4,Player object (1178),sell,2023-03-09 18:19:44.743650+00:00,"{""priceA"": 70, ""sharesA"": 0, ""secs_since_round_starts"": 91, ""market"": ""A""}",75.0,18.0,7.0,1c9lzru0,vmu7c279,FULL STUDY,80.0,s1,1,70,90.0,1,-20.0,1,buy,0,sell,0.4407118028401492,14,1,0,block 1 (G first),23.0,12.0,Male,1.0,1.0,0.0,"[4, 'block 1 (G first)']",0,0,0,0.5,7.0,-0.30000000000000004,0.42857142857142855,0.2,1.0,0.25,2,1.0,0.75,Design 2,Design 2,"Have an option between Design #1 and Design #2,",,5.0,4.0
120,3798,4,Player object (1178),buy,2023-03-09 18:19:49.981234+00:00,"{""priceA"": 85, ""sharesA"": 1, ""secs_since_round_starts"": 96, ""market"": ""A""}",-10.0,19.0,8.0,1c9lzru0,vmu7c279,FULL STUDY,80.0,s1,1,85,70.0,-1,,1,sell,0,sell,0.4934202415852731,14,0,0,block 1 (G first),23.0,12.0,Male,1.0,1.0,0.0,"[4, 'block 1 (G first)']",0,0,0,0.5,7.0,-0.30000000000000004,0.42857142857142855,0.2,1.0,0.25,2,1.0,0.75,Design 2,Design 2,"Have an option between Design #1 and Design #2,",,5.0,4.0
121,3802,4,Player object (1178),sell,2023-03-09 18:20:02.617454+00:00,"{""priceA"": 65, ""sharesA"": 0, ""secs_since_round_starts"": 109, ""market"": ""A""}",55.0,21.0,9.0,1c9lzru0,vmu7c279,FULL STUDY,80.0,s1,1,65,85.0,1,-20.0,1,buy,0,sell,0.4378043684469758,14,0,0,block 1 (G first),23.0,12.0,Male,1.0,1.0,0.0,"[4, 'block 1 (G first)']",0,0,0,0.5,7.0,-0.30000000000000004,0.42857142857142855,0.2,1.0,0.25,2,1.0,0.75,Design 2,Design 2,"Have an option between Design #1 and Design #2,",,5.0,4.0
122,3803,4,Player object (1178),buy,2023-03-09 18:20:08.384224+00:00,"{""priceA"": 55, ""sharesA"": 1, ""secs_since_round_starts"": 115, ""market"": ""A""}",,22.0,10.0,1c9lzru0,vmu7c279,FULL STUDY,80.0,s1,1,55,65.0,-1,,1,sell,0,sell,0.4224279859932807,14,1,0,block 1 (G first),23.0,12.0,Male,1.0,1.0,0.0,"[4, 'block 1 (G first)']",0,0,0,0.5,7.0,-0.30000000000000004,0.42857142857142855,0.2,1.0,0.25,2,1.0,0.75,Design 2,Design 2,"Have an option between Design #1 and Design #2,",,5.0,4.0
123,3804,4,Player object (1178),sell,2023-03-09 18:20:41.843825+00:00,"{""priceA"": 80, ""sharesA"": 0, ""secs_since_round_starts"": 148, ""market"": ""A""}",80.0,28.0,11.0,1c9lzru0,vmu7c279,FULL STUDY,80.0,s1,1,80,55.0,1,25.0,1,buy,0,sell,0.5529051331090981,14,0,1,block 1 (G first),23.0,12.0,Male,1.0,1.0,0.0,"[4, 'block 1 (G first)']",0,0,0,0.5,7.0,-0.30000000000000004,0.42857142857142855,0.2,1.0,0.25,2,1.0,0.75,Design 2,Design 2,"Have an option between Design #1 and Design #2,",,5.0,4.0
124,3809,4,Player object (1178),buy,2023-03-09 18:21:25.483599+00:00,"{""priceA"": 85, ""sharesA"": 1, ""secs_since_round_starts"": 192, ""market"": ""A""}",-5.0,36.0,12.0,1c9lzru0,vmu7c279,FULL STUDY,80.0,s1,1,85,80.0,-1,,1,sell,0,sell,0.4885269486642424,14,0,0,block 1 (G first),23.0,12.0,Male,1.0,1.0,0.0,"[4, 'block 1 (G first)']",0,0,0,0.5,7.0,-0.30000000000000004,0.42857142857142855,0.2,1.0,0.25,2,1.0,0.75,Design 2,Design 2,"Have an option between Design #1 and Design #2,",,5.0,4.0
125,3811,4,Player object (1178),sell,2023-03-09 18:21:58.108191+00:00,"{""priceA"": 95, ""sharesA"": 0, ""secs_since_round_starts"": 224, ""market"": ""A""}",90.0,42.0,13.0,1c9lzru0,vmu7c279,FULL STUDY,80.0,s1,1,95,85.0,1,10.0,1,buy,0,sell,0.5388552795609507,14,0,0,block 1 (G first),23.0,12.0,Male,1.0,1.0,0.0,"[4, 'block 1 (G first)']",0,0,0,0.5,7.0,-0.30000000000000004,0.42857142857142855,0.2,1.0,0.25,2,1.0,0.75,Design 2,Design 2,"Have an option between Design #1 and Design #2,",,5.0,4.0
126,3817,4,Player object (1178),buy,2023-03-09 18:23:03.900170+00:00,"{""priceA"": 85, ""sharesA"": 1, ""secs_since_round_starts"": 290, ""market"": ""A""}",5.0,54.0,14.0,1c9lzru0,vmu7c279,FULL STUDY,80.0,s1,1,85,95.0,-1,,1,sell,0,sell,0.4957421237757241,14,0,0,block 1 (G first),23.0,12.0,Male,1.0,1.0,0.0,"[4, 'block 1 (G first)']",0,0,0,0.5,7.0,-0.30000000000000004,0.42857142857142855,0.2,1.0,0.25,2,1.0,0.75,Design 2,Design 2,"Have an option between Design #1 and Design #2,",,5.0,4.0
127,3830,5,Player object (1298),sell,2023-03-09 18:24:45.243586+00:00,"{""priceA"": 100, ""sharesA"": 0, ""secs_since_round_starts"": 59, ""market"": ""A""}",150.0,12.0,2.0,1c9lzru0,vmu7c279,FULL STUDY,195.0,s1,1,100,95.0,1,5.0,1,,0,sell,0.5344269279803172,17,0,0,block 1 (G first),23.0,12.0,Male,1.0,1.0,0.0,"[5, 'block 1 (G first)']",0,1,0,1.0,7.0,-0.30000000000000004,0.4,0.05,0.6666666666666666,0.0,1,0.75,1.0,Design 2,Design 2,"Have an option between Design #1 and Design #2,",,5.0,4.0
128,3832,5,Player object (1298),buy,2023-03-09 18:24:55.741525+00:00,"{""priceA"": 80, ""sharesA"": 1, ""secs_since_round_starts"": 69, ""market"": ""A""}",70.0,14.0,3.0,1c9lzru0,vmu7c279,FULL STUDY,195.0,s1,1,80,100.0,-1,,1,sell,0,sell,0.457409789643144,17,0,0,block 1 (G first),23.0,12.0,Male,1.0,1.0,0.0,"[5, 'block 1 (G first)']",0,1,0,1.0,7.0,-0.30000000000000004,0.4,0.05,0.6666666666666666,0.0,1,0.75,1.0,Design 2,Design 2,"Have an option between Design #1 and Design #2,",,5.0,4.0
129,3834,5,Player object (1298),sell,2023-03-09 18:25:05.747577+00:00,"{""priceA"": 85, ""sharesA"": 0, ""secs_since_round_starts"": 79, ""market"": ""A""}",155.0,16.0,4.0,1c9lzru0,vmu7c279,FULL STUDY,195.0,s1,1,85,80.0,1,5.0,1,buy,0,sell,0.4686291671454359,17,0,0,block 1 (G first),23.0,12.0,Male,1.0,1.0,0.0,"[5, 'block 1 (G first)']",0,1,0,1.0,7.0,-0.30000000000000004,0.4,0.05,0.6666666666666666,0.0,1,0.75,1.0,Design 2,Design 2,"Have an option between Design #1 and Design #2,",,5.0,4.0
130,3836,5,Player object (1298),buy,2023-03-09 18:25:25.121554+00:00,"{""priceA"": 80, ""sharesA"": 1, ""secs_since_round_starts"": 99, ""market"": ""A""}",75.0,19.0,5.0,1c9lzru0,vmu7c279,FULL STUDY,195.0,s1,1,80,85.0,-1,,1,sell,0,sell,0.4830991506082083,17,0,0,block 1 (G first),23.0,12.0,Male,1.0,1.0,0.0,"[5, 'block 1 (G first)']",0,1,0,1.0,7.0,-0.30000000000000004,0.4,0.05,0.6666666666666666,0.0,1,0.75,1.0,Design 2,Design 2,"Have an option between Design #1 and Design #2,",,5.0,4.0
131,3837,5,Player object (1298),sell,2023-03-09 18:25:33.495484+00:00,"{""priceA"": 105, ""sharesA"": 0, ""secs_since_round_starts"": 107, ""market"": ""A""}",180.0,21.0,6.0,1c9lzru0,vmu7c279,FULL STUDY,195.0,s1,1,105,80.0,1,25.0,1,buy,0,sell,0.5510362930796925,17,0,1,block 1 (G first),23.0,12.0,Male,1.0,1.0,0.0,"[5, 'block 1 (G first)']",0,1,0,1.0,7.0,-0.30000000000000004,0.4,0.05,0.6666666666666666,0.0,1,0.75,1.0,Design 2,Design 2,"Have an option between Design #1 and Design #2,",,5.0,4.0
132,3840,5,Player object (1298),buy,2023-03-09 18:26:18.061834+00:00,"{""priceA"": 80, ""sharesA"": 1, ""secs_since_round_starts"": 151, ""market"": ""A""}",100.0,29.0,7.0,1c9lzru0,vmu7c279,FULL STUDY,195.0,s1,1,80,105.0,-1,,1,sell,0,sell,0.4304345659865384,17,0,0,block 1 (G first),23.0,12.0,Male,1.0,1.0,0.0,"[5, 'block 1 (G first)']",0,1,0,1.0,7.0,-0.30000000000000004,0.4,0.05,0.6666666666666666,0.0,1,0.75,1.0,Design 2,Design 2,"Have an option between Design #1 and Design #2,",,5.0,4.0
133,3845,5,Player object (1298),sell,2023-03-09 18:26:49.166513+00:00,"{""priceA"": 120, ""sharesA"": 0, ""secs_since_round_starts"": 183, ""market"": ""A""}",220.0,34.0,8.0,1c9lzru0,vmu7c279,FULL STUDY,195.0,s1,1,120,80.0,1,40.0,1,buy,0,sell,0.5679672812132522,17,0,0,block 1 (G first),23.0,12.0,Male,1.0,1.0,0.0,"[5, 'block 1 (G first)']",0,1,0,1.0,7.0,-0.30000000000000004,0.4,0.05,0.6666666666666666,0.0,1,0.75,1.0,Design 2,Design 2,"Have an option between Design #1 and Design #2,",,5.0,4.0
134,3847,5,Player object (1298),buy,2023-03-09 18:26:58.378052+00:00,"{""priceA"": 110, ""sharesA"": 1, ""secs_since_round_starts"": 192, ""market"": ""A""}",110.0,36.0,9.0,1c9lzru0,vmu7c279,FULL STUDY,195.0,s1,1,110,120.0,-1,,1,sell,0,sell,0.5223936301876935,17,0,0,block 1 (G first),23.0,12.0,Male,1.0,1.0,0.0,"[5, 'block 1 (G first)']",0,1,0,1.0,7.0,-0.30000000000000004,0.4,0.05,0.6666666666666666,0.0,1,0.75,1.0,Design 2,Design 2,"Have an option between Design #1 and Design #2,",,5.0,4.0
135,3848,5,Player object (1298),sell,2023-03-09 18:27:03.024096+00:00,"{""priceA"": 95, ""sharesA"": 0, ""secs_since_round_starts"": 196, ""market"": ""A""}",205.0,37.0,10.0,1c9lzru0,vmu7c279,FULL STUDY,195.0,s1,1,95,110.0,1,-15.0,1,buy,0,sell,0.4805886028013266,17,0,0,block 1 (G first),23.0,12.0,Male,1.0,1.0,0.0,"[5, 'block 1 (G first)']",0,1,0,1.0,7.0,-0.30000000000000004,0.4,0.05,0.6666666666666666,0.0,1,0.75,1.0,Design 2,Design 2,"Have an option between Design #1 and Design #2,",,5.0,4.0
136,3849,5,Player object (1298),buy,2023-03-09 18:27:08.107485+00:00,"{""priceA"": 80, ""sharesA"": 1, ""secs_since_round_starts"": 201, ""market"": ""A""}",125.0,38.0,11.0,1c9lzru0,vmu7c279,FULL STUDY,195.0,s1,1,80,95.0,-1,,1,sell,0,sell,0.4515999245786187,17,1,0,block 1 (G first),23.0,12.0,Male,1.0,1.0,0.0,"[5, 'block 1 (G first)']",0,1,0,1.0,7.0,-0.30000000000000004,0.4,0.05,0.6666666666666666,0.0,1,0.75,1.0,Design 2,Design 2,"Have an option between Design #1 and Design #2,",,5.0,4.0
137,3850,5,Player object (1298),sell,2023-03-09 18:27:30.045355+00:00,"{""priceA"": 100, ""sharesA"": 0, ""secs_since_round_starts"": 223, ""market"": ""A""}",225.0,42.0,12.0,1c9lzru0,vmu7c279,FULL STUDY,195.0,s1,1,100,80.0,1,20.0,1,buy,0,sell,0.5529358605422235,17,0,1,block 1 (G first),23.0,12.0,Male,1.0,1.0,0.0,"[5, 'block 1 (G first)']",0,1,0,1.0,7.0,-0.30000000000000004,0.4,0.05,0.6666666666666666,0.0,1,0.75,1.0,Design 2,Design 2,"Have an option between Design #1 and Design #2,",,5.0,4.0
138,3852,5,Player object (1298),buy,2023-03-09 18:27:53.384304+00:00,"{""priceA"": 95, ""sharesA"": 1, ""secs_since_round_starts"": 247, ""market"": ""A""}",130.0,46.0,13.0,1c9lzru0,vmu7c279,FULL STUDY,195.0,s1,1,95,100.0,-1,,1,sell,0,sell,0.4967862103563366,17,0,0,block 1 (G first),23.0,12.0,Male,1.0,1.0,0.0,"[5, 'block 1 (G first)']",0,1,0,1.0,7.0,-0.30000000000000004,0.4,0.05,0.6666666666666666,0.0,1,0.75,1.0,Design 2,Design 2,"Have an option between Design #1 and Design #2,",,5.0,4.0
139,3120,2,Player object (921),sell,2023-03-09 00:58:09.172346+00:00,"{""priceA"": 120, ""sharesA"": 0, ""secs_since_round_starts"": 75, ""market"": ""A""}",170.0,15.0,1.0,1f2rfly4,vmu7c279,FULL STUDY,150.0,s2,1,120,,1,,1,,0,sell,0.5761373211134116,16,0,0,block 2 (G first),22.0,12.0,Female,1.0,1.0,1.0,"[2, 'block 2 (G first)']",1,1,0,0.5,5.0,-0.5,0.21428571428571427,0.0,0.0,0.0,4,1.0,0.25,Design 1,Design 1,Only trade on Design #1,3.0,,
140,3121,2,Player object (921),buy,2023-03-09 00:58:44.707793+00:00,"{""priceA"": 140, ""sharesA"": 1, ""secs_since_round_starts"": 110, ""market"": ""A""}",30.0,22.0,2.0,1f2rfly4,vmu7c279,FULL STUDY,150.0,s2,1,140,120.0,-1,,1,sell,0,sell,0.5695815034421478,16,0,0,block 2 (G first),22.0,12.0,Female,1.0,1.0,1.0,"[2, 'block 2 (G first)']",1,1,0,0.5,5.0,-0.5,0.21428571428571427,0.0,0.0,0.0,4,1.0,0.25,Design 1,Design 1,Only trade on Design #1,3.0,,
141,3122,2,Player object (921),sell,2023-03-09 00:59:01.729245+00:00,"{""priceA"": 145, ""sharesA"": 0, ""secs_since_round_starts"": 127, ""market"": ""A""}",175.0,25.0,3.0,1f2rfly4,vmu7c279,FULL STUDY,150.0,s2,1,145,140.0,1,5.0,1,buy,0,sell,0.5294358264188312,16,0,0,block 2 (G first),22.0,12.0,Female,1.0,1.0,1.0,"[2, 'block 2 (G first)']",1,1,0,0.5,5.0,-0.5,0.21428571428571427,0.0,0.0,0.0,4,1.0,0.25,Design 1,Design 1,Only trade on Design #1,3.0,,
142,3123,2,Player object (921),buy,2023-03-09 00:59:12.975768+00:00,"{""priceA"": 125, ""sharesA"": 1, ""secs_since_round_starts"": 139, ""market"": ""A""}",50.0,27.0,4.0,1f2rfly4,vmu7c279,FULL STUDY,150.0,s2,1,125,145.0,-1,,1,sell,0,sell,0.4549942201992644,16,1,0,block 2 (G first),22.0,12.0,Female,1.0,1.0,1.0,"[2, 'block 2 (G first)']",1,1,0,0.5,5.0,-0.5,0.21428571428571427,0.0,0.0,0.0,4,1.0,0.25,Design 1,Design 1,Only trade on Design #1,3.0,,
143,3125,2,Player object (921),sell,2023-03-09 01:00:05.682436+00:00,"{""priceA"": 145, ""sharesA"": 0, ""secs_since_round_starts"": 191, ""market"": ""A""}",195.0,37.0,5.0,1f2rfly4,vmu7c279,FULL STUDY,150.0,s2,1,145,125.0,1,20.0,1,buy,0,sell,0.494384744736363,16,0,0,block 2 (G first),22.0,12.0,Female,1.0,1.0,1.0,"[2, 'block 2 (G first)']",1,1,0,0.5,5.0,-0.5,0.21428571428571427,0.0,0.0,0.0,4,1.0,0.25,Design 1,Design 1,Only trade on Design #1,3.0,,
144,3126,2,Player object (921),buy,2023-03-09 01:00:22.707393+00:00,"{""priceA"": 140, ""sharesA"": 1, ""secs_since_round_starts"": 208, ""market"": ""A""}",55.0,40.0,6.0,1f2rfly4,vmu7c279,FULL STUDY,150.0,s2,1,140,145.0,-1,,1,sell,0,sell,0.4916787423410894,16,0,0,block 2 (G first),22.0,12.0,Female,1.0,1.0,1.0,"[2, 'block 2 (G first)']",1,1,0,0.5,5.0,-0.5,0.21428571428571427,0.0,0.0,0.0,4,1.0,0.25,Design 1,Design 1,Only trade on Design #1,3.0,,
145,3127,2,Player object (921),sell,2023-03-09 01:01:00.413340+00:00,"{""priceA"": 140, ""sharesA"": 0, ""secs_since_round_starts"": 246, ""market"": ""A""}",195.0,47.0,7.0,1f2rfly4,vmu7c279,FULL STUDY,150.0,s2,1,140,140.0,1,0.0,1,buy,0,sell,0.4996814899229063,16,0,0,block 2 (G first),22.0,12.0,Female,1.0,1.0,1.0,"[2, 'block 2 (G first)']",1,1,0,0.5,5.0,-0.5,0.21428571428571427,0.0,0.0,0.0,4,1.0,0.25,Design 1,Design 1,Only trade on Design #1,3.0,,
146,3128,2,Player object (921),buy,2023-03-09 01:01:12.487493+00:00,"{""priceA"": 170, ""sharesA"": 1, ""secs_since_round_starts"": 258, ""market"": ""A""}",25.0,49.0,8.0,1f2rfly4,vmu7c279,FULL STUDY,150.0,s2,1,170,140.0,-1,,1,sell,0,sell,0.5589355340840079,16,0,0,block 2 (G first),22.0,12.0,Female,1.0,1.0,1.0,"[2, 'block 2 (G first)']",1,1,0,0.5,5.0,-0.5,0.21428571428571427,0.0,0.0,0.0,4,1.0,0.25,Design 1,Design 1,Only trade on Design #1,3.0,,
147,3132,3,Player object (1041),sell,2023-03-09 01:02:57.243324+00:00,"{""priceA"": 100, ""sharesA"": 0, ""secs_since_round_starts"": 38, ""market"": ""A""}",150.0,8.0,1.0,1f2rfly4,vmu7c279,FULL STUDY,200.0,s2,1,100,,1,,1,,0,sell,0.5057155770500936,19,0,0,block 2 (G first),22.0,12.0,Female,1.0,1.0,1.0,"[3, 'block 2 (G first)']",1,0,0,0.5,5.0,-0.5,0.26666666666666666,0.11764705882352941,0.0,0.0,2,0.5,0.25,Design 1,Design 1,Only trade on Design #1,3.0,,
148,3133,3,Player object (1041),buy,2023-03-09 01:03:08.019345+00:00,"{""priceA"": 95, ""sharesA"": 1, ""secs_since_round_starts"": 49, ""market"": ""A""}",55.0,10.0,2.0,1f2rfly4,vmu7c279,FULL STUDY,200.0,s2,1,95,100.0,-1,,1,sell,0,sell,0.4922087569005138,19,0,0,block 2 (G first),22.0,12.0,Female,1.0,1.0,1.0,"[3, 'block 2 (G first)']",1,0,0,0.5,5.0,-0.5,0.26666666666666666,0.11764705882352941,0.0,0.0,2,0.5,0.25,Design 1,Design 1,Only trade on Design #1,3.0,,
149,3134,3,Player object (1041),sell,2023-03-09 01:03:28.955302+00:00,"{""priceA"": 125, ""sharesA"": 0, ""secs_since_round_starts"": 70, ""market"": ""A""}",180.0,14.0,3.0,1f2rfly4,vmu7c279,FULL STUDY,200.0,s2,1,125,95.0,1,30.0,1,buy,0,sell,0.5163117828594225,19,0,0,block 2 (G first),22.0,12.0,Female,1.0,1.0,1.0,"[3, 'block 2 (G first)']",1,0,0,0.5,5.0,-0.5,0.26666666666666666,0.11764705882352941,0.0,0.0,2,0.5,0.25,Design 1,Design 1,Only trade on Design #1,3.0,,
150,3135,3,Player object (1041),buy,2023-03-09 01:03:45.957452+00:00,"{""priceA"": 105, ""sharesA"": 1, ""secs_since_round_starts"": 87, ""market"": ""A""}",75.0,17.0,4.0,1f2rfly4,vmu7c279,FULL STUDY,200.0,s2,1,105,125.0,-1,,1,sell,0,sell,0.4990675303551922,19,0,0,block 2 (G first),22.0,12.0,Female,1.0,1.0,1.0,"[3, 'block 2 (G first)']",1,0,0,0.5,5.0,-0.5,0.26666666666666666,0.11764705882352941,0.0,0.0,2,0.5,0.25,Design 1,Design 1,Only trade on Design #1,3.0,,
151,3136,3,Player object (1041),sell,2023-03-09 01:04:03.603215+00:00,"{""priceA"": 115, ""sharesA"": 0, ""secs_since_round_starts"": 104, ""market"": ""A""}",190.0,20.0,5.0,1f2rfly4,vmu7c279,FULL STUDY,200.0,s2,1,115,105.0,1,10.0,1,buy,0,sell,0.5061230669509241,19,0,0,block 2 (G first),22.0,12.0,Female,1.0,1.0,1.0,"[3, 'block 2 (G first)']",1,0,0,0.5,5.0,-0.5,0.26666666666666666,0.11764705882352941,0.0,0.0,2,0.5,0.25,Design 1,Design 1,Only trade on Design #1,3.0,,
152,3137,3,Player object (1041),buy,2023-03-09 01:04:13.986795+00:00,"{""priceA"": 85, ""sharesA"": 1, ""secs_since_round_starts"": 115, ""market"": ""A""}",105.0,22.0,6.0,1f2rfly4,vmu7c279,FULL STUDY,200.0,s2,1,85,115.0,-1,,1,sell,0,sell,0.443819468959905,19,1,0,block 2 (G first),22.0,12.0,Female,1.0,1.0,1.0,"[3, 'block 2 (G first)']",1,0,0,0.5,5.0,-0.5,0.26666666666666666,0.11764705882352941,0.0,0.0,2,0.5,0.25,Design 1,Design 1,Only trade on Design #1,3.0,,
153,3138,3,Player object (1041),sell,2023-03-09 01:04:29.785007+00:00,"{""priceA"": 110, ""sharesA"": 0, ""secs_since_round_starts"": 131, ""market"": ""A""}",215.0,25.0,7.0,1f2rfly4,vmu7c279,FULL STUDY,200.0,s2,1,110,85.0,1,25.0,1,buy,0,sell,0.4872943409941583,19,0,0,block 2 (G first),22.0,12.0,Female,1.0,1.0,1.0,"[3, 'block 2 (G first)']",1,0,0,0.5,5.0,-0.5,0.26666666666666666,0.11764705882352941,0.0,0.0,2,0.5,0.25,Design 1,Design 1,Only trade on Design #1,3.0,,
154,3139,3,Player object (1041),buy,2023-03-09 01:04:36.892019+00:00,"{""priceA"": 115, ""sharesA"": 1, ""secs_since_round_starts"": 138, ""market"": ""A""}",100.0,26.0,8.0,1f2rfly4,vmu7c279,FULL STUDY,200.0,s2,1,115,110.0,-1,,1,sell,0,sell,0.526172546586359,19,0,0,block 2 (G first),22.0,12.0,Female,1.0,1.0,1.0,"[3, 'block 2 (G first)']",1,0,0,0.5,5.0,-0.5,0.26666666666666666,0.11764705882352941,0.0,0.0,2,0.5,0.25,Design 1,Design 1,Only trade on Design #1,3.0,,
155,3143,3,Player object (1041),sell,2023-03-09 01:05:08.129988+00:00,"{""priceA"": 110, ""sharesA"": 0, ""secs_since_round_starts"": 169, ""market"": ""A""}",210.0,32.0,10.0,1f2rfly4,vmu7c279,FULL STUDY,200.0,s2,1,110,110.0,1,0.0,1,buy,0,sell,0.4748947710808772,19,0,0,block 2 (G first),22.0,12.0,Female,1.0,1.0,1.0,"[3, 'block 2 (G first)']",1,0,0,0.5,5.0,-0.5,0.26666666666666666,0.11764705882352941,0.0,0.0,2,0.5,0.25,Design 1,Design 1,Only trade on Design #1,3.0,,
156,3144,3,Player object (1041),buy,2023-03-09 01:05:19.376504+00:00,"{""priceA"": 110, ""sharesA"": 1, ""secs_since_round_starts"": 180, ""market"": ""A""}",100.0,34.0,11.0,1f2rfly4,vmu7c279,FULL STUDY,200.0,s2,1,110,110.0,-1,,1,sell,0,sell,0.4983651933170437,19,0,0,block 2 (G first),22.0,12.0,Female,1.0,1.0,1.0,"[3, 'block 2 (G first)']",1,0,0,0.5,5.0,-0.5,0.26666666666666666,0.11764705882352941,0.0,0.0,2,0.5,0.25,Design 1,Design 1,Only trade on Design #1,3.0,,
157,3145,3,Player object (1041),sell,2023-03-09 01:05:59.960780+00:00,"{""priceA"": 95, ""sharesA"": 0, ""secs_since_round_starts"": 221, ""market"": ""A""}",195.0,41.0,12.0,1f2rfly4,vmu7c279,FULL STUDY,200.0,s2,1,95,110.0,1,-15.0,1,buy,0,sell,0.4514823197003955,19,0,0,block 2 (G first),22.0,12.0,Female,1.0,1.0,1.0,"[3, 'block 2 (G first)']",1,0,0,0.5,5.0,-0.5,0.26666666666666666,0.11764705882352941,0.0,0.0,2,0.5,0.25,Design 1,Design 1,Only trade on Design #1,3.0,,
158,3146,3,Player object (1041),buy,2023-03-09 01:06:07.139865+00:00,"{""priceA"": 120, ""sharesA"": 1, ""secs_since_round_starts"": 228, ""market"": ""A""}",75.0,43.0,13.0,1f2rfly4,vmu7c279,FULL STUDY,200.0,s2,1,120,95.0,-1,,1,sell,0,sell,0.5357259670782416,19,0,0,block 2 (G first),22.0,12.0,Female,1.0,1.0,1.0,"[3, 'block 2 (G first)']",1,0,0,0.5,5.0,-0.5,0.26666666666666666,0.11764705882352941,0.0,0.0,2,0.5,0.25,Design 1,Design 1,Only trade on Design #1,3.0,,
159,3147,3,Player object (1041),sell,2023-03-09 01:06:17.890628+00:00,"{""priceA"": 125, ""sharesA"": 0, ""secs_since_round_starts"": 239, ""market"": ""A""}",200.0,45.0,14.0,1f2rfly4,vmu7c279,FULL STUDY,200.0,s2,1,125,120.0,1,5.0,1,buy,0,sell,0.5067886105922249,19,0,0,block 2 (G first),22.0,12.0,Female,1.0,1.0,1.0,"[3, 'block 2 (G first)']",1,0,0,0.5,5.0,-0.5,0.26666666666666666,0.11764705882352941,0.0,0.0,2,0.5,0.25,Design 1,Design 1,Only trade on Design #1,3.0,,
160,3148,3,Player object (1041),buy,2023-03-09 01:06:29.986937+00:00,"{""priceA"": 130, ""sharesA"": 1, ""secs_since_round_starts"": 251, ""market"": ""A""}",70.0,47.0,15.0,1f2rfly4,vmu7c279,FULL STUDY,200.0,s2,1,130,125.0,-1,,1,sell,0,sell,0.4927309765460438,19,0,0,block 2 (G first),22.0,12.0,Female,1.0,1.0,1.0,"[3, 'block 2 (G first)']",1,0,0,0.5,5.0,-0.5,0.26666666666666666,0.11764705882352941,0.0,0.0,2,0.5,0.25,Design 1,Design 1,Only trade on Design #1,3.0,,
161,3149,3,Player object (1041),sell,2023-03-09 01:07:04.234490+00:00,"{""priceA"": 130, ""sharesA"": 0, ""secs_since_round_starts"": 285, ""market"": ""A""}",200.0,53.0,16.0,1f2rfly4,vmu7c279,FULL STUDY,200.0,s2,1,130,130.0,1,0.0,1,buy,0,sell,0.4905868559773416,19,0,0,block 2 (G first),22.0,12.0,Female,1.0,1.0,1.0,"[3, 'block 2 (G first)']",1,0,0,0.5,5.0,-0.5,0.26666666666666666,0.11764705882352941,0.0,0.0,2,0.5,0.25,Design 1,Design 1,Only trade on Design #1,3.0,,
162,3152,3,Player object (1041),buy,2023-03-09 01:07:31.004040+00:00,"{""priceA"": 115, ""sharesA"": 1, ""secs_since_round_starts"": 312, ""market"": ""A""}",85.0,58.0,18.0,1f2rfly4,vmu7c279,FULL STUDY,200.0,s2,1,115,130.0,-1,,1,sell,0,sell,0.442461876115205,19,1,0,block 2 (G first),22.0,12.0,Female,1.0,1.0,1.0,"[3, 'block 2 (G first)']",1,0,0,0.5,5.0,-0.5,0.26666666666666666,0.11764705882352941,0.0,0.0,2,0.5,0.25,Design 1,Design 1,Only trade on Design #1,3.0,,
163,3157,4,Player object (1161),sell,2023-03-09 01:13:03.533419+00:00,"{""priceA"": 90, ""sharesA"": 0, ""secs_since_round_starts"": 62, ""market"": ""A""}",140.0,12.0,1.0,1f2rfly4,vmu7c279,FULL STUDY,150.0,s2,1,90,,1,,1,,0,sell,0.5210961257750505,14,0,0,block 2 (G first),22.0,12.0,Female,1.0,1.0,1.0,"[4, 'block 2 (G first)']",0,1,0,0.5,5.0,-0.5,0.2,0.06451612903225806,0.0,0.0,4,0.5,0.25,Design 1,Design 1,Only trade on Design #1,3.0,,
164,3160,4,Player object (1161),buy,2023-03-09 01:13:21.009288+00:00,"{""priceA"": 95, ""sharesA"": 1, ""secs_since_round_starts"": 80, ""market"": ""A""}",45.0,15.0,2.0,1f2rfly4,vmu7c279,FULL STUDY,150.0,s2,1,95,90.0,-1,,1,sell,0,sell,0.5493972040799432,14,0,0,block 2 (G first),22.0,12.0,Female,1.0,1.0,1.0,"[4, 'block 2 (G first)']",0,1,0,0.5,5.0,-0.5,0.2,0.06451612903225806,0.0,0.0,4,0.5,0.25,Design 1,Design 1,Only trade on Design #1,3.0,,
165,3162,4,Player object (1161),sell,2023-03-09 01:13:28.271189+00:00,"{""priceA"": 90, ""sharesA"": 0, ""secs_since_round_starts"": 87, ""market"": ""A""}",135.0,16.0,3.0,1f2rfly4,vmu7c279,FULL STUDY,150.0,s2,1,90,95.0,1,-5.0,1,buy,0,sell,0.4995738325599586,14,0,0,block 2 (G first),22.0,12.0,Female,1.0,1.0,1.0,"[4, 'block 2 (G first)']",0,1,0,0.5,5.0,-0.5,0.2,0.06451612903225806,0.0,0.0,4,0.5,0.25,Design 1,Design 1,Only trade on Design #1,3.0,,
166,3165,4,Player object (1161),buy,2023-03-09 01:13:47.634989+00:00,"{""priceA"": 70, ""sharesA"": 1, ""secs_since_round_starts"": 106, ""market"": ""A""}",65.0,20.0,4.0,1f2rfly4,vmu7c279,FULL STUDY,150.0,s2,1,70,90.0,-1,,1,sell,0,sell,0.4604462199730844,14,0,0,block 2 (G first),22.0,12.0,Female,1.0,1.0,1.0,"[4, 'block 2 (G first)']",0,1,0,0.5,5.0,-0.5,0.2,0.06451612903225806,0.0,0.0,4,0.5,0.25,Design 1,Design 1,Only trade on Design #1,3.0,,
167,3167,4,Player object (1161),sell,2023-03-09 01:14:43.023396+00:00,"{""priceA"": 85, ""sharesA"": 0, ""secs_since_round_starts"": 162, ""market"": ""A""}",150.0,30.0,5.0,1f2rfly4,vmu7c279,FULL STUDY,150.0,s2,1,85,70.0,1,15.0,1,buy,0,sell,0.5151109892827086,14,0,0,block 2 (G first),22.0,12.0,Female,1.0,1.0,1.0,"[4, 'block 2 (G first)']",0,1,0,0.5,5.0,-0.5,0.2,0.06451612903225806,0.0,0.0,4,0.5,0.25,Design 1,Design 1,Only trade on Design #1,3.0,,
168,3169,4,Player object (1161),buy,2023-03-09 01:15:04.434766+00:00,"{""priceA"": 100, ""sharesA"": 1, ""secs_since_round_starts"": 183, ""market"": ""A""}",50.0,33.0,6.0,1f2rfly4,vmu7c279,FULL STUDY,150.0,s2,1,100,85.0,-1,,1,sell,0,sell,0.5473882863317556,14,0,0,block 2 (G first),22.0,12.0,Female,1.0,1.0,1.0,"[4, 'block 2 (G first)']",0,1,0,0.5,5.0,-0.5,0.2,0.06451612903225806,0.0,0.0,4,0.5,0.25,Design 1,Design 1,Only trade on Design #1,3.0,,
169,3176,4,Player object (1161),sell,2023-03-09 01:16:28.892032+00:00,"{""priceA"": 100, ""sharesA"": 0, ""secs_since_round_starts"": 268, ""market"": ""A""}",150.0,48.0,8.0,1f2rfly4,vmu7c279,FULL STUDY,150.0,s2,1,100,100.0,1,0.0,1,buy,0,sell,0.500105737602651,14,0,0,block 2 (G first),22.0,12.0,Female,1.0,1.0,1.0,"[4, 'block 2 (G first)']",0,1,0,0.5,5.0,-0.5,0.2,0.06451612903225806,0.0,0.0,4,0.5,0.25,Design 1,Design 1,Only trade on Design #1,3.0,,
170,3181,4,Player object (1161),buy,2023-03-09 01:16:52.155338+00:00,"{""priceA"": 75, ""sharesA"": 1, ""secs_since_round_starts"": 291, ""market"": ""A""}",75.0,53.0,10.0,1f2rfly4,vmu7c279,FULL STUDY,150.0,s2,1,75,105.0,-1,,1,sell,0,sell,0.4439854633835125,14,1,0,block 2 (G first),22.0,12.0,Female,1.0,1.0,1.0,"[4, 'block 2 (G first)']",0,1,0,0.5,5.0,-0.5,0.2,0.06451612903225806,0.0,0.0,4,0.5,0.25,Design 1,Design 1,Only trade on Design #1,3.0,,
171,3190,5,Player object (1281),sell,2023-03-09 01:19:03.190991+00:00,"{""priceA"": 85, ""sharesA"": 0, ""secs_since_round_starts"": 63, ""market"": ""A""}",135.0,13.0,1.0,1f2rfly4,vmu7c279,FULL STUDY,195.0,s2,1,85,,1,,1,,0,sell,0.4890232705715233,17,0,0,block 2 (G first),22.0,12.0,Female,1.0,1.0,1.0,"[5, 'block 2 (G first)']",0,0,0,0.5,5.0,-0.5,0.23529411764705882,0.10526315789473684,0.0,0.16666666666666666,2,1.0,0.5,Design 1,Design 1,Only trade on Design #1,3.0,,
172,3193,5,Player object (1281),buy,2023-03-09 01:19:12.888586+00:00,"{""priceA"": 90, ""sharesA"": 1, ""secs_since_round_starts"": 73, ""market"": ""A""}",45.0,15.0,2.0,1f2rfly4,vmu7c279,FULL STUDY,195.0,s2,1,90,85.0,-1,,1,sell,0,sell,0.505231414156075,17,0,0,block 2 (G first),22.0,12.0,Female,1.0,1.0,1.0,"[5, 'block 2 (G first)']",0,0,0,0.5,5.0,-0.5,0.23529411764705882,0.10526315789473684,0.0,0.16666666666666666,2,1.0,0.5,Design 1,Design 1,Only trade on Design #1,3.0,,
173,3195,5,Player object (1281),sell,2023-03-09 01:19:44.721439+00:00,"{""priceA"": 95, ""sharesA"": 0, ""secs_since_round_starts"": 105, ""market"": ""A""}",140.0,20.0,3.0,1f2rfly4,vmu7c279,FULL STUDY,195.0,s2,1,95,90.0,1,5.0,1,buy,0,sell,0.5232479875730728,17,0,0,block 2 (G first),22.0,12.0,Female,1.0,1.0,1.0,"[5, 'block 2 (G first)']",0,0,0,0.5,5.0,-0.5,0.23529411764705882,0.10526315789473684,0.0,0.16666666666666666,2,1.0,0.5,Design 1,Design 1,Only trade on Design #1,3.0,,
174,3196,5,Player object (1281),buy,2023-03-09 01:19:58.222337+00:00,"{""priceA"": 95, ""sharesA"": 1, ""secs_since_round_starts"": 118, ""market"": ""A""}",45.0,23.0,4.0,1f2rfly4,vmu7c279,FULL STUDY,195.0,s2,1,95,95.0,-1,,1,sell,0,sell,0.5355078155027276,17,0,0,block 2 (G first),22.0,12.0,Female,1.0,1.0,1.0,"[5, 'block 2 (G first)']",0,0,0,0.5,5.0,-0.5,0.23529411764705882,0.10526315789473684,0.0,0.16666666666666666,2,1.0,0.5,Design 1,Design 1,Only trade on Design #1,3.0,,
175,3198,5,Player object (1281),sell,2023-03-09 01:20:29.161667+00:00,"{""priceA"": 85, ""sharesA"": 0, ""secs_since_round_starts"": 149, ""market"": ""A""}",130.0,28.0,5.0,1f2rfly4,vmu7c279,FULL STUDY,195.0,s2,1,85,95.0,1,-10.0,1,buy,0,sell,0.4496194529460131,17,1,0,block 2 (G first),22.0,12.0,Female,1.0,1.0,1.0,"[5, 'block 2 (G first)']",0,0,0,0.5,5.0,-0.5,0.23529411764705882,0.10526315789473684,0.0,0.16666666666666666,2,1.0,0.5,Design 1,Design 1,Only trade on Design #1,3.0,,
176,3199,5,Player object (1281),buy,2023-03-09 01:20:38.197998+00:00,"{""priceA"": 70, ""sharesA"": 1, ""secs_since_round_starts"": 158, ""market"": ""A""}",60.0,30.0,6.0,1f2rfly4,vmu7c279,FULL STUDY,195.0,s2,1,70,85.0,-1,,1,sell,0,sell,0.4174526841611717,17,0,0,block 2 (G first),22.0,12.0,Female,1.0,1.0,1.0,"[5, 'block 2 (G first)']",0,0,0,0.5,5.0,-0.5,0.23529411764705882,0.10526315789473684,0.0,0.16666666666666666,2,1.0,0.5,Design 1,Design 1,Only trade on Design #1,3.0,,
177,3201,5,Player object (1281),sell,2023-03-09 01:21:01.211594+00:00,"{""priceA"": 120, ""sharesA"": 0, ""secs_since_round_starts"": 181, ""market"": ""A""}",180.0,34.0,7.0,1f2rfly4,vmu7c279,FULL STUDY,195.0,s2,1,120,70.0,1,50.0,1,buy,0,sell,0.5679672812132522,17,0,0,block 2 (G first),22.0,12.0,Female,1.0,1.0,1.0,"[5, 'block 2 (G first)']",0,0,0,0.5,5.0,-0.5,0.23529411764705882,0.10526315789473684,0.0,0.16666666666666666,2,1.0,0.5,Design 1,Design 1,Only trade on Design #1,3.0,,
178,3203,5,Player object (1281),buy,2023-03-09 01:21:21.672938+00:00,"{""priceA"": 95, ""sharesA"": 1, ""secs_since_round_starts"": 202, ""market"": ""A""}",85.0,37.0,8.0,1f2rfly4,vmu7c279,FULL STUDY,195.0,s2,1,95,120.0,-1,,1,sell,0,sell,0.4805886028013266,17,0,0,block 2 (G first),22.0,12.0,Female,1.0,1.0,1.0,"[5, 'block 2 (G first)']",0,0,0,0.5,5.0,-0.5,0.23529411764705882,0.10526315789473684,0.0,0.16666666666666666,2,1.0,0.5,Design 1,Design 1,Only trade on Design #1,3.0,,
179,3209,5,Player object (1281),sell,2023-03-09 01:21:55.716846+00:00,"{""priceA"": 105, ""sharesA"": 0, ""secs_since_round_starts"": 236, ""market"": ""A""}",190.0,44.0,10.0,1f2rfly4,vmu7c279,FULL STUDY,195.0,s2,1,105,80.0,1,25.0,1,buy,0,sell,0.515125859635568,17,0,0,block 2 (G first),22.0,12.0,Female,1.0,1.0,1.0,"[5, 'block 2 (G first)']",0,0,0,0.5,5.0,-0.5,0.23529411764705882,0.10526315789473684,0.0,0.16666666666666666,2,1.0,0.5,Design 1,Design 1,Only trade on Design #1,3.0,,
180,3212,5,Player object (1281),buy,2023-03-09 01:22:22.067216+00:00,"{""priceA"": 75, ""sharesA"": 1, ""secs_since_round_starts"": 262, ""market"": ""A""}",115.0,48.0,11.0,1f2rfly4,vmu7c279,FULL STUDY,195.0,s2,1,75,105.0,-1,,1,sell,0,sell,0.4393932183506925,17,1,0,block 2 (G first),22.0,12.0,Female,1.0,1.0,1.0,"[5, 'block 2 (G first)']",0,0,0,0.5,5.0,-0.5,0.23529411764705882,0.10526315789473684,0.0,0.16666666666666666,2,1.0,0.5,Design 1,Design 1,Only trade on Design #1,3.0,,
181,3214,5,Player object (1281),sell,2023-03-09 01:22:41.702802+00:00,"{""priceA"": 95, ""sharesA"": 0, ""secs_since_round_starts"": 282, ""market"": ""A""}",210.0,52.0,12.0,1f2rfly4,vmu7c279,FULL STUDY,195.0,s2,1,95,75.0,1,20.0,1,buy,0,sell,0.5397855680881701,17,0,0,block 2 (G first),22.0,12.0,Female,1.0,1.0,1.0,"[5, 'block 2 (G first)']",0,0,0,0.5,5.0,-0.5,0.23529411764705882,0.10526315789473684,0.0,0.16666666666666666,2,1.0,0.5,Design 1,Design 1,Only trade on Design #1,3.0,,
182,3215,5,Player object (1281),buy,2023-03-09 01:22:57.080175+00:00,"{""priceA"": 80, ""sharesA"": 1, ""secs_since_round_starts"": 297, ""market"": ""A""}",130.0,55.0,13.0,1f2rfly4,vmu7c279,FULL STUDY,195.0,s2,1,80,95.0,-1,,1,sell,0,sell,0.4859141076178286,17,0,0,block 2 (G first),22.0,12.0,Female,1.0,1.0,1.0,"[5, 'block 2 (G first)']",0,0,0,0.5,5.0,-0.5,0.23529411764705882,0.10526315789473684,0.0,0.16666666666666666,2,1.0,0.5,Design 1,Design 1,Only trade on Design #1,3.0,,
183,4929,2,Player object (951),sell,2023-03-10 10:38:19.398818+00:00,"{""priceA"": 110, ""sharesA"": 0, ""secs_since_round_starts"": 34, ""market"": ""A""}",160.0,6.0,1.0,2f9gqu83,vmu7c279,FULL STUDY,230.0,s2,1,110,,1,,1,,0,sell,0.5028735207100592,16,0,0,block 3 (G second),20.0,11.0,Female,1.0,0.0,1.0,"[2, 'block 3 (G second)']",0,0,1,0.0,2.0,-0.7166666666666666,0.2777777777777778,0.08333333333333333,0.25,0.0,4,1.0,0.5,Design 2,Design 2,"Have an option between Design #1 and Design #2,",5.0,,
184,4930,2,Player object (951),buy,2023-03-10 10:38:29.376403+00:00,"{""priceA"": 85, ""sharesA"": 1, ""secs_since_round_starts"": 44, ""market"": ""A""}",75.0,8.0,2.0,2f9gqu83,vmu7c279,FULL STUDY,230.0,s2,1,85,110.0,-1,,1,sell,0,sell,0.4422758127435268,16,1,0,block 3 (G second),20.0,11.0,Female,1.0,0.0,1.0,"[2, 'block 3 (G second)']",0,0,1,0.0,2.0,-0.7166666666666666,0.2777777777777778,0.08333333333333333,0.25,0.0,4,1.0,0.5,Design 2,Design 2,"Have an option between Design #1 and Design #2,",5.0,,
185,4931,2,Player object (951),sell,2023-03-10 10:39:08.772516+00:00,"{""priceA"": 120, ""sharesA"": 0, ""secs_since_round_starts"": 83, ""market"": ""A""}",195.0,15.0,3.0,2f9gqu83,vmu7c279,FULL STUDY,230.0,s2,1,120,85.0,1,35.0,1,buy,0,sell,0.5761373211134116,16,0,0,block 3 (G second),20.0,11.0,Female,1.0,0.0,1.0,"[2, 'block 3 (G second)']",0,0,1,0.0,2.0,-0.7166666666666666,0.2777777777777778,0.08333333333333333,0.25,0.0,4,1.0,0.5,Design 2,Design 2,"Have an option between Design #1 and Design #2,",5.0,,
186,4932,2,Player object (951),buy,2023-03-10 10:39:47.269918+00:00,"{""priceA"": 140, ""sharesA"": 1, ""secs_since_round_starts"": 122, ""market"": ""A""}",55.0,22.0,4.0,2f9gqu83,vmu7c279,FULL STUDY,230.0,s2,1,140,120.0,-1,,1,sell,0,sell,0.5695815034421478,16,0,0,block 3 (G second),20.0,11.0,Female,1.0,0.0,1.0,"[2, 'block 3 (G second)']",0,0,1,0.0,2.0,-0.7166666666666666,0.2777777777777778,0.08333333333333333,0.25,0.0,4,1.0,0.5,Design 2,Design 2,"Have an option between Design #1 and Design #2,",5.0,,
187,4933,2,Player object (951),sell,2023-03-10 10:39:51.974893+00:00,"{""priceA"": 150, ""sharesA"": 0, ""secs_since_round_starts"": 126, ""market"": ""A""}",205.0,23.0,5.0,2f9gqu83,vmu7c279,FULL STUDY,230.0,s2,1,150,140.0,1,10.0,1,buy,0,sell,0.5825581483921976,16,0,1,block 3 (G second),20.0,11.0,Female,1.0,0.0,1.0,"[2, 'block 3 (G second)']",0,0,1,0.0,2.0,-0.7166666666666666,0.2777777777777778,0.08333333333333333,0.25,0.0,4,1.0,0.5,Design 2,Design 2,"Have an option between Design #1 and Design #2,",5.0,,
188,4934,2,Player object (951),buy,2023-03-10 10:40:26.459607+00:00,"{""priceA"": 115, ""sharesA"": 1, ""secs_since_round_starts"": 161, ""market"": ""A""}",90.0,29.0,6.0,2f9gqu83,vmu7c279,FULL STUDY,230.0,s2,1,115,150.0,-1,,1,sell,0,sell,0.41991811093665,16,0,0,block 3 (G second),20.0,11.0,Female,1.0,0.0,1.0,"[2, 'block 3 (G second)']",0,0,1,0.0,2.0,-0.7166666666666666,0.2777777777777778,0.08333333333333333,0.25,0.0,4,1.0,0.5,Design 2,Design 2,"Have an option between Design #1 and Design #2,",5.0,,
189,4936,2,Player object (951),sell,2023-03-10 10:41:09.484212+00:00,"{""priceA"": 145, ""sharesA"": 0, ""secs_since_round_starts"": 204, ""market"": ""A""}",235.0,37.0,7.0,2f9gqu83,vmu7c279,FULL STUDY,230.0,s2,1,145,115.0,1,30.0,1,buy,0,sell,0.494384744736363,16,0,0,block 3 (G second),20.0,11.0,Female,1.0,0.0,1.0,"[2, 'block 3 (G second)']",0,0,1,0.0,2.0,-0.7166666666666666,0.2777777777777778,0.08333333333333333,0.25,0.0,4,1.0,0.5,Design 2,Design 2,"Have an option between Design #1 and Design #2,",5.0,,
190,4937,2,Player object (951),buy,2023-03-10 10:41:27.793842+00:00,"{""priceA"": 140, ""sharesA"": 1, ""secs_since_round_starts"": 222, ""market"": ""A""}",95.0,40.0,8.0,2f9gqu83,vmu7c279,FULL STUDY,230.0,s2,1,140,145.0,-1,,1,sell,0,sell,0.4916787423410894,16,0,0,block 3 (G second),20.0,11.0,Female,1.0,0.0,1.0,"[2, 'block 3 (G second)']",0,0,1,0.0,2.0,-0.7166666666666666,0.2777777777777778,0.08333333333333333,0.25,0.0,4,1.0,0.5,Design 2,Design 2,"Have an option between Design #1 and Design #2,",5.0,,
191,4938,2,Player object (951),sell,2023-03-10 10:42:04.787573+00:00,"{""priceA"": 140, ""sharesA"": 0, ""secs_since_round_starts"": 259, ""market"": ""A""}",235.0,47.0,9.0,2f9gqu83,vmu7c279,FULL STUDY,230.0,s2,1,140,140.0,1,0.0,1,buy,0,sell,0.4996814899229063,16,0,0,block 3 (G second),20.0,11.0,Female,1.0,0.0,1.0,"[2, 'block 3 (G second)']",0,0,1,0.0,2.0,-0.7166666666666666,0.2777777777777778,0.08333333333333333,0.25,0.0,4,1.0,0.5,Design 2,Design 2,"Have an option between Design #1 and Design #2,",5.0,,
192,4939,2,Player object (951),buy,2023-03-10 10:42:15.172741+00:00,"{""priceA"": 170, ""sharesA"": 1, ""secs_since_round_starts"": 270, ""market"": ""A""}",65.0,49.0,10.0,2f9gqu83,vmu7c279,FULL STUDY,230.0,s2,1,170,140.0,-1,,1,sell,0,sell,0.5589355340840079,16,0,0,block 3 (G second),20.0,11.0,Female,1.0,0.0,1.0,"[2, 'block 3 (G second)']",0,0,1,0.0,2.0,-0.7166666666666666,0.2777777777777778,0.08333333333333333,0.25,0.0,4,1.0,0.5,Design 2,Design 2,"Have an option between Design #1 and Design #2,",5.0,,
193,4940,2,Player object (951),sell,2023-03-10 10:42:20.635740+00:00,"{""priceA"": 155, ""sharesA"": 0, ""secs_since_round_starts"": 275, ""market"": ""A""}",220.0,50.0,11.0,2f9gqu83,vmu7c279,FULL STUDY,230.0,s2,1,155,170.0,1,-15.0,1,buy,0,sell,0.5063294801170398,16,0,0,block 3 (G second),20.0,11.0,Female,1.0,0.0,1.0,"[2, 'block 3 (G second)']",0,0,1,0.0,2.0,-0.7166666666666666,0.2777777777777778,0.08333333333333333,0.25,0.0,4,1.0,0.5,Design 2,Design 2,"Have an option between Design #1 and Design #2,",5.0,,
194,4941,2,Player object (951),buy,2023-03-10 10:42:30.756561+00:00,"{""priceA"": 125, ""sharesA"": 1, ""secs_since_round_starts"": 285, ""market"": ""A""}",95.0,52.0,12.0,2f9gqu83,vmu7c279,FULL STUDY,230.0,s2,1,125,155.0,-1,,1,sell,0,sell,0.4439176376077041,16,1,0,block 3 (G second),20.0,11.0,Female,1.0,0.0,1.0,"[2, 'block 3 (G second)']",0,0,1,0.0,2.0,-0.7166666666666666,0.2777777777777778,0.08333333333333333,0.25,0.0,4,1.0,0.5,Design 2,Design 2,"Have an option between Design #1 and Design #2,",5.0,,
195,4942,2,Player object (951),sell,2023-03-10 10:42:49.934968+00:00,"{""priceA"": 135, ""sharesA"": 0, ""secs_since_round_starts"": 304, ""market"": ""A""}",230.0,55.0,13.0,2f9gqu83,vmu7c279,FULL STUDY,230.0,s2,1,135,125.0,1,10.0,1,buy,0,sell,0.4873282494519479,16,0,0,block 3 (G second),20.0,11.0,Female,1.0,0.0,1.0,"[2, 'block 3 (G second)']",0,0,1,0.0,2.0,-0.7166666666666666,0.2777777777777778,0.08333333333333333,0.25,0.0,4,1.0,0.5,Design 2,Design 2,"Have an option between Design #1 and Design #2,",5.0,,
196,4943,2,Player object (951),buy,2023-03-10 10:42:53.534396+00:00,"{""priceA"": 125, ""sharesA"": 1, ""secs_since_round_starts"": 308, ""market"": ""A""}",105.0,56.0,14.0,2f9gqu83,vmu7c279,FULL STUDY,230.0,s2,1,125,135.0,-1,,1,sell,0,sell,0.4562406760637778,16,0,0,block 3 (G second),20.0,11.0,Female,1.0,0.0,1.0,"[2, 'block 3 (G second)']",0,0,1,0.0,2.0,-0.7166666666666666,0.2777777777777778,0.08333333333333333,0.25,0.0,4,1.0,0.5,Design 2,Design 2,"Have an option between Design #1 and Design #2,",5.0,,
197,4947,3,Player object (1071),sell,2023-03-10 10:44:27.804189+00:00,"{""priceA"": 120, ""sharesA"": 0, ""secs_since_round_starts"": 66, ""market"": ""A""}",170.0,12.0,1.0,2f9gqu83,vmu7c279,FULL STUDY,245.0,s2,1,120,,1,,1,,0,sell,0.5553867656170776,19,0,0,block 3 (G second),20.0,11.0,Female,1.0,0.0,1.0,"[3, 'block 3 (G second)']",0,1,1,0.5,2.0,-0.7166666666666666,0.375,0.0,0.6666666666666666,0.0,2,0.5,0.75,Design 2,Design 2,"Have an option between Design #1 and Design #2,",5.0,,
198,4948,3,Player object (1071),buy,2023-03-10 10:44:54.174897+00:00,"{""priceA"": 105, ""sharesA"": 1, ""secs_since_round_starts"": 92, ""market"": ""A""}",65.0,17.0,2.0,2f9gqu83,vmu7c279,FULL STUDY,245.0,s2,1,105,120.0,-1,,1,sell,0,sell,0.4990675303551922,19,0,0,block 3 (G second),20.0,11.0,Female,1.0,0.0,1.0,"[3, 'block 3 (G second)']",0,1,1,0.5,2.0,-0.7166666666666666,0.375,0.0,0.6666666666666666,0.0,2,0.5,0.75,Design 2,Design 2,"Have an option between Design #1 and Design #2,",5.0,,
199,4949,3,Player object (1071),sell,2023-03-10 10:45:10.780608+00:00,"{""priceA"": 115, ""sharesA"": 0, ""secs_since_round_starts"": 109, ""market"": ""A""}",180.0,20.0,3.0,2f9gqu83,vmu7c279,FULL STUDY,245.0,s2,1,115,105.0,1,10.0,1,buy,0,sell,0.5061230669509241,19,0,0,block 3 (G second),20.0,11.0,Female,1.0,0.0,1.0,"[3, 'block 3 (G second)']",0,1,1,0.5,2.0,-0.7166666666666666,0.375,0.0,0.6666666666666666,0.0,2,0.5,0.75,Design 2,Design 2,"Have an option between Design #1 and Design #2,",5.0,,
200,4950,3,Player object (1071),buy,2023-03-10 10:45:22.952438+00:00,"{""priceA"": 85, ""sharesA"": 1, ""secs_since_round_starts"": 121, ""market"": ""A""}",95.0,22.0,4.0,2f9gqu83,vmu7c279,FULL STUDY,245.0,s2,1,85,115.0,-1,,1,sell,0,sell,0.443819468959905,19,1,0,block 3 (G second),20.0,11.0,Female,1.0,0.0,1.0,"[3, 'block 3 (G second)']",0,1,1,0.5,2.0,-0.7166666666666666,0.375,0.0,0.6666666666666666,0.0,2,0.5,0.75,Design 2,Design 2,"Have an option between Design #1 and Design #2,",5.0,,
201,4951,3,Player object (1071),sell,2023-03-10 10:45:36.579626+00:00,"{""priceA"": 110, ""sharesA"": 0, ""secs_since_round_starts"": 135, ""market"": ""A""}",205.0,25.0,5.0,2f9gqu83,vmu7c279,FULL STUDY,245.0,s2,1,110,85.0,1,25.0,1,buy,0,sell,0.4872943409941583,19,0,0,block 3 (G second),20.0,11.0,Female,1.0,0.0,1.0,"[3, 'block 3 (G second)']",0,1,1,0.5,2.0,-0.7166666666666666,0.375,0.0,0.6666666666666666,0.0,2,0.5,0.75,Design 2,Design 2,"Have an option between Design #1 and Design #2,",5.0,,
202,4952,3,Player object (1071),buy,2023-03-10 10:46:00.970945+00:00,"{""priceA"": 115, ""sharesA"": 1, ""secs_since_round_starts"": 159, ""market"": ""A""}",90.0,29.0,6.0,2f9gqu83,vmu7c279,FULL STUDY,245.0,s2,1,115,110.0,-1,,1,sell,0,sell,0.5511004178331719,19,0,0,block 3 (G second),20.0,11.0,Female,1.0,0.0,1.0,"[3, 'block 3 (G second)']",0,1,1,0.5,2.0,-0.7166666666666666,0.375,0.0,0.6666666666666666,0.0,2,0.5,0.75,Design 2,Design 2,"Have an option between Design #1 and Design #2,",5.0,,
203,4953,3,Player object (1071),sell,2023-03-10 10:46:06.672353+00:00,"{""priceA"": 120, ""sharesA"": 0, ""secs_since_round_starts"": 165, ""market"": ""A""}",210.0,30.0,7.0,2f9gqu83,vmu7c279,FULL STUDY,245.0,s2,1,120,115.0,1,5.0,1,buy,0,sell,0.570054331362491,19,0,1,block 3 (G second),20.0,11.0,Female,1.0,0.0,1.0,"[3, 'block 3 (G second)']",0,1,1,0.5,2.0,-0.7166666666666666,0.375,0.0,0.6666666666666666,0.0,2,0.5,0.75,Design 2,Design 2,"Have an option between Design #1 and Design #2,",5.0,,
204,4955,3,Player object (1071),buy,2023-03-10 10:46:50.857206+00:00,"{""priceA"": 95, ""sharesA"": 1, ""secs_since_round_starts"": 209, ""market"": ""A""}",115.0,37.0,8.0,2f9gqu83,vmu7c279,FULL STUDY,245.0,s2,1,95,120.0,-1,,1,sell,0,sell,0.4240076400585448,19,1,0,block 3 (G second),20.0,11.0,Female,1.0,0.0,1.0,"[3, 'block 3 (G second)']",0,1,1,0.5,2.0,-0.7166666666666666,0.375,0.0,0.6666666666666666,0.0,2,0.5,0.75,Design 2,Design 2,"Have an option between Design #1 and Design #2,",5.0,,
205,4956,3,Player object (1071),sell,2023-03-10 10:47:09.420397+00:00,"{""priceA"": 100, ""sharesA"": 0, ""secs_since_round_starts"": 227, ""market"": ""A""}",215.0,40.0,9.0,2f9gqu83,vmu7c279,FULL STUDY,245.0,s2,1,100,95.0,1,5.0,1,buy,0,sell,0.4804175727303482,19,0,0,block 3 (G second),20.0,11.0,Female,1.0,0.0,1.0,"[3, 'block 3 (G second)']",0,1,1,0.5,2.0,-0.7166666666666666,0.375,0.0,0.6666666666666666,0.0,2,0.5,0.75,Design 2,Design 2,"Have an option between Design #1 and Design #2,",5.0,,
206,4957,3,Player object (1071),buy,2023-03-10 10:47:15.119188+00:00,"{""priceA"": 95, ""sharesA"": 1, ""secs_since_round_starts"": 233, ""market"": ""A""}",120.0,41.0,10.0,2f9gqu83,vmu7c279,FULL STUDY,245.0,s2,1,95,100.0,-1,,1,sell,0,sell,0.4514823197003955,19,0,0,block 3 (G second),20.0,11.0,Female,1.0,0.0,1.0,"[3, 'block 3 (G second)']",0,1,1,0.5,2.0,-0.7166666666666666,0.375,0.0,0.6666666666666666,0.0,2,0.5,0.75,Design 2,Design 2,"Have an option between Design #1 and Design #2,",5.0,,
207,4958,3,Player object (1071),sell,2023-03-10 10:47:28.040390+00:00,"{""priceA"": 135, ""sharesA"": 0, ""secs_since_round_starts"": 246, ""market"": ""A""}",255.0,44.0,11.0,2f9gqu83,vmu7c279,FULL STUDY,245.0,s2,1,135,95.0,1,40.0,1,buy,0,sell,0.5595824488336746,19,0,1,block 3 (G second),20.0,11.0,Female,1.0,0.0,1.0,"[3, 'block 3 (G second)']",0,1,1,0.5,2.0,-0.7166666666666666,0.375,0.0,0.6666666666666666,0.0,2,0.5,0.75,Design 2,Design 2,"Have an option between Design #1 and Design #2,",5.0,,
208,4959,3,Player object (1071),buy,2023-03-10 10:48:49.837917+00:00,"{""priceA"": 125, ""sharesA"": 1, ""secs_since_round_starts"": 328, ""market"": ""A""}",130.0,59.0,12.0,2f9gqu83,vmu7c279,FULL STUDY,245.0,s2,1,125,135.0,-1,,1,sell,0,sell,0.4946618842475483,19,0,0,block 3 (G second),20.0,11.0,Female,1.0,0.0,1.0,"[3, 'block 3 (G second)']",0,1,1,0.5,2.0,-0.7166666666666666,0.375,0.0,0.6666666666666666,0.0,2,0.5,0.75,Design 2,Design 2,"Have an option between Design #1 and Design #2,",5.0,,
209,4963,4,Player object (1191),sell,2023-03-10 10:49:58.383828+00:00,"{""priceA"": 80, ""sharesA"": 0, ""secs_since_round_starts"": 55, ""market"": ""A""}",130.0,10.0,1.0,2f9gqu83,vmu7c279,FULL STUDY,175.0,s2,1,80,,1,,1,,0,sell,0.5652817482669988,14,0,0,block 3 (G second),20.0,11.0,Female,1.0,0.0,1.0,"[4, 'block 3 (G second)']",1,0,1,0.0,2.0,-0.7166666666666666,0.25,0.125,0.5,0.0,2,1.0,0.75,Design 2,Design 2,"Have an option between Design #1 and Design #2,",5.0,,
210,4964,4,Player object (1191),buy,2023-03-10 10:50:56.793872+00:00,"{""priceA"": 65, ""sharesA"": 1, ""secs_since_round_starts"": 113, ""market"": ""A""}",65.0,21.0,2.0,2f9gqu83,vmu7c279,FULL STUDY,175.0,s2,1,65,80.0,-1,,1,sell,0,sell,0.4378043684469758,14,0,0,block 3 (G second),20.0,11.0,Female,1.0,0.0,1.0,"[4, 'block 3 (G second)']",1,0,1,0.0,2.0,-0.7166666666666666,0.25,0.125,0.5,0.0,2,1.0,0.75,Design 2,Design 2,"Have an option between Design #1 and Design #2,",5.0,,
211,4965,4,Player object (1191),sell,2023-03-10 10:51:39.932569+00:00,"{""priceA"": 90, ""sharesA"": 0, ""secs_since_round_starts"": 156, ""market"": ""A""}",155.0,29.0,3.0,2f9gqu83,vmu7c279,FULL STUDY,175.0,s2,1,90,65.0,1,25.0,1,buy,0,sell,0.5712793841154561,14,0,0,block 3 (G second),20.0,11.0,Female,1.0,0.0,1.0,"[4, 'block 3 (G second)']",1,0,1,0.0,2.0,-0.7166666666666666,0.25,0.125,0.5,0.0,2,1.0,0.75,Design 2,Design 2,"Have an option between Design #1 and Design #2,",5.0,,
212,4967,4,Player object (1191),buy,2023-03-10 10:52:17.831018+00:00,"{""priceA"": 100, ""sharesA"": 1, ""secs_since_round_starts"": 194, ""market"": ""A""}",55.0,35.0,4.0,2f9gqu83,vmu7c279,FULL STUDY,175.0,s2,1,100,90.0,-1,,1,sell,0,sell,0.5337204628349665,14,0,0,block 3 (G second),20.0,11.0,Female,1.0,0.0,1.0,"[4, 'block 3 (G second)']",1,0,1,0.0,2.0,-0.7166666666666666,0.25,0.125,0.5,0.0,2,1.0,0.75,Design 2,Design 2,"Have an option between Design #1 and Design #2,",5.0,,
213,4968,4,Player object (1191),sell,2023-03-10 10:52:22.312762+00:00,"{""priceA"": 85, ""sharesA"": 0, ""secs_since_round_starts"": 199, ""market"": ""A""}",140.0,36.0,5.0,2f9gqu83,vmu7c279,FULL STUDY,175.0,s2,1,85,100.0,1,-15.0,1,buy,0,sell,0.4885269486642424,14,0,0,block 3 (G second),20.0,11.0,Female,1.0,0.0,1.0,"[4, 'block 3 (G second)']",1,0,1,0.0,2.0,-0.7166666666666666,0.25,0.125,0.5,0.0,2,1.0,0.75,Design 2,Design 2,"Have an option between Design #1 and Design #2,",5.0,,
214,4969,4,Player object (1191),buy,2023-03-10 10:52:34.060476+00:00,"{""priceA"": 65, ""sharesA"": 1, ""secs_since_round_starts"": 210, ""market"": ""A""}",75.0,38.0,6.0,2f9gqu83,vmu7c279,FULL STUDY,175.0,s2,1,65,85.0,-1,,1,sell,0,sell,0.4355009867455686,14,1,0,block 3 (G second),20.0,11.0,Female,1.0,0.0,1.0,"[4, 'block 3 (G second)']",1,0,1,0.0,2.0,-0.7166666666666666,0.25,0.125,0.5,0.0,2,1.0,0.75,Design 2,Design 2,"Have an option between Design #1 and Design #2,",5.0,,
215,4970,4,Player object (1191),sell,2023-03-10 10:53:00.455385+00:00,"{""priceA"": 100, ""sharesA"": 0, ""secs_since_round_starts"": 237, ""market"": ""A""}",175.0,43.0,7.0,2f9gqu83,vmu7c279,FULL STUDY,175.0,s2,1,100,65.0,1,35.0,1,buy,0,sell,0.5617190733230237,14,0,1,block 3 (G second),20.0,11.0,Female,1.0,0.0,1.0,"[4, 'block 3 (G second)']",1,0,1,0.0,2.0,-0.7166666666666666,0.25,0.125,0.5,0.0,2,1.0,0.75,Design 2,Design 2,"Have an option between Design #1 and Design #2,",5.0,,
216,4971,4,Player object (1191),buy,2023-03-10 10:53:57.364224+00:00,"{""priceA"": 75, ""sharesA"": 1, ""secs_since_round_starts"": 294, ""market"": ""A""}",100.0,53.0,8.0,2f9gqu83,vmu7c279,FULL STUDY,175.0,s2,1,75,100.0,-1,,1,sell,0,sell,0.4439854633835125,14,1,0,block 3 (G second),20.0,11.0,Female,1.0,0.0,1.0,"[4, 'block 3 (G second)']",1,0,1,0.0,2.0,-0.7166666666666666,0.25,0.125,0.5,0.0,2,1.0,0.75,Design 2,Design 2,"Have an option between Design #1 and Design #2,",5.0,,
217,4975,5,Player object (1311),sell,2023-03-10 10:55:23.562248+00:00,"{""priceA"": 90, ""sharesA"": 0, ""secs_since_round_starts"": 43, ""market"": ""A""}",140.0,8.0,1.0,2f9gqu83,vmu7c279,FULL STUDY,245.0,s2,1,90,,1,,1,,0,sell,0.5166236645513725,17,0,0,block 3 (G second),20.0,11.0,Female,1.0,0.0,1.0,"[5, 'block 3 (G second)']",1,1,1,0.5,2.0,-0.7166666666666666,0.2857142857142857,0.25,0.3333333333333333,0.0,4,0.5,0.75,Design 2,Design 2,"Have an option between Design #1 and Design #2,",5.0,,
218,4976,5,Player object (1311),buy,2023-03-10 10:55:35.324875+00:00,"{""priceA"": 75, ""sharesA"": 1, ""secs_since_round_starts"": 54, ""market"": ""A""}",65.0,10.0,2.0,2f9gqu83,vmu7c279,FULL STUDY,245.0,s2,1,75,90.0,-1,,1,sell,0,sell,0.4488309348307913,17,1,0,block 3 (G second),20.0,11.0,Female,1.0,0.0,1.0,"[5, 'block 3 (G second)']",1,1,1,0.5,2.0,-0.7166666666666666,0.2857142857142857,0.25,0.3333333333333333,0.0,4,0.5,0.75,Design 2,Design 2,"Have an option between Design #1 and Design #2,",5.0,,
219,4977,5,Player object (1311),sell,2023-03-10 10:55:49.885162+00:00,"{""priceA"": 85, ""sharesA"": 0, ""secs_since_round_starts"": 69, ""market"": ""A""}",150.0,13.0,3.0,2f9gqu83,vmu7c279,FULL STUDY,245.0,s2,1,85,75.0,1,10.0,1,buy,0,sell,0.4890232705715233,17,0,0,block 3 (G second),20.0,11.0,Female,1.0,0.0,1.0,"[5, 'block 3 (G second)']",1,1,1,0.5,2.0,-0.7166666666666666,0.2857142857142857,0.25,0.3333333333333333,0.0,4,0.5,0.75,Design 2,Design 2,"Have an option between Design #1 and Design #2,",5.0,,
220,4978,5,Player object (1311),buy,2023-03-10 10:56:18.915680+00:00,"{""priceA"": 70, ""sharesA"": 1, ""secs_since_round_starts"": 98, ""market"": ""A""}",80.0,18.0,4.0,2f9gqu83,vmu7c279,FULL STUDY,245.0,s2,1,70,85.0,-1,,1,sell,0,sell,0.42621223683237,17,1,0,block 3 (G second),20.0,11.0,Female,1.0,0.0,1.0,"[5, 'block 3 (G second)']",1,1,1,0.5,2.0,-0.7166666666666666,0.2857142857142857,0.25,0.3333333333333333,0.0,4,0.5,0.75,Design 2,Design 2,"Have an option between Design #1 and Design #2,",5.0,,
221,4979,5,Player object (1311),sell,2023-03-10 10:56:35.578330+00:00,"{""priceA"": 105, ""sharesA"": 0, ""secs_since_round_starts"": 115, ""market"": ""A""}",185.0,21.0,5.0,2f9gqu83,vmu7c279,FULL STUDY,245.0,s2,1,105,70.0,1,35.0,1,buy,0,sell,0.5510362930796925,17,0,1,block 3 (G second),20.0,11.0,Female,1.0,0.0,1.0,"[5, 'block 3 (G second)']",1,1,1,0.5,2.0,-0.7166666666666666,0.2857142857142857,0.25,0.3333333333333333,0.0,4,0.5,0.75,Design 2,Design 2,"Have an option between Design #1 and Design #2,",5.0,,
222,4981,5,Player object (1311),buy,2023-03-10 10:57:35.252260+00:00,"{""priceA"": 95, ""sharesA"": 1, ""secs_since_round_starts"": 174, ""market"": ""A""}",90.0,32.0,6.0,2f9gqu83,vmu7c279,FULL STUDY,245.0,s2,1,95,105.0,-1,,1,sell,0,sell,0.5188715333997952,17,0,0,block 3 (G second),20.0,11.0,Female,1.0,0.0,1.0,"[5, 'block 3 (G second)']",1,1,1,0.5,2.0,-0.7166666666666666,0.2857142857142857,0.25,0.3333333333333333,0.0,4,0.5,0.75,Design 2,Design 2,"Have an option between Design #1 and Design #2,",5.0,,
223,4982,5,Player object (1311),sell,2023-03-10 10:57:46.512107+00:00,"{""priceA"": 120, ""sharesA"": 0, ""secs_since_round_starts"": 186, ""market"": ""A""}",210.0,34.0,7.0,2f9gqu83,vmu7c279,FULL STUDY,245.0,s2,1,120,95.0,1,25.0,1,buy,0,sell,0.5679672812132522,17,0,0,block 3 (G second),20.0,11.0,Female,1.0,0.0,1.0,"[5, 'block 3 (G second)']",1,1,1,0.5,2.0,-0.7166666666666666,0.2857142857142857,0.25,0.3333333333333333,0.0,4,0.5,0.75,Design 2,Design 2,"Have an option between Design #1 and Design #2,",5.0,,
224,4983,5,Player object (1311),buy,2023-03-10 10:58:13.651410+00:00,"{""priceA"": 70, ""sharesA"": 1, ""secs_since_round_starts"": 213, ""market"": ""A""}",140.0,39.0,8.0,2f9gqu83,vmu7c279,FULL STUDY,245.0,s2,1,70,120.0,-1,,1,sell,0,sell,0.4317803147869401,17,0,0,block 3 (G second),20.0,11.0,Female,1.0,0.0,1.0,"[5, 'block 3 (G second)']",1,1,1,0.5,2.0,-0.7166666666666666,0.2857142857142857,0.25,0.3333333333333333,0.0,4,0.5,0.75,Design 2,Design 2,"Have an option between Design #1 and Design #2,",5.0,,
225,4984,5,Player object (1311),sell,2023-03-10 10:58:40.052413+00:00,"{""priceA"": 105, ""sharesA"": 0, ""secs_since_round_starts"": 239, ""market"": ""A""}",245.0,44.0,9.0,2f9gqu83,vmu7c279,FULL STUDY,245.0,s2,1,105,70.0,1,35.0,1,buy,0,sell,0.515125859635568,17,0,0,block 3 (G second),20.0,11.0,Female,1.0,0.0,1.0,"[5, 'block 3 (G second)']",1,1,1,0.5,2.0,-0.7166666666666666,0.2857142857142857,0.25,0.3333333333333333,0.0,4,0.5,0.75,Design 2,Design 2,"Have an option between Design #1 and Design #2,",5.0,,
226,4985,5,Player object (1311),buy,2023-03-10 10:59:09.919444+00:00,"{""priceA"": 85, ""sharesA"": 1, ""secs_since_round_starts"": 269, ""market"": ""A""}",160.0,49.0,10.0,2f9gqu83,vmu7c279,FULL STUDY,245.0,s2,1,85,105.0,-1,,1,sell,0,sell,0.4924841505562556,17,0,0,block 3 (G second),20.0,11.0,Female,1.0,0.0,1.0,"[5, 'block 3 (G second)']",1,1,1,0.5,2.0,-0.7166666666666666,0.2857142857142857,0.25,0.3333333333333333,0.0,4,0.5,0.75,Design 2,Design 2,"Have an option between Design #1 and Design #2,",5.0,,
227,4986,5,Player object (1311),sell,2023-03-10 10:59:31.903255+00:00,"{""priceA"": 85, ""sharesA"": 0, ""secs_since_round_starts"": 291, ""market"": ""A""}",245.0,53.0,11.0,2f9gqu83,vmu7c279,FULL STUDY,245.0,s2,1,85,85.0,1,0.0,1,buy,0,sell,0.4927925471404216,17,0,0,block 3 (G second),20.0,11.0,Female,1.0,0.0,1.0,"[5, 'block 3 (G second)']",1,1,1,0.5,2.0,-0.7166666666666666,0.2857142857142857,0.25,0.3333333333333333,0.0,4,0.5,0.75,Design 2,Design 2,"Have an option between Design #1 and Design #2,",5.0,,
228,4987,5,Player object (1311),buy,2023-03-10 11:00:09.470263+00:00,"{""priceA"": 65, ""sharesA"": 1, ""secs_since_round_starts"": 329, ""market"": ""A""}",180.0,60.0,12.0,2f9gqu83,vmu7c279,FULL STUDY,245.0,s2,1,65,85.0,-1,,1,sell,0,sell,0.4189820782479906,17,0,0,block 3 (G second),20.0,11.0,Female,1.0,0.0,1.0,"[5, 'block 3 (G second)']",1,1,1,0.5,2.0,-0.7166666666666666,0.2857142857142857,0.25,0.3333333333333333,0.0,4,0.5,0.75,Design 2,Design 2,"Have an option between Design #1 and Design #2,",5.0,,
229,5086,2,Player object (1513),sell,2023-03-10 12:42:29.176360+00:00,"{""priceA"": 110, ""sharesA"": 0, ""secs_since_round_starts"": 223, ""market"": ""A""}",160.0,6.0,1.0,34e7d6u1,t7od4xlw,FULL STUDY,185.0,s1,1,110,,1,,1,,0,sell,0.5028735207100592,16,0,0,block 3 (G second),23.0,12.0,Female,0.0,0.0,0.0,"[2, 'block 3 (G second)']",0,0,1,0.5,3.0,-0.7,0.5384615384615384,0.4,1.0,0.4,2,0.5,0.25,Design 2,Design 2,"Have an option between Design #1 and Design #2,",,3.0,3.0
230,5090,2,Player object (1513),buy,2023-03-10 12:42:37.387787+00:00,"{""priceA"": 85, ""sharesA"": 1, ""secs_since_round_starts"": 232, ""market"": ""A""}",75.0,8.0,3.0,34e7d6u1,t7od4xlw,FULL STUDY,185.0,s1,1,85,100.0,-1,,1,sell,0,sell,0.4422758127435268,16,1,0,block 3 (G second),23.0,12.0,Female,0.0,0.0,0.0,"[2, 'block 3 (G second)']",0,0,1,0.5,3.0,-0.7,0.5384615384615384,0.4,1.0,0.4,2,0.5,0.25,Design 2,Design 2,"Have an option between Design #1 and Design #2,",,3.0,3.0
231,5092,2,Player object (1513),sell,2023-03-10 12:42:41.547351+00:00,"{""priceA"": 70, ""sharesA"": 0, ""secs_since_round_starts"": 236, ""market"": ""A""}",145.0,9.0,4.0,34e7d6u1,t7od4xlw,FULL STUDY,185.0,s1,1,70,85.0,1,-15.0,1,buy,0,sell,0.4254536939069079,16,0,0,block 3 (G second),23.0,12.0,Female,0.0,0.0,0.0,"[2, 'block 3 (G second)']",0,0,1,0.5,3.0,-0.7,0.5384615384615384,0.4,1.0,0.4,2,0.5,0.25,Design 2,Design 2,"Have an option between Design #1 and Design #2,",,3.0,3.0
232,5093,2,Player object (1513),buy,2023-03-10 12:42:48.813401+00:00,"{""priceA"": 75, ""sharesA"": 1, ""secs_since_round_starts"": 243, ""market"": ""A""}",70.0,10.0,5.0,34e7d6u1,t7od4xlw,FULL STUDY,185.0,s1,1,75,70.0,-1,,1,sell,0,sell,0.4825575314143953,16,0,0,block 3 (G second),23.0,12.0,Female,0.0,0.0,0.0,"[2, 'block 3 (G second)']",0,0,1,0.5,3.0,-0.7,0.5384615384615384,0.4,1.0,0.4,2,0.5,0.25,Design 2,Design 2,"Have an option between Design #1 and Design #2,",,3.0,3.0
233,5094,2,Player object (1513),sell,2023-03-10 12:42:54.387819+00:00,"{""priceA"": 65, ""sharesA"": 0, ""secs_since_round_starts"": 249, ""market"": ""A""}",135.0,11.0,6.0,34e7d6u1,t7od4xlw,FULL STUDY,185.0,s1,1,65,75.0,1,-10.0,1,buy,0,sell,0.4529543903039196,16,0,0,block 3 (G second),23.0,12.0,Female,0.0,0.0,0.0,"[2, 'block 3 (G second)']",0,0,1,0.5,3.0,-0.7,0.5384615384615384,0.4,1.0,0.4,2,0.5,0.25,Design 2,Design 2,"Have an option between Design #1 and Design #2,",,3.0,3.0
234,5095,2,Player object (1513),buy,2023-03-10 12:43:00.756341+00:00,"{""priceA"": 80, ""sharesA"": 1, ""secs_since_round_starts"": 255, ""market"": ""A""}",55.0,12.0,7.0,34e7d6u1,t7od4xlw,FULL STUDY,185.0,s1,1,80,65.0,-1,,1,sell,0,sell,0.502087716794639,16,0,0,block 3 (G second),23.0,12.0,Female,0.0,0.0,0.0,"[2, 'block 3 (G second)']",0,0,1,0.5,3.0,-0.7,0.5384615384615384,0.4,1.0,0.4,2,0.5,0.25,Design 2,Design 2,"Have an option between Design #1 and Design #2,",,3.0,3.0
235,5097,2,Player object (1513),sell,2023-03-10 12:43:14.263253+00:00,"{""priceA"": 105, ""sharesA"": 0, ""secs_since_round_starts"": 269, ""market"": ""A""}",160.0,14.0,8.0,34e7d6u1,t7od4xlw,FULL STUDY,185.0,s1,1,105,80.0,1,25.0,1,buy,0,sell,0.5600744319669811,16,0,1,block 3 (G second),23.0,12.0,Female,0.0,0.0,0.0,"[2, 'block 3 (G second)']",0,0,1,0.5,3.0,-0.7,0.5384615384615384,0.4,1.0,0.4,2,0.5,0.25,Design 2,Design 2,"Have an option between Design #1 and Design #2,",,3.0,3.0
236,5098,2,Player object (1513),buy,2023-03-10 12:43:21.040174+00:00,"{""priceA"": 105, ""sharesA"": 1, ""secs_since_round_starts"": 275, ""market"": ""A""}",55.0,16.0,9.0,34e7d6u1,t7od4xlw,FULL STUDY,185.0,s1,1,105,105.0,-1,,1,sell,0,sell,0.5185790363913291,16,0,0,block 3 (G second),23.0,12.0,Female,0.0,0.0,0.0,"[2, 'block 3 (G second)']",0,0,1,0.5,3.0,-0.7,0.5384615384615384,0.4,1.0,0.4,2,0.5,0.25,Design 2,Design 2,"Have an option between Design #1 and Design #2,",,3.0,3.0
237,5101,2,Player object (1513),sell,2023-03-10 12:43:35.252359+00:00,"{""priceA"": 125, ""sharesA"": 0, ""secs_since_round_starts"": 289, ""market"": ""A""}",180.0,18.0,10.0,34e7d6u1,t7od4xlw,FULL STUDY,185.0,s1,1,125,105.0,1,20.0,1,buy,0,sell,0.5678304910935957,16,0,0,block 3 (G second),23.0,12.0,Female,0.0,0.0,0.0,"[2, 'block 3 (G second)']",0,0,1,0.5,3.0,-0.7,0.5384615384615384,0.4,1.0,0.4,2,0.5,0.25,Design 2,Design 2,"Have an option between Design #1 and Design #2,",,3.0,3.0
238,5103,2,Player object (1513),buy,2023-03-10 12:44:23.208176+00:00,"{""priceA"": 125, ""sharesA"": 1, ""secs_since_round_starts"": 337, ""market"": ""A""}",55.0,27.0,11.0,34e7d6u1,t7od4xlw,FULL STUDY,185.0,s1,1,125,125.0,-1,,1,sell,0,sell,0.4549942201992644,16,1,0,block 3 (G second),23.0,12.0,Female,0.0,0.0,0.0,"[2, 'block 3 (G second)']",0,0,1,0.5,3.0,-0.7,0.5384615384615384,0.4,1.0,0.4,2,0.5,0.25,Design 2,Design 2,"Have an option between Design #1 and Design #2,",,3.0,3.0
239,5104,2,Player object (1513),sell,2023-03-10 12:44:28.692597+00:00,"{""priceA"": 120, ""sharesA"": 0, ""secs_since_round_starts"": 343, ""market"": ""A""}",175.0,28.0,12.0,34e7d6u1,t7od4xlw,FULL STUDY,185.0,s1,1,120,125.0,1,-5.0,1,buy,0,sell,0.4340892272841542,16,0,0,block 3 (G second),23.0,12.0,Female,0.0,0.0,0.0,"[2, 'block 3 (G second)']",0,0,1,0.5,3.0,-0.7,0.5384615384615384,0.4,1.0,0.4,2,0.5,0.25,Design 2,Design 2,"Have an option between Design #1 and Design #2,",,3.0,3.0
240,5107,2,Player object (1513),buy,2023-03-10 12:44:35.416437+00:00,"{""priceA"": 115, ""sharesA"": 1, ""secs_since_round_starts"": 350, ""market"": ""A""}",60.0,29.0,13.0,34e7d6u1,t7od4xlw,FULL STUDY,185.0,s1,1,115,120.0,-1,,1,sell,0,sell,0.41991811093665,16,0,0,block 3 (G second),23.0,12.0,Female,0.0,0.0,0.0,"[2, 'block 3 (G second)']",0,0,1,0.5,3.0,-0.7,0.5384615384615384,0.4,1.0,0.4,2,0.5,0.25,Design 2,Design 2,"Have an option between Design #1 and Design #2,",,3.0,3.0
241,5109,2,Player object (1513),sell,2023-03-10 12:44:39.226167+00:00,"{""priceA"": 125, ""sharesA"": 0, ""secs_since_round_starts"": 353, ""market"": ""A""}",185.0,30.0,14.0,34e7d6u1,t7od4xlw,FULL STUDY,185.0,s1,1,125,115.0,1,10.0,1,buy,0,sell,0.4785999259850118,16,0,0,block 3 (G second),23.0,12.0,Female,0.0,0.0,0.0,"[2, 'block 3 (G second)']",0,0,1,0.5,3.0,-0.7,0.5384615384615384,0.4,1.0,0.4,2,0.5,0.25,Design 2,Design 2,"Have an option between Design #1 and Design #2,",,3.0,3.0
242,5114,2,Player object (1513),buy,2023-03-10 12:45:13.759711+00:00,"{""priceA"": 125, ""sharesA"": 1, ""secs_since_round_starts"": 388, ""market"": ""A""}",60.0,34.0,15.0,34e7d6u1,t7od4xlw,FULL STUDY,185.0,s1,1,125,125.0,-1,,1,sell,0,sell,0.4644502626891607,16,0,0,block 3 (G second),23.0,12.0,Female,0.0,0.0,0.0,"[2, 'block 3 (G second)']",0,0,1,0.5,3.0,-0.7,0.5384615384615384,0.4,1.0,0.4,2,0.5,0.25,Design 2,Design 2,"Have an option between Design #1 and Design #2,",,3.0,3.0
243,5117,2,Player object (1513),sell,2023-03-10 12:45:20.158778+00:00,"{""priceA"": 140, ""sharesA"": 0, ""secs_since_round_starts"": 394, ""market"": ""A""}",200.0,35.0,16.0,34e7d6u1,t7od4xlw,FULL STUDY,185.0,s1,1,140,125.0,1,15.0,1,buy,0,sell,0.5101876173062244,16,0,0,block 3 (G second),23.0,12.0,Female,0.0,0.0,0.0,"[2, 'block 3 (G second)']",0,0,1,0.5,3.0,-0.7,0.5384615384615384,0.4,1.0,0.4,2,0.5,0.25,Design 2,Design 2,"Have an option between Design #1 and Design #2,",,3.0,3.0
244,5118,2,Player object (1513),buy,2023-03-10 12:45:28.448432+00:00,"{""priceA"": 150, ""sharesA"": 1, ""secs_since_round_starts"": 403, ""market"": ""A""}",50.0,36.0,17.0,34e7d6u1,t7od4xlw,FULL STUDY,185.0,s1,1,150,140.0,-1,,1,sell,0,sell,0.542045663089369,16,0,0,block 3 (G second),23.0,12.0,Female,0.0,0.0,0.0,"[2, 'block 3 (G second)']",0,0,1,0.5,3.0,-0.7,0.5384615384615384,0.4,1.0,0.4,2,0.5,0.25,Design 2,Design 2,"Have an option between Design #1 and Design #2,",,3.0,3.0
245,5120,2,Player object (1513),sell,2023-03-10 12:45:53.753501+00:00,"{""priceA"": 135, ""sharesA"": 0, ""secs_since_round_starts"": 428, ""market"": ""A""}",185.0,41.0,18.0,34e7d6u1,t7od4xlw,FULL STUDY,185.0,s1,1,135,150.0,1,-15.0,1,buy,0,sell,0.4592429496222846,16,0,0,block 3 (G second),23.0,12.0,Female,0.0,0.0,0.0,"[2, 'block 3 (G second)']",0,0,1,0.5,3.0,-0.7,0.5384615384615384,0.4,1.0,0.4,2,0.5,0.25,Design 2,Design 2,"Have an option between Design #1 and Design #2,",,3.0,3.0
246,5122,2,Player object (1513),buy,2023-03-10 12:45:57.620376+00:00,"{""priceA"": 130, ""sharesA"": 1, ""secs_since_round_starts"": 432, ""market"": ""A""}",55.0,42.0,19.0,34e7d6u1,t7od4xlw,FULL STUDY,185.0,s1,1,130,135.0,-1,,1,sell,0,sell,0.4369837361437204,16,0,0,block 3 (G second),23.0,12.0,Female,0.0,0.0,0.0,"[2, 'block 3 (G second)']",0,0,1,0.5,3.0,-0.7,0.5384615384615384,0.4,1.0,0.4,2,0.5,0.25,Design 2,Design 2,"Have an option between Design #1 and Design #2,",,3.0,3.0
247,5123,2,Player object (1513),sell,2023-03-10 12:46:04.593398+00:00,"{""priceA"": 125, ""sharesA"": 0, ""secs_since_round_starts"": 439, ""market"": ""A""}",180.0,43.0,20.0,34e7d6u1,t7od4xlw,FULL STUDY,185.0,s1,1,125,130.0,1,-5.0,1,buy,0,sell,0.4218732662739463,16,1,0,block 3 (G second),23.0,12.0,Female,0.0,0.0,0.0,"[2, 'block 3 (G second)']",0,0,1,0.5,3.0,-0.7,0.5384615384615384,0.4,1.0,0.4,2,0.5,0.25,Design 2,Design 2,"Have an option between Design #1 and Design #2,",,3.0,3.0
248,5126,2,Player object (1513),buy,2023-03-10 12:46:16.769227+00:00,"{""priceA"": 140, ""sharesA"": 1, ""secs_since_round_starts"": 451, ""market"": ""A""}",40.0,45.0,21.0,34e7d6u1,t7od4xlw,FULL STUDY,185.0,s1,1,140,125.0,-1,,1,sell,0,sell,0.5210834711709403,16,0,0,block 3 (G second),23.0,12.0,Female,0.0,0.0,0.0,"[2, 'block 3 (G second)']",0,0,1,0.5,3.0,-0.7,0.5384615384615384,0.4,1.0,0.4,2,0.5,0.25,Design 2,Design 2,"Have an option between Design #1 and Design #2,",,3.0,3.0
249,5129,2,Player object (1513),sell,2023-03-10 12:46:22.669744+00:00,"{""priceA"": 155, ""sharesA"": 0, ""secs_since_round_starts"": 457, ""market"": ""A""}",195.0,46.0,22.0,34e7d6u1,t7od4xlw,FULL STUDY,185.0,s1,1,155,140.0,1,15.0,1,buy,0,sell,0.5495494947508355,16,0,1,block 3 (G second),23.0,12.0,Female,0.0,0.0,0.0,"[2, 'block 3 (G second)']",0,0,1,0.5,3.0,-0.7,0.5384615384615384,0.4,1.0,0.4,2,0.5,0.25,Design 2,Design 2,"Have an option between Design #1 and Design #2,",,3.0,3.0
250,5130,2,Player object (1513),buy,2023-03-10 12:46:26.003321+00:00,"{""priceA"": 140, ""sharesA"": 1, ""secs_since_round_starts"": 460, ""market"": ""A""}",55.0,47.0,23.0,34e7d6u1,t7od4xlw,FULL STUDY,185.0,s1,1,140,155.0,-1,,1,sell,0,sell,0.4996814899229063,16,0,0,block 3 (G second),23.0,12.0,Female,0.0,0.0,0.0,"[2, 'block 3 (G second)']",0,0,1,0.5,3.0,-0.7,0.5384615384615384,0.4,1.0,0.4,2,0.5,0.25,Design 2,Design 2,"Have an option between Design #1 and Design #2,",,3.0,3.0
251,5132,2,Player object (1513),sell,2023-03-10 12:46:42.601432+00:00,"{""priceA"": 155, ""sharesA"": 0, ""secs_since_round_starts"": 477, ""market"": ""A""}",210.0,50.0,24.0,34e7d6u1,t7od4xlw,FULL STUDY,185.0,s1,1,155,140.0,1,15.0,1,buy,0,sell,0.5063294801170398,16,0,0,block 3 (G second),23.0,12.0,Female,0.0,0.0,0.0,"[2, 'block 3 (G second)']",0,0,1,0.5,3.0,-0.7,0.5384615384615384,0.4,1.0,0.4,2,0.5,0.25,Design 2,Design 2,"Have an option between Design #1 and Design #2,",,3.0,3.0
252,5133,2,Player object (1513),buy,2023-03-10 12:46:47.252363+00:00,"{""priceA"": 140, ""sharesA"": 1, ""secs_since_round_starts"": 481, ""market"": ""A""}",70.0,51.0,25.0,34e7d6u1,t7od4xlw,FULL STUDY,185.0,s1,1,140,155.0,-1,,1,sell,0,sell,0.4693918893964308,16,0,0,block 3 (G second),23.0,12.0,Female,0.0,0.0,0.0,"[2, 'block 3 (G second)']",0,0,1,0.5,3.0,-0.7,0.5384615384615384,0.4,1.0,0.4,2,0.5,0.25,Design 2,Design 2,"Have an option between Design #1 and Design #2,",,3.0,3.0
253,5134,2,Player object (1513),sell,2023-03-10 12:46:54.549382+00:00,"{""priceA"": 125, ""sharesA"": 0, ""secs_since_round_starts"": 489, ""market"": ""A""}",195.0,52.0,26.0,34e7d6u1,t7od4xlw,FULL STUDY,185.0,s1,1,125,140.0,1,-15.0,1,buy,0,sell,0.4439176376077041,16,1,0,block 3 (G second),23.0,12.0,Female,0.0,0.0,0.0,"[2, 'block 3 (G second)']",0,0,1,0.5,3.0,-0.7,0.5384615384615384,0.4,1.0,0.4,2,0.5,0.25,Design 2,Design 2,"Have an option between Design #1 and Design #2,",,3.0,3.0
254,5136,2,Player object (1513),buy,2023-03-10 12:46:58.937023+00:00,"{""priceA"": 135, ""sharesA"": 1, ""secs_since_round_starts"": 493, ""market"": ""A""}",60.0,53.0,27.0,34e7d6u1,t7od4xlw,FULL STUDY,185.0,s1,1,135,125.0,-1,,1,sell,0,sell,0.4956940487416096,16,0,0,block 3 (G second),23.0,12.0,Female,0.0,0.0,0.0,"[2, 'block 3 (G second)']",0,0,1,0.5,3.0,-0.7,0.5384615384615384,0.4,1.0,0.4,2,0.5,0.25,Design 2,Design 2,"Have an option between Design #1 and Design #2,",,3.0,3.0
255,5154,3,Player object (1693),sell,2023-03-10 12:49:22.878876+00:00,"{""priceA"": 100, ""sharesA"": 0, ""secs_since_round_starts"": 99, ""market"": ""A""}",150.0,16.0,1.0,34e7d6u1,t7od4xlw,FULL STUDY,165.0,s1,1,100,,1,,1,,0,sell,0.4486815727575955,19,1,0,block 3 (G second),23.0,12.0,Female,0.0,0.0,0.0,"[3, 'block 3 (G second)']",0,1,1,0.5,3.0,-0.7,0.15384615384615385,0.0,0.0,0.0,2,0.5,0.25,Design 2,Design 2,"Have an option between Design #1 and Design #2,",,3.0,3.0
256,5156,3,Player object (1693),buy,2023-03-10 12:49:51.554362+00:00,"{""priceA"": 100, ""sharesA"": 1, ""secs_since_round_starts"": 127, ""market"": ""A""}",50.0,21.0,2.0,34e7d6u1,t7od4xlw,FULL STUDY,165.0,s1,1,100,100.0,-1,,1,sell,0,sell,0.4692484881524699,19,0,0,block 3 (G second),23.0,12.0,Female,0.0,0.0,0.0,"[3, 'block 3 (G second)']",0,1,1,0.5,3.0,-0.7,0.15384615384615385,0.0,0.0,0.0,2,0.5,0.25,Design 2,Design 2,"Have an option between Design #1 and Design #2,",,3.0,3.0
257,5161,3,Player object (1693),sell,2023-03-10 12:50:31.249898+00:00,"{""priceA"": 110, ""sharesA"": 0, ""secs_since_round_starts"": 167, ""market"": ""A""}",160.0,28.0,3.0,34e7d6u1,t7od4xlw,FULL STUDY,165.0,s1,1,110,100.0,1,10.0,1,buy,0,sell,0.5233413838959273,19,0,0,block 3 (G second),23.0,12.0,Female,0.0,0.0,0.0,"[3, 'block 3 (G second)']",0,1,1,0.5,3.0,-0.7,0.15384615384615385,0.0,0.0,0.0,2,0.5,0.25,Design 2,Design 2,"Have an option between Design #1 and Design #2,",,3.0,3.0
258,5162,3,Player object (1693),buy,2023-03-10 12:50:35.389350+00:00,"{""priceA"": 115, ""sharesA"": 1, ""secs_since_round_starts"": 171, ""market"": ""A""}",45.0,29.0,4.0,34e7d6u1,t7od4xlw,FULL STUDY,165.0,s1,1,115,110.0,-1,,1,sell,0,sell,0.5511004178331719,19,0,0,block 3 (G second),23.0,12.0,Female,0.0,0.0,0.0,"[3, 'block 3 (G second)']",0,1,1,0.5,3.0,-0.7,0.15384615384615385,0.0,0.0,0.0,2,0.5,0.25,Design 2,Design 2,"Have an option between Design #1 and Design #2,",,3.0,3.0
259,5171,3,Player object (1693),sell,2023-03-10 12:52:01.818822+00:00,"{""priceA"": 120, ""sharesA"": 0, ""secs_since_round_starts"": 258, ""market"": ""A""}",165.0,43.0,5.0,34e7d6u1,t7od4xlw,FULL STUDY,165.0,s1,1,120,115.0,1,5.0,1,buy,0,sell,0.5357259670782416,19,0,0,block 3 (G second),23.0,12.0,Female,0.0,0.0,0.0,"[3, 'block 3 (G second)']",0,1,1,0.5,3.0,-0.7,0.15384615384615385,0.0,0.0,0.0,2,0.5,0.25,Design 2,Design 2,"Have an option between Design #1 and Design #2,",,3.0,3.0
260,5183,4,Player object (1873),sell,2023-03-10 12:54:34.082304+00:00,"{""priceA"": 80, ""sharesA"": 0, ""secs_since_round_starts"": 55, ""market"": ""A""}",130.0,10.0,1.0,34e7d6u1,t7od4xlw,FULL STUDY,175.0,s1,1,80,,1,,1,,0,sell,0.5652817482669988,14,0,0,block 3 (G second),23.0,12.0,Female,0.0,0.0,0.0,"[4, 'block 3 (G second)']",1,0,1,0.5,3.0,-0.7,0.25,0.05555555555555555,1.0,0.0,2,1.0,0.25,Design 2,Design 2,"Have an option between Design #1 and Design #2,",,3.0,3.0
261,5187,4,Player object (1873),buy,2023-03-10 12:55:19.380352+00:00,"{""priceA"": 70, ""sharesA"": 1, ""secs_since_round_starts"": 101, ""market"": ""A""}",60.0,18.0,2.0,34e7d6u1,t7od4xlw,FULL STUDY,175.0,s1,1,70,80.0,-1,,1,sell,0,sell,0.4407118028401492,14,1,0,block 3 (G second),23.0,12.0,Female,0.0,0.0,0.0,"[4, 'block 3 (G second)']",1,0,1,0.5,3.0,-0.7,0.25,0.05555555555555555,1.0,0.0,2,1.0,0.25,Design 2,Design 2,"Have an option between Design #1 and Design #2,",,3.0,3.0
262,5191,4,Player object (1873),sell,2023-03-10 12:56:14.139070+00:00,"{""priceA"": 80, ""sharesA"": 0, ""secs_since_round_starts"": 155, ""market"": ""A""}",140.0,28.0,3.0,34e7d6u1,t7od4xlw,FULL STUDY,175.0,s1,1,80,70.0,1,10.0,1,buy,0,sell,0.5529051331090981,14,0,1,block 3 (G second),23.0,12.0,Female,0.0,0.0,0.0,"[4, 'block 3 (G second)']",1,0,1,0.5,3.0,-0.7,0.25,0.05555555555555555,1.0,0.0,2,1.0,0.25,Design 2,Design 2,"Have an option between Design #1 and Design #2,",,3.0,3.0
263,5197,4,Player object (1873),buy,2023-03-10 12:57:29.062556+00:00,"{""priceA"": 65, ""sharesA"": 1, ""secs_since_round_starts"": 230, ""market"": ""A""}",75.0,38.0,4.0,34e7d6u1,t7od4xlw,FULL STUDY,175.0,s1,1,65,80.0,-1,,1,sell,0,sell,0.4355009867455686,14,1,0,block 3 (G second),23.0,12.0,Female,0.0,0.0,0.0,"[4, 'block 3 (G second)']",1,0,1,0.5,3.0,-0.7,0.25,0.05555555555555555,1.0,0.0,2,1.0,0.25,Design 2,Design 2,"Have an option between Design #1 and Design #2,",,3.0,3.0
264,5199,4,Player object (1873),sell,2023-03-10 12:57:56.788067+00:00,"{""priceA"": 100, ""sharesA"": 0, ""secs_since_round_starts"": 258, ""market"": ""A""}",175.0,43.0,5.0,34e7d6u1,t7od4xlw,FULL STUDY,175.0,s1,1,100,65.0,1,35.0,1,buy,0,sell,0.5617190733230237,14,0,1,block 3 (G second),23.0,12.0,Female,0.0,0.0,0.0,"[4, 'block 3 (G second)']",1,0,1,0.5,3.0,-0.7,0.25,0.05555555555555555,1.0,0.0,2,1.0,0.25,Design 2,Design 2,"Have an option between Design #1 and Design #2,",,3.0,3.0
265,5200,4,Player object (1873),buy,2023-03-10 12:58:50.510225+00:00,"{""priceA"": 75, ""sharesA"": 1, ""secs_since_round_starts"": 312, ""market"": ""A""}",100.0,53.0,6.0,34e7d6u1,t7od4xlw,FULL STUDY,175.0,s1,1,75,100.0,-1,,1,sell,0,sell,0.4439854633835125,14,1,0,block 3 (G second),23.0,12.0,Female,0.0,0.0,0.0,"[4, 'block 3 (G second)']",1,0,1,0.5,3.0,-0.7,0.25,0.05555555555555555,1.0,0.0,2,1.0,0.25,Design 2,Design 2,"Have an option between Design #1 and Design #2,",,3.0,3.0
266,5205,5,Player object (2053),sell,2023-03-10 13:01:28.869073+00:00,"{""priceA"": 105, ""sharesA"": 0, ""secs_since_round_starts"": 114, ""market"": ""A""}",155.0,21.0,1.0,34e7d6u1,t7od4xlw,FULL STUDY,200.0,s1,1,105,,1,,1,,0,sell,0.5510362930796925,17,0,1,block 3 (G second),23.0,12.0,Female,0.0,0.0,0.0,"[5, 'block 3 (G second)']",1,1,1,0.5,3.0,-0.7,0.15384615384615385,0.0,0.5,0.0,4,0.5,0.75,Design 2,Design 2,"Have an option between Design #1 and Design #2,",,3.0,3.0
267,5206,5,Player object (2053),buy,2023-03-10 13:02:19.944249+00:00,"{""priceA"": 70, ""sharesA"": 1, ""secs_since_round_starts"": 165, ""market"": ""A""}",85.0,30.0,2.0,34e7d6u1,t7od4xlw,FULL STUDY,200.0,s1,1,70,105.0,-1,,1,sell,0,sell,0.4174526841611717,17,0,0,block 3 (G second),23.0,12.0,Female,0.0,0.0,0.0,"[5, 'block 3 (G second)']",1,1,1,0.5,3.0,-0.7,0.15384615384615385,0.0,0.5,0.0,4,0.5,0.75,Design 2,Design 2,"Have an option between Design #1 and Design #2,",,3.0,3.0
268,5208,5,Player object (2053),sell,2023-03-10 13:02:46.407568+00:00,"{""priceA"": 120, ""sharesA"": 0, ""secs_since_round_starts"": 192, ""market"": ""A""}",205.0,34.0,3.0,34e7d6u1,t7od4xlw,FULL STUDY,200.0,s1,1,120,70.0,1,50.0,1,buy,0,sell,0.5679672812132522,17,0,0,block 3 (G second),23.0,12.0,Female,0.0,0.0,0.0,"[5, 'block 3 (G second)']",1,1,1,0.5,3.0,-0.7,0.15384615384615385,0.0,0.5,0.0,4,0.5,0.75,Design 2,Design 2,"Have an option between Design #1 and Design #2,",,3.0,3.0
269,5209,5,Player object (2053),buy,2023-03-10 13:04:14.358513+00:00,"{""priceA"": 70, ""sharesA"": 1, ""secs_since_round_starts"": 280, ""market"": ""A""}",135.0,50.0,4.0,34e7d6u1,t7od4xlw,FULL STUDY,200.0,s1,1,70,120.0,-1,,1,sell,0,sell,0.4597993338202879,17,0,0,block 3 (G second),23.0,12.0,Female,0.0,0.0,0.0,"[5, 'block 3 (G second)']",1,1,1,0.5,3.0,-0.7,0.15384615384615385,0.0,0.5,0.0,4,0.5,0.75,Design 2,Design 2,"Have an option between Design #1 and Design #2,",,3.0,3.0
270,940,2,Player object (867),sell,2023-03-04 19:51:50.458604+00:00,"{""priceA"": 105, ""sharesA"": 0, ""secs_since_round_starts"": 95, ""market"": ""A""}",155.0,16.0,1.0,3cbm3sys,vmu7c279,FULL STUDY,180.0,s2,1,105,,1,,1,,0,sell,0.5185790363913291,16,0,0,block 1 (G first),22.0,11.0,Male,0.0,0.0,0.0,"[2, 'block 1 (G first)']",1,0,0,0.5,7.0,-0.21666666666666667,0.2,0.0,0.6666666666666666,0.0,3,0.75,0.5,Design 2,Design 1,"Have an option between Design #1 and Design #2,",3.0,,
271,942,2,Player object (867),buy,2023-03-04 19:52:14.568137+00:00,"{""priceA"": 125, ""sharesA"": 1, ""secs_since_round_starts"": 119, ""market"": ""A""}",30.0,20.0,2.0,3cbm3sys,vmu7c279,FULL STUDY,180.0,s2,1,125,105.0,-1,,1,sell,0,sell,0.5223275507294591,16,0,0,block 1 (G first),22.0,11.0,Male,0.0,0.0,0.0,"[2, 'block 1 (G first)']",1,0,0,0.5,7.0,-0.21666666666666667,0.2,0.0,0.6666666666666666,0.0,3,0.75,0.5,Design 2,Design 1,"Have an option between Design #1 and Design #2,",3.0,,
272,943,2,Player object (867),sell,2023-03-04 19:52:31.677169+00:00,"{""priceA"": 150, ""sharesA"": 0, ""secs_since_round_starts"": 136, ""market"": ""A""}",180.0,23.0,3.0,3cbm3sys,vmu7c279,FULL STUDY,180.0,s2,1,150,125.0,1,25.0,1,buy,0,sell,0.5825581483921976,16,0,1,block 1 (G first),22.0,11.0,Male,0.0,0.0,0.0,"[2, 'block 1 (G first)']",1,0,0,0.5,7.0,-0.21666666666666667,0.2,0.0,0.6666666666666666,0.0,3,0.75,0.5,Design 2,Design 1,"Have an option between Design #1 and Design #2,",3.0,,
273,944,2,Player object (867),buy,2023-03-04 19:52:40.161039+00:00,"{""priceA"": 145, ""sharesA"": 1, ""secs_since_round_starts"": 145, ""market"": ""A""}",35.0,25.0,4.0,3cbm3sys,vmu7c279,FULL STUDY,180.0,s2,1,145,150.0,-1,,1,sell,0,sell,0.5294358264188312,16,0,0,block 1 (G first),22.0,11.0,Male,0.0,0.0,0.0,"[2, 'block 1 (G first)']",1,0,0,0.5,7.0,-0.21666666666666667,0.2,0.0,0.6666666666666666,0.0,3,0.75,0.5,Design 2,Design 1,"Have an option between Design #1 and Design #2,",3.0,,
274,948,2,Player object (867),sell,2023-03-04 19:54:07.465081+00:00,"{""priceA"": 145, ""sharesA"": 0, ""secs_since_round_starts"": 232, ""market"": ""A""}",180.0,37.0,5.0,3cbm3sys,vmu7c279,FULL STUDY,180.0,s2,1,145,145.0,1,0.0,1,buy,0,sell,0.494384744736363,16,0,0,block 1 (G first),22.0,11.0,Male,0.0,0.0,0.0,"[2, 'block 1 (G first)']",1,0,0,0.5,7.0,-0.21666666666666667,0.2,0.0,0.6666666666666666,0.0,3,0.75,0.5,Design 2,Design 1,"Have an option between Design #1 and Design #2,",3.0,,
275,950,2,Player object (867),buy,2023-03-04 19:54:20.645347+00:00,"{""priceA"": 125, ""sharesA"": 1, ""secs_since_round_starts"": 245, ""market"": ""A""}",55.0,39.0,6.0,3cbm3sys,vmu7c279,FULL STUDY,180.0,s2,1,125,145.0,-1,,1,sell,0,sell,0.4382592777609274,16,1,0,block 1 (G first),22.0,11.0,Male,0.0,0.0,0.0,"[2, 'block 1 (G first)']",1,0,0,0.5,7.0,-0.21666666666666667,0.2,0.0,0.6666666666666666,0.0,3,0.75,0.5,Design 2,Design 1,"Have an option between Design #1 and Design #2,",3.0,,
276,953,2,Player object (867),sell,2023-03-04 19:54:58.217347+00:00,"{""priceA"": 155, ""sharesA"": 0, ""secs_since_round_starts"": 283, ""market"": ""A""}",210.0,46.0,7.0,3cbm3sys,vmu7c279,FULL STUDY,180.0,s2,1,155,125.0,1,30.0,1,buy,0,sell,0.5495494947508355,16,0,1,block 1 (G first),22.0,11.0,Male,0.0,0.0,0.0,"[2, 'block 1 (G first)']",1,0,0,0.5,7.0,-0.21666666666666667,0.2,0.0,0.6666666666666666,0.0,3,0.75,0.5,Design 2,Design 1,"Have an option between Design #1 and Design #2,",3.0,,
277,955,2,Player object (867),buy,2023-03-04 19:55:20.929162+00:00,"{""priceA"": 155, ""sharesA"": 1, ""secs_since_round_starts"": 306, ""market"": ""A""}",55.0,50.0,8.0,3cbm3sys,vmu7c279,FULL STUDY,180.0,s2,1,155,155.0,-1,,1,sell,0,sell,0.5063294801170398,16,0,0,block 1 (G first),22.0,11.0,Male,0.0,0.0,0.0,"[2, 'block 1 (G first)']",1,0,0,0.5,7.0,-0.21666666666666667,0.2,0.0,0.6666666666666666,0.0,3,0.75,0.5,Design 2,Design 1,"Have an option between Design #1 and Design #2,",3.0,,
278,967,3,Player object (987),sell,2023-03-04 19:57:36.511482+00:00,"{""priceA"": 130, ""sharesA"": 0, ""secs_since_round_starts"": 69, ""market"": ""A""}",180.0,13.0,1.0,3cbm3sys,vmu7c279,FULL STUDY,255.0,s2,1,130,,1,,1,,0,sell,0.5729625045047859,19,0,1,block 1 (G first),22.0,11.0,Male,0.0,0.0,0.0,"[3, 'block 1 (G first)']",1,1,0,0.5,7.0,-0.21666666666666667,0.2,0.0,0.6666666666666666,0.0,2,0.5,0.75,Design 2,Design 1,"Have an option between Design #1 and Design #2,",3.0,,
279,968,3,Player object (987),buy,2023-03-04 19:57:50.759166+00:00,"{""priceA"": 100, ""sharesA"": 1, ""secs_since_round_starts"": 83, ""market"": ""A""}",80.0,16.0,2.0,3cbm3sys,vmu7c279,FULL STUDY,255.0,s2,1,100,130.0,-1,,1,sell,0,sell,0.4486815727575955,19,1,0,block 1 (G first),22.0,11.0,Male,0.0,0.0,0.0,"[3, 'block 1 (G first)']",1,1,0,0.5,7.0,-0.21666666666666667,0.2,0.0,0.6666666666666666,0.0,2,0.5,0.75,Design 2,Design 1,"Have an option between Design #1 and Design #2,",3.0,,
280,971,3,Player object (987),sell,2023-03-04 19:59:08.574680+00:00,"{""priceA"": 120, ""sharesA"": 0, ""secs_since_round_starts"": 161, ""market"": ""A""}",200.0,30.0,3.0,3cbm3sys,vmu7c279,FULL STUDY,255.0,s2,1,120,100.0,1,20.0,1,buy,0,sell,0.570054331362491,19,0,1,block 1 (G first),22.0,11.0,Male,0.0,0.0,0.0,"[3, 'block 1 (G first)']",1,1,0,0.5,7.0,-0.21666666666666667,0.2,0.0,0.6666666666666666,0.0,2,0.5,0.75,Design 2,Design 1,"Have an option between Design #1 and Design #2,",3.0,,
281,974,3,Player object (987),buy,2023-03-04 19:59:36.064394+00:00,"{""priceA"": 100, ""sharesA"": 1, ""secs_since_round_starts"": 189, ""market"": ""A""}",100.0,33.0,4.0,3cbm3sys,vmu7c279,FULL STUDY,255.0,s2,1,100,120.0,-1,,1,sell,0,sell,0.4476889957041811,19,1,0,block 1 (G first),22.0,11.0,Male,0.0,0.0,0.0,"[3, 'block 1 (G first)']",1,1,0,0.5,7.0,-0.21666666666666667,0.2,0.0,0.6666666666666666,0.0,2,0.5,0.75,Design 2,Design 1,"Have an option between Design #1 and Design #2,",3.0,,
282,977,3,Player object (987),sell,2023-03-04 20:00:08.890270+00:00,"{""priceA"": 115, ""sharesA"": 0, ""secs_since_round_starts"": 221, ""market"": ""A""}",215.0,39.0,5.0,3cbm3sys,vmu7c279,FULL STUDY,255.0,s2,1,115,100.0,1,15.0,1,buy,0,sell,0.5221490272476892,19,0,0,block 1 (G first),22.0,11.0,Male,0.0,0.0,0.0,"[3, 'block 1 (G first)']",1,1,0,0.5,7.0,-0.21666666666666667,0.2,0.0,0.6666666666666666,0.0,2,0.5,0.75,Design 2,Design 1,"Have an option between Design #1 and Design #2,",3.0,,
283,979,3,Player object (987),buy,2023-03-04 20:00:13.083919+00:00,"{""priceA"": 100, ""sharesA"": 1, ""secs_since_round_starts"": 226, ""market"": ""A""}",115.0,40.0,6.0,3cbm3sys,vmu7c279,FULL STUDY,255.0,s2,1,100,115.0,-1,,1,sell,0,sell,0.4804175727303482,19,0,0,block 1 (G first),22.0,11.0,Male,0.0,0.0,0.0,"[3, 'block 1 (G first)']",1,1,0,0.5,7.0,-0.21666666666666667,0.2,0.0,0.6666666666666666,0.0,2,0.5,0.75,Design 2,Design 1,"Have an option between Design #1 and Design #2,",3.0,,
284,981,3,Player object (987),sell,2023-03-04 20:00:29.462310+00:00,"{""priceA"": 120, ""sharesA"": 0, ""secs_since_round_starts"": 242, ""market"": ""A""}",235.0,43.0,7.0,3cbm3sys,vmu7c279,FULL STUDY,255.0,s2,1,120,100.0,1,20.0,1,buy,0,sell,0.5357259670782416,19,0,0,block 1 (G first),22.0,11.0,Male,0.0,0.0,0.0,"[3, 'block 1 (G first)']",1,1,0,0.5,7.0,-0.21666666666666667,0.2,0.0,0.6666666666666666,0.0,2,0.5,0.75,Design 2,Design 1,"Have an option between Design #1 and Design #2,",3.0,,
285,985,3,Player object (987),buy,2023-03-04 20:01:02.178336+00:00,"{""priceA"": 110, ""sharesA"": 1, ""secs_since_round_starts"": 275, ""market"": ""A""}",125.0,49.0,8.0,3cbm3sys,vmu7c279,FULL STUDY,255.0,s2,1,110,120.0,-1,,1,sell,0,sell,0.4374794566672981,19,1,0,block 1 (G first),22.0,11.0,Male,0.0,0.0,0.0,"[3, 'block 1 (G first)']",1,1,0,0.5,7.0,-0.21666666666666667,0.2,0.0,0.6666666666666666,0.0,2,0.5,0.75,Design 2,Design 1,"Have an option between Design #1 and Design #2,",3.0,,
286,986,3,Player object (987),sell,2023-03-04 20:01:23.404760+00:00,"{""priceA"": 130, ""sharesA"": 0, ""secs_since_round_starts"": 296, ""market"": ""A""}",255.0,53.0,9.0,3cbm3sys,vmu7c279,FULL STUDY,255.0,s2,1,130,110.0,1,20.0,1,buy,0,sell,0.4905868559773416,19,0,0,block 1 (G first),22.0,11.0,Male,0.0,0.0,0.0,"[3, 'block 1 (G first)']",1,1,0,0.5,7.0,-0.21666666666666667,0.2,0.0,0.6666666666666666,0.0,2,0.5,0.75,Design 2,Design 1,"Have an option between Design #1 and Design #2,",3.0,,
287,988,3,Player object (987),buy,2023-03-04 20:01:52.753130+00:00,"{""priceA"": 115, ""sharesA"": 1, ""secs_since_round_starts"": 325, ""market"": ""A""}",140.0,58.0,10.0,3cbm3sys,vmu7c279,FULL STUDY,255.0,s2,1,115,130.0,-1,,1,sell,0,sell,0.442461876115205,19,1,0,block 1 (G first),22.0,11.0,Male,0.0,0.0,0.0,"[3, 'block 1 (G first)']",1,1,0,0.5,7.0,-0.21666666666666667,0.2,0.0,0.6666666666666666,0.0,2,0.5,0.75,Design 2,Design 1,"Have an option between Design #1 and Design #2,",3.0,,
288,998,4,Player object (1107),sell,2023-03-04 20:04:50.635903+00:00,"{""priceA"": 85, ""sharesA"": 0, ""secs_since_round_starts"": 161, ""market"": ""A""}",135.0,30.0,1.0,3cbm3sys,vmu7c279,FULL STUDY,185.0,s2,1,85,,1,,1,,0,sell,0.5151109892827086,14,0,0,block 1 (G first),22.0,11.0,Male,0.0,0.0,0.0,"[4, 'block 1 (G first)']",0,0,0,0.5,7.0,-0.21666666666666667,0.25,0.03125,1.0,0.0,2,1.0,0.75,Design 2,Design 1,"Have an option between Design #1 and Design #2,",3.0,,
289,1000,4,Player object (1107),buy,2023-03-04 20:05:34.037069+00:00,"{""priceA"": 70, ""sharesA"": 1, ""secs_since_round_starts"": 204, ""market"": ""A""}",65.0,37.0,2.0,3cbm3sys,vmu7c279,FULL STUDY,185.0,s2,1,70,85.0,-1,,1,sell,0,sell,0.4570673777008929,14,0,0,block 1 (G first),22.0,11.0,Male,0.0,0.0,0.0,"[4, 'block 1 (G first)']",0,0,0,0.5,7.0,-0.21666666666666667,0.25,0.03125,1.0,0.0,2,1.0,0.75,Design 2,Design 1,"Have an option between Design #1 and Design #2,",3.0,,
290,1004,4,Player object (1107),sell,2023-03-04 20:06:08.670857+00:00,"{""priceA"": 100, ""sharesA"": 0, ""secs_since_round_starts"": 239, ""market"": ""A""}",165.0,43.0,3.0,3cbm3sys,vmu7c279,FULL STUDY,185.0,s2,1,100,70.0,1,30.0,1,buy,0,sell,0.5617190733230237,14,0,1,block 1 (G first),22.0,11.0,Male,0.0,0.0,0.0,"[4, 'block 1 (G first)']",0,0,0,0.5,7.0,-0.21666666666666667,0.25,0.03125,1.0,0.0,2,1.0,0.75,Design 2,Design 1,"Have an option between Design #1 and Design #2,",3.0,,
291,1005,4,Player object (1107),buy,2023-03-04 20:06:32.890377+00:00,"{""priceA"": 85, ""sharesA"": 1, ""secs_since_round_starts"": 263, ""market"": ""A""}",80.0,47.0,4.0,3cbm3sys,vmu7c279,FULL STUDY,185.0,s2,1,85,100.0,-1,,1,sell,0,sell,0.4501495476988393,14,1,0,block 1 (G first),22.0,11.0,Male,0.0,0.0,0.0,"[4, 'block 1 (G first)']",0,0,0,0.5,7.0,-0.21666666666666667,0.25,0.03125,1.0,0.0,2,1.0,0.75,Design 2,Design 1,"Have an option between Design #1 and Design #2,",3.0,,
292,1007,4,Player object (1107),sell,2023-03-04 20:06:42.943125+00:00,"{""priceA"": 105, ""sharesA"": 0, ""secs_since_round_starts"": 273, ""market"": ""A""}",185.0,49.0,5.0,3cbm3sys,vmu7c279,FULL STUDY,185.0,s2,1,105,85.0,1,20.0,1,buy,0,sell,0.5350732746090608,14,0,0,block 1 (G first),22.0,11.0,Male,0.0,0.0,0.0,"[4, 'block 1 (G first)']",0,0,0,0.5,7.0,-0.21666666666666667,0.25,0.03125,1.0,0.0,2,1.0,0.75,Design 2,Design 1,"Have an option between Design #1 and Design #2,",3.0,,
293,1008,4,Player object (1107),buy,2023-03-04 20:07:02.626915+00:00,"{""priceA"": 75, ""sharesA"": 1, ""secs_since_round_starts"": 293, ""market"": ""A""}",110.0,53.0,6.0,3cbm3sys,vmu7c279,FULL STUDY,185.0,s2,1,75,105.0,-1,,1,sell,0,sell,0.4439854633835125,14,1,0,block 1 (G first),22.0,11.0,Male,0.0,0.0,0.0,"[4, 'block 1 (G first)']",0,0,0,0.5,7.0,-0.21666666666666667,0.25,0.03125,1.0,0.0,2,1.0,0.75,Design 2,Design 1,"Have an option between Design #1 and Design #2,",3.0,,
294,1016,5,Player object (1227),sell,2023-03-04 20:08:48.550329+00:00,"{""priceA"": 100, ""sharesA"": 0, ""secs_since_round_starts"": 60, ""market"": ""A""}",150.0,12.0,1.0,3cbm3sys,vmu7c279,FULL STUDY,190.0,s2,1,100,,1,,1,,0,sell,0.5344269279803172,17,0,0,block 1 (G first),22.0,11.0,Male,0.0,0.0,0.0,"[5, 'block 1 (G first)']",0,1,0,1.0,7.0,-0.21666666666666667,0.23076923076923078,0.0,0.6666666666666666,0.0,4,0.5,0.5,Design 2,Design 1,"Have an option between Design #1 and Design #2,",3.0,,
295,1017,5,Player object (1227),buy,2023-03-04 20:09:02.328811+00:00,"{""priceA"": 80, ""sharesA"": 1, ""secs_since_round_starts"": 73, ""market"": ""A""}",70.0,14.0,2.0,3cbm3sys,vmu7c279,FULL STUDY,190.0,s2,1,80,100.0,-1,,1,sell,0,sell,0.457409789643144,17,0,0,block 1 (G first),22.0,11.0,Male,0.0,0.0,0.0,"[5, 'block 1 (G first)']",0,1,0,1.0,7.0,-0.21666666666666667,0.23076923076923078,0.0,0.6666666666666666,0.0,4,0.5,0.5,Design 2,Design 1,"Have an option between Design #1 and Design #2,",3.0,,
296,1018,5,Player object (1227),sell,2023-03-04 20:09:38.412931+00:00,"{""priceA"": 105, ""sharesA"": 0, ""secs_since_round_starts"": 110, ""market"": ""A""}",175.0,21.0,3.0,3cbm3sys,vmu7c279,FULL STUDY,190.0,s2,1,105,80.0,1,25.0,1,buy,0,sell,0.5510362930796925,17,0,1,block 1 (G first),22.0,11.0,Male,0.0,0.0,0.0,"[5, 'block 1 (G first)']",0,1,0,1.0,7.0,-0.21666666666666667,0.23076923076923078,0.0,0.6666666666666666,0.0,4,0.5,0.5,Design 2,Design 1,"Have an option between Design #1 and Design #2,",3.0,,
297,1020,5,Player object (1227),buy,2023-03-04 20:10:16.737794+00:00,"{""priceA"": 85, ""sharesA"": 1, ""secs_since_round_starts"": 148, ""market"": ""A""}",90.0,28.0,4.0,3cbm3sys,vmu7c279,FULL STUDY,190.0,s2,1,85,105.0,-1,,1,sell,0,sell,0.4496194529460131,17,1,0,block 1 (G first),22.0,11.0,Male,0.0,0.0,0.0,"[5, 'block 1 (G first)']",0,1,0,1.0,7.0,-0.21666666666666667,0.23076923076923078,0.0,0.6666666666666666,0.0,4,0.5,0.5,Design 2,Design 1,"Have an option between Design #1 and Design #2,",3.0,,
298,1023,5,Player object (1227),sell,2023-03-04 20:10:59.940272+00:00,"{""priceA"": 110, ""sharesA"": 0, ""secs_since_round_starts"": 191, ""market"": ""A""}",200.0,33.0,5.0,3cbm3sys,vmu7c279,FULL STUDY,190.0,s2,1,110,85.0,1,25.0,1,buy,0,sell,0.5480287979668599,17,0,1,block 1 (G first),22.0,11.0,Male,0.0,0.0,0.0,"[5, 'block 1 (G first)']",0,1,0,1.0,7.0,-0.21666666666666667,0.23076923076923078,0.0,0.6666666666666666,0.0,4,0.5,0.5,Design 2,Design 1,"Have an option between Design #1 and Design #2,",3.0,,
299,1025,5,Player object (1227),buy,2023-03-04 20:11:21.053838+00:00,"{""priceA"": 95, ""sharesA"": 1, ""secs_since_round_starts"": 212, ""market"": ""A""}",105.0,37.0,6.0,3cbm3sys,vmu7c279,FULL STUDY,190.0,s2,1,95,110.0,-1,,1,sell,0,sell,0.4805886028013266,17,0,0,block 1 (G first),22.0,11.0,Male,0.0,0.0,0.0,"[5, 'block 1 (G first)']",0,1,0,1.0,7.0,-0.21666666666666667,0.23076923076923078,0.0,0.6666666666666666,0.0,4,0.5,0.5,Design 2,Design 1,"Have an option between Design #1 and Design #2,",3.0,,
300,1028,5,Player object (1227),sell,2023-03-04 20:12:05.421776+00:00,"{""priceA"": 110, ""sharesA"": 0, ""secs_since_round_starts"": 257, ""market"": ""A""}",215.0,45.0,7.0,3cbm3sys,vmu7c279,FULL STUDY,190.0,s2,1,110,95.0,1,15.0,1,buy,0,sell,0.5454506058480159,17,0,0,block 1 (G first),22.0,11.0,Male,0.0,0.0,0.0,"[5, 'block 1 (G first)']",0,1,0,1.0,7.0,-0.21666666666666667,0.23076923076923078,0.0,0.6666666666666666,0.0,4,0.5,0.5,Design 2,Design 1,"Have an option between Design #1 and Design #2,",3.0,,
301,1029,5,Player object (1227),buy,2023-03-04 20:12:15.944929+00:00,"{""priceA"": 90, ""sharesA"": 1, ""secs_since_round_starts"": 267, ""market"": ""A""}",125.0,47.0,8.0,3cbm3sys,vmu7c279,FULL STUDY,190.0,s2,1,90,110.0,-1,,1,sell,0,sell,0.4627742743797309,17,0,0,block 1 (G first),22.0,11.0,Male,0.0,0.0,0.0,"[5, 'block 1 (G first)']",0,1,0,1.0,7.0,-0.21666666666666667,0.23076923076923078,0.0,0.6666666666666666,0.0,4,0.5,0.5,Design 2,Design 1,"Have an option between Design #1 and Design #2,",3.0,,
302,2872,2,Player object (919),sell,2023-03-08 23:41:17.053206+00:00,"{""priceA"": 110, ""sharesA"": 0, ""secs_since_round_starts"": 52, ""market"": ""A""}",160.0,6.0,1.0,41x3lsag,vmu7c279,FULL STUDY,200.0,s1,1,110,,1,,1,,0,sell,0.5028735207100592,16,0,0,block 2 (G first),20.0,12.0,Female,1.0,0.0,0.0,"[2, 'block 2 (G first)']",1,1,0,0.5,7.0,-0.30000000000000004,0.5454545454545454,0.0,0.0,0.0,4,1.0,0.5,Design 2,Design 2,"Have an option between Design #1 and Design #2,",,4.0,3.0
303,2873,2,Player object (919),buy,2023-03-08 23:41:19.909362+00:00,"{""priceA"": 100, ""sharesA"": 1, ""secs_since_round_starts"": 55, ""market"": ""A""}",60.0,7.0,2.0,41x3lsag,vmu7c279,FULL STUDY,200.0,s1,1,100,110.0,-1,,1,sell,0,sell,0.4669924949471701,16,0,0,block 2 (G first),20.0,12.0,Female,1.0,0.0,0.0,"[2, 'block 2 (G first)']",1,1,0,0.5,7.0,-0.30000000000000004,0.5454545454545454,0.0,0.0,0.0,4,1.0,0.5,Design 2,Design 2,"Have an option between Design #1 and Design #2,",,4.0,3.0
304,2874,2,Player object (919),sell,2023-03-08 23:42:14.275172+00:00,"{""priceA"": 110, ""sharesA"": 0, ""secs_since_round_starts"": 110, ""market"": ""A""}",170.0,17.0,3.0,41x3lsag,vmu7c279,FULL STUDY,200.0,s1,1,110,100.0,1,10.0,1,buy,0,sell,0.5478276073026133,16,0,0,block 2 (G first),20.0,12.0,Female,1.0,0.0,0.0,"[2, 'block 2 (G first)']",1,1,0,0.5,7.0,-0.30000000000000004,0.5454545454545454,0.0,0.0,0.0,4,1.0,0.5,Design 2,Design 2,"Have an option between Design #1 and Design #2,",,4.0,3.0
305,2875,2,Player object (919),buy,2023-03-08 23:42:58.168870+00:00,"{""priceA"": 145, ""sharesA"": 1, ""secs_since_round_starts"": 154, ""market"": ""A""}",25.0,25.0,4.0,41x3lsag,vmu7c279,FULL STUDY,200.0,s1,1,145,110.0,-1,,1,sell,0,sell,0.5294358264188312,16,0,0,block 2 (G first),20.0,12.0,Female,1.0,0.0,0.0,"[2, 'block 2 (G first)']",1,1,0,0.5,7.0,-0.30000000000000004,0.5454545454545454,0.0,0.0,0.0,4,1.0,0.5,Design 2,Design 2,"Have an option between Design #1 and Design #2,",,4.0,3.0
306,2877,2,Player object (919),sell,2023-03-08 23:44:02.635255+00:00,"{""priceA"": 150, ""sharesA"": 0, ""secs_since_round_starts"": 218, ""market"": ""A""}",175.0,36.0,5.0,41x3lsag,vmu7c279,FULL STUDY,200.0,s1,1,150,145.0,1,5.0,1,buy,0,sell,0.542045663089369,16,0,0,block 2 (G first),20.0,12.0,Female,1.0,0.0,0.0,"[2, 'block 2 (G first)']",1,1,0,0.5,7.0,-0.30000000000000004,0.5454545454545454,0.0,0.0,0.0,4,1.0,0.5,Design 2,Design 2,"Have an option between Design #1 and Design #2,",,4.0,3.0
307,2878,2,Player object (919),buy,2023-03-08 23:44:19.026667+00:00,"{""priceA"": 125, ""sharesA"": 1, ""secs_since_round_starts"": 234, ""market"": ""A""}",50.0,39.0,6.0,41x3lsag,vmu7c279,FULL STUDY,200.0,s1,1,125,150.0,-1,,1,sell,0,sell,0.4382592777609274,16,1,0,block 2 (G first),20.0,12.0,Female,1.0,0.0,0.0,"[2, 'block 2 (G first)']",1,1,0,0.5,7.0,-0.30000000000000004,0.5454545454545454,0.0,0.0,0.0,4,1.0,0.5,Design 2,Design 2,"Have an option between Design #1 and Design #2,",,4.0,3.0
308,2879,2,Player object (919),sell,2023-03-08 23:44:24.903817+00:00,"{""priceA"": 140, ""sharesA"": 0, ""secs_since_round_starts"": 240, ""market"": ""A""}",190.0,40.0,7.0,41x3lsag,vmu7c279,FULL STUDY,200.0,s1,1,140,125.0,1,15.0,1,buy,0,sell,0.4916787423410894,16,0,0,block 2 (G first),20.0,12.0,Female,1.0,0.0,0.0,"[2, 'block 2 (G first)']",1,1,0,0.5,7.0,-0.30000000000000004,0.5454545454545454,0.0,0.0,0.0,4,1.0,0.5,Design 2,Design 2,"Have an option between Design #1 and Design #2,",,4.0,3.0
309,2880,2,Player object (919),buy,2023-03-08 23:44:35.067136+00:00,"{""priceA"": 130, ""sharesA"": 1, ""secs_since_round_starts"": 250, ""market"": ""A""}",60.0,42.0,8.0,41x3lsag,vmu7c279,FULL STUDY,200.0,s1,1,130,140.0,-1,,1,sell,0,sell,0.4369837361437204,16,0,0,block 2 (G first),20.0,12.0,Female,1.0,0.0,0.0,"[2, 'block 2 (G first)']",1,1,0,0.5,7.0,-0.30000000000000004,0.5454545454545454,0.0,0.0,0.0,4,1.0,0.5,Design 2,Design 2,"Have an option between Design #1 and Design #2,",,4.0,3.0
310,2881,2,Player object (919),sell,2023-03-08 23:44:53.971816+00:00,"{""priceA"": 140, ""sharesA"": 0, ""secs_since_round_starts"": 269, ""market"": ""A""}",200.0,45.0,9.0,41x3lsag,vmu7c279,FULL STUDY,200.0,s1,1,140,130.0,1,10.0,1,buy,0,sell,0.5210834711709403,16,0,0,block 2 (G first),20.0,12.0,Female,1.0,0.0,0.0,"[2, 'block 2 (G first)']",1,1,0,0.5,7.0,-0.30000000000000004,0.5454545454545454,0.0,0.0,0.0,4,1.0,0.5,Design 2,Design 2,"Have an option between Design #1 and Design #2,",,4.0,3.0
311,2882,2,Player object (919),buy,2023-03-08 23:45:02.789980+00:00,"{""priceA"": 140, ""sharesA"": 1, ""secs_since_round_starts"": 278, ""market"": ""A""}",60.0,47.0,10.0,41x3lsag,vmu7c279,FULL STUDY,200.0,s1,1,140,140.0,-1,,1,sell,0,sell,0.4996814899229063,16,0,0,block 2 (G first),20.0,12.0,Female,1.0,0.0,0.0,"[2, 'block 2 (G first)']",1,1,0,0.5,7.0,-0.30000000000000004,0.5454545454545454,0.0,0.0,0.0,4,1.0,0.5,Design 2,Design 2,"Have an option between Design #1 and Design #2,",,4.0,3.0
312,2884,2,Player object (919),sell,2023-03-08 23:45:13.068458+00:00,"{""priceA"": 155, ""sharesA"": 0, ""secs_since_round_starts"": 288, ""market"": ""A""}",215.0,48.0,11.0,41x3lsag,vmu7c279,FULL STUDY,200.0,s1,1,155,140.0,1,15.0,1,buy,0,sell,0.5347792584548927,16,0,0,block 2 (G first),20.0,12.0,Female,1.0,0.0,0.0,"[2, 'block 2 (G first)']",1,1,0,0.5,7.0,-0.30000000000000004,0.5454545454545454,0.0,0.0,0.0,4,1.0,0.5,Design 2,Design 2,"Have an option between Design #1 and Design #2,",,4.0,3.0
313,2885,2,Player object (919),buy,2023-03-08 23:45:28.173854+00:00,"{""priceA"": 140, ""sharesA"": 1, ""secs_since_round_starts"": 303, ""market"": ""A""}",75.0,51.0,12.0,41x3lsag,vmu7c279,FULL STUDY,200.0,s1,1,140,155.0,-1,,1,sell,0,sell,0.4693918893964308,16,0,0,block 2 (G first),20.0,12.0,Female,1.0,0.0,0.0,"[2, 'block 2 (G first)']",1,1,0,0.5,7.0,-0.30000000000000004,0.5454545454545454,0.0,0.0,0.0,4,1.0,0.5,Design 2,Design 2,"Have an option between Design #1 and Design #2,",,4.0,3.0
314,2891,3,Player object (1039),sell,2023-03-08 23:47:01.863390+00:00,"{""priceA"": 100, ""sharesA"": 0, ""secs_since_round_starts"": 36, ""market"": ""A""}",150.0,8.0,1.0,41x3lsag,vmu7c279,FULL STUDY,275.0,s1,1,100,,1,,1,,0,sell,0.5057155770500936,19,0,0,block 2 (G first),20.0,12.0,Female,1.0,0.0,0.0,"[3, 'block 2 (G first)']",1,0,0,0.5,7.0,-0.30000000000000004,0.5714285714285714,0.0,1.0,0.0,4,1.0,0.5,Design 2,Design 2,"Have an option between Design #1 and Design #2,",,4.0,3.0
315,2892,3,Player object (1039),buy,2023-03-08 23:47:12.360246+00:00,"{""priceA"": 95, ""sharesA"": 1, ""secs_since_round_starts"": 47, ""market"": ""A""}",55.0,10.0,2.0,41x3lsag,vmu7c279,FULL STUDY,275.0,s1,1,95,100.0,-1,,1,sell,0,sell,0.4922087569005138,19,0,0,block 2 (G first),20.0,12.0,Female,1.0,0.0,0.0,"[3, 'block 2 (G first)']",1,0,0,0.5,7.0,-0.30000000000000004,0.5714285714285714,0.0,1.0,0.0,4,1.0,0.5,Design 2,Design 2,"Have an option between Design #1 and Design #2,",,4.0,3.0
316,2893,3,Player object (1039),sell,2023-03-08 23:47:20.556930+00:00,"{""priceA"": 110, ""sharesA"": 0, ""secs_since_round_starts"": 55, ""market"": ""A""}",165.0,11.0,3.0,41x3lsag,vmu7c279,FULL STUDY,275.0,s1,1,110,95.0,1,15.0,1,buy,0,sell,0.5295922419004607,19,0,0,block 2 (G first),20.0,12.0,Female,1.0,0.0,0.0,"[3, 'block 2 (G first)']",1,0,0,0.5,7.0,-0.30000000000000004,0.5714285714285714,0.0,1.0,0.0,4,1.0,0.5,Design 2,Design 2,"Have an option between Design #1 and Design #2,",,4.0,3.0
317,2896,3,Player object (1039),buy,2023-03-08 23:47:40.479751+00:00,"{""priceA"": 110, ""sharesA"": 1, ""secs_since_round_starts"": 75, ""market"": ""A""}",55.0,15.0,4.0,41x3lsag,vmu7c279,FULL STUDY,275.0,s1,1,110,110.0,-1,,1,sell,0,sell,0.4763410641166328,19,0,0,block 2 (G first),20.0,12.0,Female,1.0,0.0,0.0,"[3, 'block 2 (G first)']",1,0,0,0.5,7.0,-0.30000000000000004,0.5714285714285714,0.0,1.0,0.0,4,1.0,0.5,Design 2,Design 2,"Have an option between Design #1 and Design #2,",,4.0,3.0
318,2897,3,Player object (1039),sell,2023-03-08 23:48:03.163759+00:00,"{""priceA"": 120, ""sharesA"": 0, ""secs_since_round_starts"": 98, ""market"": ""A""}",175.0,19.0,5.0,41x3lsag,vmu7c279,FULL STUDY,275.0,s1,1,120,110.0,1,10.0,1,buy,0,sell,0.5586446427659006,19,0,1,block 2 (G first),20.0,12.0,Female,1.0,0.0,0.0,"[3, 'block 2 (G first)']",1,0,0,0.5,7.0,-0.30000000000000004,0.5714285714285714,0.0,1.0,0.0,4,1.0,0.5,Design 2,Design 2,"Have an option between Design #1 and Design #2,",,4.0,3.0
319,2898,3,Player object (1039),buy,2023-03-08 23:48:13.024038+00:00,"{""priceA"": 100, ""sharesA"": 1, ""secs_since_round_starts"": 107, ""market"": ""A""}",75.0,21.0,6.0,41x3lsag,vmu7c279,FULL STUDY,275.0,s1,1,100,120.0,-1,,1,sell,0,sell,0.4692484881524699,19,0,0,block 2 (G first),20.0,12.0,Female,1.0,0.0,0.0,"[3, 'block 2 (G first)']",1,0,0,0.5,7.0,-0.30000000000000004,0.5714285714285714,0.0,1.0,0.0,4,1.0,0.5,Design 2,Design 2,"Have an option between Design #1 and Design #2,",,4.0,3.0
320,2899,3,Player object (1039),sell,2023-03-08 23:48:29.765600+00:00,"{""priceA"": 115, ""sharesA"": 0, ""secs_since_round_starts"": 124, ""market"": ""A""}",190.0,24.0,7.0,41x3lsag,vmu7c279,FULL STUDY,275.0,s1,1,115,100.0,1,15.0,1,buy,0,sell,0.5319650978870379,19,0,0,block 2 (G first),20.0,12.0,Female,1.0,0.0,0.0,"[3, 'block 2 (G first)']",1,0,0,0.5,7.0,-0.30000000000000004,0.5714285714285714,0.0,1.0,0.0,4,1.0,0.5,Design 2,Design 2,"Have an option between Design #1 and Design #2,",,4.0,3.0
321,2900,3,Player object (1039),buy,2023-03-08 23:48:46.452503+00:00,"{""priceA"": 105, ""sharesA"": 1, ""secs_since_round_starts"": 141, ""market"": ""A""}",85.0,27.0,8.0,41x3lsag,vmu7c279,FULL STUDY,275.0,s1,1,105,115.0,-1,,1,sell,0,sell,0.4832330156747784,19,0,0,block 2 (G first),20.0,12.0,Female,1.0,0.0,0.0,"[3, 'block 2 (G first)']",1,0,0,0.5,7.0,-0.30000000000000004,0.5714285714285714,0.0,1.0,0.0,4,1.0,0.5,Design 2,Design 2,"Have an option between Design #1 and Design #2,",,4.0,3.0
322,2901,3,Player object (1039),sell,2023-03-08 23:49:03.068730+00:00,"{""priceA"": 120, ""sharesA"": 0, ""secs_since_round_starts"": 158, ""market"": ""A""}",205.0,30.0,9.0,41x3lsag,vmu7c279,FULL STUDY,275.0,s1,1,120,105.0,1,15.0,1,buy,0,sell,0.570054331362491,19,0,1,block 2 (G first),20.0,12.0,Female,1.0,0.0,0.0,"[3, 'block 2 (G first)']",1,0,0,0.5,7.0,-0.30000000000000004,0.5714285714285714,0.0,1.0,0.0,4,1.0,0.5,Design 2,Design 2,"Have an option between Design #1 and Design #2,",,4.0,3.0
323,2905,3,Player object (1039),buy,2023-03-08 23:49:21.971268+00:00,"{""priceA"": 100, ""sharesA"": 1, ""secs_since_round_starts"": 176, ""market"": ""A""}",105.0,33.0,10.0,41x3lsag,vmu7c279,FULL STUDY,275.0,s1,1,100,120.0,-1,,1,sell,0,sell,0.4476889957041811,19,1,0,block 2 (G first),20.0,12.0,Female,1.0,0.0,0.0,"[3, 'block 2 (G first)']",1,0,0,0.5,7.0,-0.30000000000000004,0.5714285714285714,0.0,1.0,0.0,4,1.0,0.5,Design 2,Design 2,"Have an option between Design #1 and Design #2,",,4.0,3.0
324,2908,3,Player object (1039),sell,2023-03-08 23:49:58.665131+00:00,"{""priceA"": 115, ""sharesA"": 0, ""secs_since_round_starts"": 213, ""market"": ""A""}",220.0,39.0,11.0,41x3lsag,vmu7c279,FULL STUDY,275.0,s1,1,115,100.0,1,15.0,1,buy,0,sell,0.5221490272476892,19,0,0,block 2 (G first),20.0,12.0,Female,1.0,0.0,0.0,"[3, 'block 2 (G first)']",1,0,0,0.5,7.0,-0.30000000000000004,0.5714285714285714,0.0,1.0,0.0,4,1.0,0.5,Design 2,Design 2,"Have an option between Design #1 and Design #2,",,4.0,3.0
325,2911,3,Player object (1039),buy,2023-03-08 23:50:09.879398+00:00,"{""priceA"": 95, ""sharesA"": 1, ""secs_since_round_starts"": 224, ""market"": ""A""}",125.0,41.0,12.0,41x3lsag,vmu7c279,FULL STUDY,275.0,s1,1,95,115.0,-1,,1,sell,0,sell,0.4514823197003955,19,0,0,block 2 (G first),20.0,12.0,Female,1.0,0.0,0.0,"[3, 'block 2 (G first)']",1,0,0,0.5,7.0,-0.30000000000000004,0.5714285714285714,0.0,1.0,0.0,4,1.0,0.5,Design 2,Design 2,"Have an option between Design #1 and Design #2,",,4.0,3.0
326,2912,3,Player object (1039),sell,2023-03-08 23:50:20.686671+00:00,"{""priceA"": 120, ""sharesA"": 0, ""secs_since_round_starts"": 235, ""market"": ""A""}",245.0,43.0,13.0,41x3lsag,vmu7c279,FULL STUDY,275.0,s1,1,120,95.0,1,25.0,1,buy,0,sell,0.5357259670782416,19,0,0,block 2 (G first),20.0,12.0,Female,1.0,0.0,0.0,"[3, 'block 2 (G first)']",1,0,0,0.5,7.0,-0.30000000000000004,0.5714285714285714,0.0,1.0,0.0,4,1.0,0.5,Design 2,Design 2,"Have an option between Design #1 and Design #2,",,4.0,3.0
327,2913,3,Player object (1039),buy,2023-03-08 23:50:54.220608+00:00,"{""priceA"": 110, ""sharesA"": 1, ""secs_since_round_starts"": 269, ""market"": ""A""}",135.0,49.0,14.0,41x3lsag,vmu7c279,FULL STUDY,275.0,s1,1,110,120.0,-1,,1,sell,0,sell,0.4374794566672981,19,1,0,block 2 (G first),20.0,12.0,Female,1.0,0.0,0.0,"[3, 'block 2 (G first)']",1,0,0,0.5,7.0,-0.30000000000000004,0.5714285714285714,0.0,1.0,0.0,4,1.0,0.5,Design 2,Design 2,"Have an option between Design #1 and Design #2,",,4.0,3.0
328,2915,3,Player object (1039),sell,2023-03-08 23:50:59.686579+00:00,"{""priceA"": 125, ""sharesA"": 0, ""secs_since_round_starts"": 274, ""market"": ""A""}",260.0,50.0,15.0,41x3lsag,vmu7c279,FULL STUDY,275.0,s1,1,125,110.0,1,15.0,1,buy,0,sell,0.4911246412164243,19,0,0,block 2 (G first),20.0,12.0,Female,1.0,0.0,0.0,"[3, 'block 2 (G first)']",1,0,0,0.5,7.0,-0.30000000000000004,0.5714285714285714,0.0,1.0,0.0,4,1.0,0.5,Design 2,Design 2,"Have an option between Design #1 and Design #2,",,4.0,3.0
329,2918,3,Player object (1039),buy,2023-03-08 23:51:15.718742+00:00,"{""priceA"": 115, ""sharesA"": 1, ""secs_since_round_starts"": 290, ""market"": ""A""}",145.0,52.0,16.0,41x3lsag,vmu7c279,FULL STUDY,275.0,s1,1,115,125.0,-1,,1,sell,0,sell,0.4367228334197354,19,0,0,block 2 (G first),20.0,12.0,Female,1.0,0.0,0.0,"[3, 'block 2 (G first)']",1,0,0,0.5,7.0,-0.30000000000000004,0.5714285714285714,0.0,1.0,0.0,4,1.0,0.5,Design 2,Design 2,"Have an option between Design #1 and Design #2,",,4.0,3.0
330,2920,3,Player object (1039),sell,2023-03-08 23:51:19.843982+00:00,"{""priceA"": 130, ""sharesA"": 0, ""secs_since_round_starts"": 294, ""market"": ""A""}",275.0,53.0,17.0,41x3lsag,vmu7c279,FULL STUDY,275.0,s1,1,130,115.0,1,15.0,1,buy,0,sell,0.4905868559773416,19,0,0,block 2 (G first),20.0,12.0,Female,1.0,0.0,0.0,"[3, 'block 2 (G first)']",1,0,0,0.5,7.0,-0.30000000000000004,0.5714285714285714,0.0,1.0,0.0,4,1.0,0.5,Design 2,Design 2,"Have an option between Design #1 and Design #2,",,4.0,3.0
331,2921,3,Player object (1039),buy,2023-03-08 23:51:47.496591+00:00,"{""priceA"": 115, ""sharesA"": 1, ""secs_since_round_starts"": 322, ""market"": ""A""}",160.0,58.0,18.0,41x3lsag,vmu7c279,FULL STUDY,275.0,s1,1,115,130.0,-1,,1,sell,0,sell,0.442461876115205,19,1,0,block 2 (G first),20.0,12.0,Female,1.0,0.0,0.0,"[3, 'block 2 (G first)']",1,0,0,0.5,7.0,-0.30000000000000004,0.5714285714285714,0.0,1.0,0.0,4,1.0,0.5,Design 2,Design 2,"Have an option between Design #1 and Design #2,",,4.0,3.0
332,2928,4,Player object (1159),sell,2023-03-08 23:53:11.330724+00:00,"{""priceA"": 90, ""sharesA"": 0, ""secs_since_round_starts"": 65, ""market"": ""A""}",140.0,12.0,1.0,41x3lsag,vmu7c279,FULL STUDY,180.0,s1,1,90,,1,,1,,0,sell,0.5210961257750505,14,0,0,block 2 (G first),20.0,12.0,Female,1.0,0.0,0.0,"[4, 'block 2 (G first)']",0,1,0,1.0,7.0,-0.30000000000000004,0.6666666666666666,0.041666666666666664,1.0,0.0,4,0.5,0.25,Design 2,Design 2,"Have an option between Design #1 and Design #2,",,4.0,3.0
333,2929,4,Player object (1159),buy,2023-03-08 23:53:18.574788+00:00,"{""priceA"": 75, ""sharesA"": 1, ""secs_since_round_starts"": 72, ""market"": ""A""}",65.0,13.0,2.0,41x3lsag,vmu7c279,FULL STUDY,180.0,s1,1,75,90.0,-1,,1,sell,0,sell,0.479681559969247,14,0,0,block 2 (G first),20.0,12.0,Female,1.0,0.0,0.0,"[4, 'block 2 (G first)']",0,1,0,1.0,7.0,-0.30000000000000004,0.6666666666666666,0.041666666666666664,1.0,0.0,4,0.5,0.25,Design 2,Design 2,"Have an option between Design #1 and Design #2,",,4.0,3.0
334,2931,4,Player object (1159),sell,2023-03-08 23:53:31.015108+00:00,"{""priceA"": 95, ""sharesA"": 0, ""secs_since_round_starts"": 85, ""market"": ""A""}",160.0,15.0,3.0,41x3lsag,vmu7c279,FULL STUDY,180.0,s1,1,95,75.0,1,20.0,1,buy,0,sell,0.5493972040799432,14,0,0,block 2 (G first),20.0,12.0,Female,1.0,0.0,0.0,"[4, 'block 2 (G first)']",0,1,0,1.0,7.0,-0.30000000000000004,0.6666666666666666,0.041666666666666664,1.0,0.0,4,0.5,0.25,Design 2,Design 2,"Have an option between Design #1 and Design #2,",,4.0,3.0
335,2942,4,Player object (1159),buy,2023-03-08 23:53:44.570581+00:00,"{""priceA"": 70, ""sharesA"": 1, ""secs_since_round_starts"": 98, ""market"": ""A""}",90.0,18.0,5.0,41x3lsag,vmu7c279,FULL STUDY,180.0,s1,1,70,90.0,-1,,1,sell,0,sell,0.4407118028401492,14,1,0,block 2 (G first),20.0,12.0,Female,1.0,0.0,0.0,"[4, 'block 2 (G first)']",0,1,0,1.0,7.0,-0.30000000000000004,0.6666666666666666,0.041666666666666664,1.0,0.0,4,0.5,0.25,Design 2,Design 2,"Have an option between Design #1 and Design #2,",,4.0,3.0
336,2944,4,Player object (1159),sell,2023-03-08 23:54:39.899668+00:00,"{""priceA"": 80, ""sharesA"": 0, ""secs_since_round_starts"": 154, ""market"": ""A""}",170.0,28.0,6.0,41x3lsag,vmu7c279,FULL STUDY,180.0,s1,1,80,70.0,1,10.0,1,buy,0,sell,0.5529051331090981,14,0,1,block 2 (G first),20.0,12.0,Female,1.0,0.0,0.0,"[4, 'block 2 (G first)']",0,1,0,1.0,7.0,-0.30000000000000004,0.6666666666666666,0.041666666666666664,1.0,0.0,4,0.5,0.25,Design 2,Design 2,"Have an option between Design #1 and Design #2,",,4.0,3.0
337,2947,4,Player object (1159),buy,2023-03-08 23:55:33.114732+00:00,"{""priceA"": 70, ""sharesA"": 1, ""secs_since_round_starts"": 207, ""market"": ""A""}",100.0,37.0,7.0,41x3lsag,vmu7c279,FULL STUDY,180.0,s1,1,70,80.0,-1,,1,sell,0,sell,0.4570673777008929,14,0,0,block 2 (G first),20.0,12.0,Female,1.0,0.0,0.0,"[4, 'block 2 (G first)']",0,1,0,1.0,7.0,-0.30000000000000004,0.6666666666666666,0.041666666666666664,1.0,0.0,4,0.5,0.25,Design 2,Design 2,"Have an option between Design #1 and Design #2,",,4.0,3.0
338,2949,4,Player object (1159),sell,2023-03-08 23:55:44.511628+00:00,"{""priceA"": 80, ""sharesA"": 0, ""secs_since_round_starts"": 218, ""market"": ""A""}",180.0,39.0,8.0,41x3lsag,vmu7c279,FULL STUDY,180.0,s1,1,80,70.0,1,10.0,1,buy,0,sell,0.4897180556691627,14,0,0,block 2 (G first),20.0,12.0,Female,1.0,0.0,0.0,"[4, 'block 2 (G first)']",0,1,0,1.0,7.0,-0.30000000000000004,0.6666666666666666,0.041666666666666664,1.0,0.0,4,0.5,0.25,Design 2,Design 2,"Have an option between Design #1 and Design #2,",,4.0,3.0
339,2952,4,Player object (1159),buy,2023-03-08 23:56:27.611099+00:00,"{""priceA"": 85, ""sharesA"": 1, ""secs_since_round_starts"": 261, ""market"": ""A""}",95.0,47.0,9.0,41x3lsag,vmu7c279,FULL STUDY,180.0,s1,1,85,80.0,-1,,1,sell,0,sell,0.4501495476988393,14,1,0,block 2 (G first),20.0,12.0,Female,1.0,0.0,0.0,"[4, 'block 2 (G first)']",0,1,0,1.0,7.0,-0.30000000000000004,0.6666666666666666,0.041666666666666664,1.0,0.0,4,0.5,0.25,Design 2,Design 2,"Have an option between Design #1 and Design #2,",,4.0,3.0
340,2953,4,Player object (1159),sell,2023-03-08 23:56:35.817541+00:00,"{""priceA"": 100, ""sharesA"": 0, ""secs_since_round_starts"": 270, ""market"": ""A""}",195.0,48.0,10.0,41x3lsag,vmu7c279,FULL STUDY,180.0,s1,1,100,85.0,1,15.0,1,buy,0,sell,0.500105737602651,14,0,0,block 2 (G first),20.0,12.0,Female,1.0,0.0,0.0,"[4, 'block 2 (G first)']",0,1,0,1.0,7.0,-0.30000000000000004,0.6666666666666666,0.041666666666666664,1.0,0.0,4,0.5,0.25,Design 2,Design 2,"Have an option between Design #1 and Design #2,",,4.0,3.0
341,2955,4,Player object (1159),buy,2023-03-08 23:56:55.565886+00:00,"{""priceA"": 90, ""sharesA"": 1, ""secs_since_round_starts"": 289, ""market"": ""A""}",105.0,52.0,11.0,41x3lsag,vmu7c279,FULL STUDY,180.0,s1,1,90,100.0,-1,,1,sell,0,sell,0.4694909620846048,14,0,0,block 2 (G first),20.0,12.0,Female,1.0,0.0,0.0,"[4, 'block 2 (G first)']",0,1,0,1.0,7.0,-0.30000000000000004,0.6666666666666666,0.041666666666666664,1.0,0.0,4,0.5,0.25,Design 2,Design 2,"Have an option between Design #1 and Design #2,",,4.0,3.0
342,2959,5,Player object (1279),sell,2023-03-08 23:58:25.309876+00:00,"{""priceA"": 80, ""sharesA"": 0, ""secs_since_round_starts"": 39, ""market"": ""A""}",130.0,9.0,1.0,41x3lsag,vmu7c279,FULL STUDY,180.0,s1,1,80,,1,,1,,0,sell,0.4765586288879626,17,0,0,block 2 (G first),20.0,12.0,Female,1.0,0.0,0.0,"[5, 'block 2 (G first)']",0,0,0,0.5,7.0,-0.30000000000000004,0.38461538461538464,0.043478260869565216,0.6666666666666666,0.0,2,1.0,0.25,Design 2,Design 2,"Have an option between Design #1 and Design #2,",,4.0,3.0
343,2960,5,Player object (1279),buy,2023-03-08 23:58:31.203200+00:00,"{""priceA"": 75, ""sharesA"": 1, ""secs_since_round_starts"": 45, ""market"": ""A""}",55.0,10.0,2.0,41x3lsag,vmu7c279,FULL STUDY,180.0,s1,1,75,80.0,-1,,1,sell,0,sell,0.4488309348307913,17,1,0,block 2 (G first),20.0,12.0,Female,1.0,0.0,0.0,"[5, 'block 2 (G first)']",0,0,0,0.5,7.0,-0.30000000000000004,0.38461538461538464,0.043478260869565216,0.6666666666666666,0.0,2,1.0,0.25,Design 2,Design 2,"Have an option between Design #1 and Design #2,",,4.0,3.0
344,2963,5,Player object (1279),sell,2023-03-08 23:59:00.220490+00:00,"{""priceA"": 90, ""sharesA"": 0, ""secs_since_round_starts"": 74, ""market"": ""A""}",145.0,15.0,3.0,41x3lsag,vmu7c279,FULL STUDY,180.0,s1,1,90,75.0,1,15.0,1,buy,0,sell,0.505231414156075,17,0,0,block 2 (G first),20.0,12.0,Female,1.0,0.0,0.0,"[5, 'block 2 (G first)']",0,0,0,0.5,7.0,-0.30000000000000004,0.38461538461538464,0.043478260869565216,0.6666666666666666,0.0,2,1.0,0.25,Design 2,Design 2,"Have an option between Design #1 and Design #2,",,4.0,3.0
345,2969,5,Player object (1279),buy,2023-03-08 23:59:16.805134+00:00,"{""priceA"": 70, ""sharesA"": 1, ""secs_since_round_starts"": 91, ""market"": ""A""}",75.0,18.0,4.0,41x3lsag,vmu7c279,FULL STUDY,180.0,s1,1,70,90.0,-1,,1,sell,0,sell,0.42621223683237,17,1,0,block 2 (G first),20.0,12.0,Female,1.0,0.0,0.0,"[5, 'block 2 (G first)']",0,0,0,0.5,7.0,-0.30000000000000004,0.38461538461538464,0.043478260869565216,0.6666666666666666,0.0,2,1.0,0.25,Design 2,Design 2,"Have an option between Design #1 and Design #2,",,4.0,3.0
346,2979,5,Player object (1279),sell,2023-03-08 23:59:32.281028+00:00,"{""priceA"": 105, ""sharesA"": 0, ""secs_since_round_starts"": 106, ""market"": ""A""}",180.0,21.0,5.0,41x3lsag,vmu7c279,FULL STUDY,180.0,s1,1,105,70.0,1,35.0,1,buy,0,sell,0.5510362930796925,17,0,1,block 2 (G first),20.0,12.0,Female,1.0,0.0,0.0,"[5, 'block 2 (G first)']",0,0,0,0.5,7.0,-0.30000000000000004,0.38461538461538464,0.043478260869565216,0.6666666666666666,0.0,2,1.0,0.25,Design 2,Design 2,"Have an option between Design #1 and Design #2,",,4.0,3.0
347,2994,5,Player object (1279),buy,2023-03-08 23:59:43.434533+00:00,"{""priceA"": 95, ""sharesA"": 1, ""secs_since_round_starts"": 117, ""market"": ""A""}",85.0,23.0,6.0,41x3lsag,vmu7c279,FULL STUDY,180.0,s1,1,95,105.0,-1,,1,sell,0,sell,0.5355078155027276,17,0,0,block 2 (G first),20.0,12.0,Female,1.0,0.0,0.0,"[5, 'block 2 (G first)']",0,0,0,0.5,7.0,-0.30000000000000004,0.38461538461538464,0.043478260869565216,0.6666666666666666,0.0,2,1.0,0.25,Design 2,Design 2,"Have an option between Design #1 and Design #2,",,4.0,3.0
348,2998,5,Player object (1279),sell,2023-03-08 23:59:48.760012+00:00,"{""priceA"": 105, ""sharesA"": 0, ""secs_since_round_starts"": 122, ""market"": ""A""}",190.0,24.0,7.0,41x3lsag,vmu7c279,FULL STUDY,180.0,s1,1,105,95.0,1,10.0,1,buy,0,sell,0.5594334008058068,17,0,0,block 2 (G first),20.0,12.0,Female,1.0,0.0,0.0,"[5, 'block 2 (G first)']",0,0,0,0.5,7.0,-0.30000000000000004,0.38461538461538464,0.043478260869565216,0.6666666666666666,0.0,2,1.0,0.25,Design 2,Design 2,"Have an option between Design #1 and Design #2,",,4.0,3.0
349,3001,5,Player object (1279),buy,2023-03-09 00:00:04.511187+00:00,"{""priceA"": 100, ""sharesA"": 1, ""secs_since_round_starts"": 138, ""market"": ""A""}",90.0,27.0,8.0,41x3lsag,vmu7c279,FULL STUDY,180.0,s1,1,100,105.0,-1,,1,sell,0,sell,0.4777068930880888,17,0,0,block 2 (G first),20.0,12.0,Female,1.0,0.0,0.0,"[5, 'block 2 (G first)']",0,0,0,0.5,7.0,-0.30000000000000004,0.38461538461538464,0.043478260869565216,0.6666666666666666,0.0,2,1.0,0.25,Design 2,Design 2,"Have an option between Design #1 and Design #2,",,4.0,3.0
350,3006,5,Player object (1279),sell,2023-03-09 00:00:38.560381+00:00,"{""priceA"": 110, ""sharesA"": 0, ""secs_since_round_starts"": 172, ""market"": ""A""}",200.0,33.0,9.0,41x3lsag,vmu7c279,FULL STUDY,180.0,s1,1,110,100.0,1,10.0,1,buy,0,sell,0.5480287979668599,17,0,1,block 2 (G first),20.0,12.0,Female,1.0,0.0,0.0,"[5, 'block 2 (G first)']",0,0,0,0.5,7.0,-0.30000000000000004,0.38461538461538464,0.043478260869565216,0.6666666666666666,0.0,2,1.0,0.25,Design 2,Design 2,"Have an option between Design #1 and Design #2,",,4.0,3.0
351,3007,5,Player object (1279),buy,2023-03-09 00:01:00.281442+00:00,"{""priceA"": 95, ""sharesA"": 1, ""secs_since_round_starts"": 194, ""market"": ""A""}",105.0,37.0,10.0,41x3lsag,vmu7c279,FULL STUDY,180.0,s1,1,95,110.0,-1,,1,sell,0,sell,0.4805886028013266,17,0,0,block 2 (G first),20.0,12.0,Female,1.0,0.0,0.0,"[5, 'block 2 (G first)']",0,0,0,0.5,7.0,-0.30000000000000004,0.38461538461538464,0.043478260869565216,0.6666666666666666,0.0,2,1.0,0.25,Design 2,Design 2,"Have an option between Design #1 and Design #2,",,4.0,3.0
352,3009,5,Player object (1279),sell,2023-03-09 00:01:39.313833+00:00,"{""priceA"": 105, ""sharesA"": 0, ""secs_since_round_starts"": 233, ""market"": ""A""}",210.0,44.0,11.0,41x3lsag,vmu7c279,FULL STUDY,180.0,s1,1,105,95.0,1,10.0,1,buy,0,sell,0.515125859635568,17,0,0,block 2 (G first),20.0,12.0,Female,1.0,0.0,0.0,"[5, 'block 2 (G first)']",0,0,0,0.5,7.0,-0.30000000000000004,0.38461538461538464,0.043478260869565216,0.6666666666666666,0.0,2,1.0,0.25,Design 2,Design 2,"Have an option between Design #1 and Design #2,",,4.0,3.0
353,3010,5,Player object (1279),buy,2023-03-09 00:01:50.525611+00:00,"{""priceA"": 95, ""sharesA"": 1, ""secs_since_round_starts"": 244, ""market"": ""A""}",115.0,46.0,12.0,41x3lsag,vmu7c279,FULL STUDY,180.0,s1,1,95,105.0,-1,,1,sell,0,sell,0.4967862103563366,17,0,0,block 2 (G first),20.0,12.0,Female,1.0,0.0,0.0,"[5, 'block 2 (G first)']",0,0,0,0.5,7.0,-0.30000000000000004,0.38461538461538464,0.043478260869565216,0.6666666666666666,0.0,2,1.0,0.25,Design 2,Design 2,"Have an option between Design #1 and Design #2,",,4.0,3.0
354,344,2,Player object (851),sell,2023-02-25 02:30:54.455377+00:00,"{""priceA"": 100, ""sharesA"": 0, ""secs_since_round_starts"": 56, ""market"": ""A""}",150.0,7.0,1.0,5c7udvpd,vmu7c279,FULL STUDY,210.0,s3,1,100,,1,,1,,0,sell,0.4669924949471701,16,0,0,block 2 (G first),23.0,10.0,Male,1.0,0.0,0.0,"[2, 'block 2 (G first)']",1,1,0,1.0,5.0,-0.33333333333333337,0.07692307692307693,0.0,0.2,0.0,4,1.0,0.5,Design 2,Design 2,"Have an option between Design #1 and Design #2,",5.0,5.0,5.0
355,345,2,Player object (851),buy,2023-02-25 02:31:10.122366+00:00,"{""priceA"": 75, ""sharesA"": 1, ""secs_since_round_starts"": 72, ""market"": ""A""}",75.0,10.0,2.0,5c7udvpd,vmu7c279,FULL STUDY,210.0,s3,1,75,100.0,-1,,1,sell,0,sell,0.4825575314143953,16,0,0,block 2 (G first),23.0,10.0,Male,1.0,0.0,0.0,"[2, 'block 2 (G first)']",1,1,0,1.0,5.0,-0.33333333333333337,0.07692307692307693,0.0,0.2,0.0,4,1.0,0.5,Design 2,Design 2,"Have an option between Design #1 and Design #2,",5.0,5.0,5.0
356,346,2,Player object (851),sell,2023-02-25 02:31:49.341445+00:00,"{""priceA"": 110, ""sharesA"": 0, ""secs_since_round_starts"": 111, ""market"": ""A""}",185.0,17.0,3.0,5c7udvpd,vmu7c279,FULL STUDY,210.0,s3,1,110,75.0,1,35.0,1,buy,0,sell,0.5478276073026133,16,0,0,block 2 (G first),23.0,10.0,Male,1.0,0.0,0.0,"[2, 'block 2 (G first)']",1,1,0,1.0,5.0,-0.33333333333333337,0.07692307692307693,0.0,0.2,0.0,4,1.0,0.5,Design 2,Design 2,"Have an option between Design #1 and Design #2,",5.0,5.0,5.0
357,347,2,Player object (851),buy,2023-02-25 02:32:55.770732+00:00,"{""priceA"": 115, ""sharesA"": 1, ""secs_since_round_starts"": 178, ""market"": ""A""}",70.0,29.0,4.0,5c7udvpd,vmu7c279,FULL STUDY,210.0,s3,1,115,110.0,-1,,1,sell,0,sell,0.41991811093665,16,0,0,block 2 (G first),23.0,10.0,Male,1.0,0.0,0.0,"[2, 'block 2 (G first)']",1,1,0,1.0,5.0,-0.33333333333333337,0.07692307692307693,0.0,0.2,0.0,4,1.0,0.5,Design 2,Design 2,"Have an option between Design #1 and Design #2,",5.0,5.0,5.0
358,349,2,Player object (851),sell,2023-02-25 02:34:35.233082+00:00,"{""priceA"": 155, ""sharesA"": 0, ""secs_since_round_starts"": 277, ""market"": ""A""}",225.0,46.0,5.0,5c7udvpd,vmu7c279,FULL STUDY,210.0,s3,1,155,115.0,1,40.0,1,buy,0,sell,0.5495494947508355,16,0,1,block 2 (G first),23.0,10.0,Male,1.0,0.0,0.0,"[2, 'block 2 (G first)']",1,1,0,1.0,5.0,-0.33333333333333337,0.07692307692307693,0.0,0.2,0.0,4,1.0,0.5,Design 2,Design 2,"Have an option between Design #1 and Design #2,",5.0,5.0,5.0
359,350,2,Player object (851),buy,2023-02-25 02:35:02.568607+00:00,"{""priceA"": 140, ""sharesA"": 1, ""secs_since_round_starts"": 304, ""market"": ""A""}",85.0,51.0,6.0,5c7udvpd,vmu7c279,FULL STUDY,210.0,s3,1,140,155.0,-1,,1,sell,0,sell,0.4693918893964308,16,0,0,block 2 (G first),23.0,10.0,Male,1.0,0.0,0.0,"[2, 'block 2 (G first)']",1,1,0,1.0,5.0,-0.33333333333333337,0.07692307692307693,0.0,0.2,0.0,4,1.0,0.5,Design 2,Design 2,"Have an option between Design #1 and Design #2,",5.0,5.0,5.0
360,354,3,Player object (971),sell,2023-02-25 02:36:50.138989+00:00,"{""priceA"": 90, ""sharesA"": 0, ""secs_since_round_starts"": 52, ""market"": ""A""}",140.0,7.0,1.0,5c7udvpd,vmu7c279,FULL STUDY,215.0,s3,1,90,,1,,1,,0,sell,0.4580966810292103,19,0,0,block 2 (G first),23.0,10.0,Male,1.0,0.0,0.0,"[3, 'block 2 (G first)']",1,0,0,0.5,5.0,-0.33333333333333337,0.375,0.08333333333333333,1.0,0.0,4,1.0,0.25,Design 2,Design 2,"Have an option between Design #1 and Design #2,",5.0,5.0,5.0
361,355,3,Player object (971),buy,2023-02-25 02:36:54.124615+00:00,"{""priceA"": 100, ""sharesA"": 1, ""secs_since_round_starts"": 56, ""market"": ""A""}",40.0,8.0,2.0,5c7udvpd,vmu7c279,FULL STUDY,215.0,s3,1,100,90.0,-1,,1,sell,0,sell,0.5057155770500936,19,0,0,block 2 (G first),23.0,10.0,Male,1.0,0.0,0.0,"[3, 'block 2 (G first)']",1,0,0,0.5,5.0,-0.33333333333333337,0.375,0.08333333333333333,1.0,0.0,4,1.0,0.25,Design 2,Design 2,"Have an option between Design #1 and Design #2,",5.0,5.0,5.0
362,356,3,Player object (971),sell,2023-02-25 02:37:10.308553+00:00,"{""priceA"": 110, ""sharesA"": 0, ""secs_since_round_starts"": 72, ""market"": ""A""}",150.0,11.0,3.0,5c7udvpd,vmu7c279,FULL STUDY,215.0,s3,1,110,100.0,1,10.0,1,buy,0,sell,0.5295922419004607,19,0,0,block 2 (G first),23.0,10.0,Male,1.0,0.0,0.0,"[3, 'block 2 (G first)']",1,0,0,0.5,5.0,-0.33333333333333337,0.375,0.08333333333333333,1.0,0.0,4,1.0,0.25,Design 2,Design 2,"Have an option between Design #1 and Design #2,",5.0,5.0,5.0
363,357,3,Player object (971),buy,2023-02-25 02:37:33.830536+00:00,"{""priceA"": 110, ""sharesA"": 1, ""secs_since_round_starts"": 96, ""market"": ""A""}",40.0,15.0,4.0,5c7udvpd,vmu7c279,FULL STUDY,215.0,s3,1,110,110.0,-1,,1,sell,0,sell,0.4763410641166328,19,0,0,block 2 (G first),23.0,10.0,Male,1.0,0.0,0.0,"[3, 'block 2 (G first)']",1,0,0,0.5,5.0,-0.33333333333333337,0.375,0.08333333333333333,1.0,0.0,4,1.0,0.25,Design 2,Design 2,"Have an option between Design #1 and Design #2,",5.0,5.0,5.0
364,358,3,Player object (971),sell,2023-02-25 02:37:54.577338+00:00,"{""priceA"": 120, ""sharesA"": 0, ""secs_since_round_starts"": 116, ""market"": ""A""}",160.0,19.0,5.0,5c7udvpd,vmu7c279,FULL STUDY,215.0,s3,1,120,110.0,1,10.0,1,buy,0,sell,0.5586446427659006,19,0,1,block 2 (G first),23.0,10.0,Male,1.0,0.0,0.0,"[3, 'block 2 (G first)']",1,0,0,0.5,5.0,-0.33333333333333337,0.375,0.08333333333333333,1.0,0.0,4,1.0,0.25,Design 2,Design 2,"Have an option between Design #1 and Design #2,",5.0,5.0,5.0
365,359,3,Player object (971),buy,2023-02-25 02:38:05.118822+00:00,"{""priceA"": 100, ""sharesA"": 1, ""secs_since_round_starts"": 127, ""market"": ""A""}",60.0,21.0,6.0,5c7udvpd,vmu7c279,FULL STUDY,215.0,s3,1,100,120.0,-1,,1,sell,0,sell,0.4692484881524699,19,0,0,block 2 (G first),23.0,10.0,Male,1.0,0.0,0.0,"[3, 'block 2 (G first)']",1,0,0,0.5,5.0,-0.33333333333333337,0.375,0.08333333333333333,1.0,0.0,4,1.0,0.25,Design 2,Design 2,"Have an option between Design #1 and Design #2,",5.0,5.0,5.0
366,360,3,Player object (971),sell,2023-02-25 02:38:22.907220+00:00,"{""priceA"": 115, ""sharesA"": 0, ""secs_since_round_starts"": 145, ""market"": ""A""}",175.0,24.0,7.0,5c7udvpd,vmu7c279,FULL STUDY,215.0,s3,1,115,100.0,1,15.0,1,buy,0,sell,0.5319650978870379,19,0,0,block 2 (G first),23.0,10.0,Male,1.0,0.0,0.0,"[3, 'block 2 (G first)']",1,0,0,0.5,5.0,-0.33333333333333337,0.375,0.08333333333333333,1.0,0.0,4,1.0,0.25,Design 2,Design 2,"Have an option between Design #1 and Design #2,",5.0,5.0,5.0
367,361,3,Player object (971),buy,2023-02-25 02:38:39.005982+00:00,"{""priceA"": 105, ""sharesA"": 1, ""secs_since_round_starts"": 161, ""market"": ""A""}",70.0,27.0,8.0,5c7udvpd,vmu7c279,FULL STUDY,215.0,s3,1,105,115.0,-1,,1,sell,0,sell,0.4832330156747784,19,0,0,block 2 (G first),23.0,10.0,Male,1.0,0.0,0.0,"[3, 'block 2 (G first)']",1,0,0,0.5,5.0,-0.33333333333333337,0.375,0.08333333333333333,1.0,0.0,4,1.0,0.25,Design 2,Design 2,"Have an option between Design #1 and Design #2,",5.0,5.0,5.0
368,362,3,Player object (971),sell,2023-02-25 02:38:54.177511+00:00,"{""priceA"": 120, ""sharesA"": 0, ""secs_since_round_starts"": 176, ""market"": ""A""}",190.0,30.0,9.0,5c7udvpd,vmu7c279,FULL STUDY,215.0,s3,1,120,105.0,1,15.0,1,buy,0,sell,0.570054331362491,19,0,1,block 2 (G first),23.0,10.0,Male,1.0,0.0,0.0,"[3, 'block 2 (G first)']",1,0,0,0.5,5.0,-0.33333333333333337,0.375,0.08333333333333333,1.0,0.0,4,1.0,0.25,Design 2,Design 2,"Have an option between Design #1 and Design #2,",5.0,5.0,5.0
369,364,3,Player object (971),buy,2023-02-25 02:39:18.779021+00:00,"{""priceA"": 100, ""sharesA"": 1, ""secs_since_round_starts"": 201, ""market"": ""A""}",90.0,33.0,10.0,5c7udvpd,vmu7c279,FULL STUDY,215.0,s3,1,100,120.0,-1,,1,sell,0,sell,0.4476889957041811,19,1,0,block 2 (G first),23.0,10.0,Male,1.0,0.0,0.0,"[3, 'block 2 (G first)']",1,0,0,0.5,5.0,-0.33333333333333337,0.375,0.08333333333333333,1.0,0.0,4,1.0,0.25,Design 2,Design 2,"Have an option between Design #1 and Design #2,",5.0,5.0,5.0
370,366,3,Player object (971),sell,2023-02-25 02:40:18.035609+00:00,"{""priceA"": 120, ""sharesA"": 0, ""secs_since_round_starts"": 260, ""market"": ""A""}",210.0,43.0,11.0,5c7udvpd,vmu7c279,FULL STUDY,215.0,s3,1,120,100.0,1,20.0,1,buy,0,sell,0.5357259670782416,19,0,0,block 2 (G first),23.0,10.0,Male,1.0,0.0,0.0,"[3, 'block 2 (G first)']",1,0,0,0.5,5.0,-0.33333333333333337,0.375,0.08333333333333333,1.0,0.0,4,1.0,0.25,Design 2,Design 2,"Have an option between Design #1 and Design #2,",5.0,5.0,5.0
371,367,3,Player object (971),buy,2023-02-25 02:40:50.861893+00:00,"{""priceA"": 110, ""sharesA"": 1, ""secs_since_round_starts"": 293, ""market"": ""A""}",100.0,49.0,12.0,5c7udvpd,vmu7c279,FULL STUDY,215.0,s3,1,110,120.0,-1,,1,sell,0,sell,0.4374794566672981,19,1,0,block 2 (G first),23.0,10.0,Male,1.0,0.0,0.0,"[3, 'block 2 (G first)']",1,0,0,0.5,5.0,-0.33333333333333337,0.375,0.08333333333333333,1.0,0.0,4,1.0,0.25,Design 2,Design 2,"Have an option between Design #1 and Design #2,",5.0,5.0,5.0
372,368,3,Player object (971),sell,2023-02-25 02:41:12.786038+00:00,"{""priceA"": 130, ""sharesA"": 0, ""secs_since_round_starts"": 315, ""market"": ""A""}",230.0,53.0,13.0,5c7udvpd,vmu7c279,FULL STUDY,215.0,s3,1,130,110.0,1,20.0,1,buy,0,sell,0.4905868559773416,19,0,0,block 2 (G first),23.0,10.0,Male,1.0,0.0,0.0,"[3, 'block 2 (G first)']",1,0,0,0.5,5.0,-0.33333333333333337,0.375,0.08333333333333333,1.0,0.0,4,1.0,0.25,Design 2,Design 2,"Have an option between Design #1 and Design #2,",5.0,5.0,5.0
373,369,3,Player object (971),buy,2023-02-25 02:41:34.169631+00:00,"{""priceA"": 130, ""sharesA"": 1, ""secs_since_round_starts"": 336, ""market"": ""A""}",100.0,57.0,14.0,5c7udvpd,vmu7c279,FULL STUDY,215.0,s3,1,130,130.0,-1,,1,sell,0,sell,0.46726452652799,19,0,0,block 2 (G first),23.0,10.0,Male,1.0,0.0,0.0,"[3, 'block 2 (G first)']",1,0,0,0.5,5.0,-0.33333333333333337,0.375,0.08333333333333333,1.0,0.0,4,1.0,0.25,Design 2,Design 2,"Have an option between Design #1 and Design #2,",5.0,5.0,5.0
374,375,4,Player object (1091),sell,2023-02-25 02:45:51.596018+00:00,"{""priceA"": 95, ""sharesA"": 0, ""secs_since_round_starts"": 233, ""market"": ""A""}",145.0,11.0,2.0,5c7udvpd,vmu7c279,FULL STUDY,190.0,s3,1,95,45.0,1,50.0,1,,0,sell,0.5796571916404338,14,0,0,block 2 (G first),23.0,10.0,Male,1.0,0.0,0.0,"[4, 'block 2 (G first)']",0,1,0,0.5,5.0,-0.33333333333333337,0.25,0.11538461538461539,1.0,0.25,4,0.5,0.25,Design 2,Design 2,"Have an option between Design #1 and Design #2,",5.0,5.0,5.0
375,376,4,Player object (1091),buy,2023-02-25 02:46:25.425129+00:00,"{""priceA"": 85, ""sharesA"": 1, ""secs_since_round_starts"": 267, ""market"": ""A""}",60.0,17.0,3.0,5c7udvpd,vmu7c279,FULL STUDY,190.0,s3,1,85,95.0,-1,,1,sell,0,sell,0.4647046911342559,14,0,0,block 2 (G first),23.0,10.0,Male,1.0,0.0,0.0,"[4, 'block 2 (G first)']",0,1,0,0.5,5.0,-0.33333333333333337,0.25,0.11538461538461539,1.0,0.25,4,0.5,0.25,Design 2,Design 2,"Have an option between Design #1 and Design #2,",5.0,5.0,5.0
376,377,4,Player object (1091),sell,2023-02-25 02:47:26.489863+00:00,"{""priceA"": 80, ""sharesA"": 0, ""secs_since_round_starts"": 328, ""market"": ""A""}",140.0,28.0,4.0,5c7udvpd,vmu7c279,FULL STUDY,190.0,s3,1,80,85.0,1,-5.0,1,buy,0,sell,0.5529051331090981,14,0,1,block 2 (G first),23.0,10.0,Male,1.0,0.0,0.0,"[4, 'block 2 (G first)']",0,1,0,0.5,5.0,-0.33333333333333337,0.25,0.11538461538461539,1.0,0.25,4,0.5,0.25,Design 2,Design 2,"Have an option between Design #1 and Design #2,",5.0,5.0,5.0
377,379,4,Player object (1091),buy,2023-02-25 02:48:47.941098+00:00,"{""priceA"": 70, ""sharesA"": 1, ""secs_since_round_starts"": 410, ""market"": ""A""}",70.0,37.0,5.0,5c7udvpd,vmu7c279,FULL STUDY,190.0,s3,1,70,80.0,-1,,1,sell,0,sell,0.4570673777008929,14,0,0,block 2 (G first),23.0,10.0,Male,1.0,0.0,0.0,"[4, 'block 2 (G first)']",0,1,0,0.5,5.0,-0.33333333333333337,0.25,0.11538461538461539,1.0,0.25,4,0.5,0.25,Design 2,Design 2,"Have an option between Design #1 and Design #2,",5.0,5.0,5.0
378,380,4,Player object (1091),sell,2023-02-25 02:49:21.871235+00:00,"{""priceA"": 100, ""sharesA"": 0, ""secs_since_round_starts"": 443, ""market"": ""A""}",170.0,43.0,6.0,5c7udvpd,vmu7c279,FULL STUDY,190.0,s3,1,100,70.0,1,30.0,1,buy,0,sell,0.5617190733230237,14,0,1,block 2 (G first),23.0,10.0,Male,1.0,0.0,0.0,"[4, 'block 2 (G first)']",0,1,0,0.5,5.0,-0.33333333333333337,0.25,0.11538461538461539,1.0,0.25,4,0.5,0.25,Design 2,Design 2,"Have an option between Design #1 and Design #2,",5.0,5.0,5.0
379,381,4,Player object (1091),buy,2023-02-25 02:49:41.783659+00:00,"{""priceA"": 85, ""sharesA"": 1, ""secs_since_round_starts"": 463, ""market"": ""A""}",85.0,47.0,7.0,5c7udvpd,vmu7c279,FULL STUDY,190.0,s3,1,85,100.0,-1,,1,sell,0,sell,0.4501495476988393,14,1,0,block 2 (G first),23.0,10.0,Male,1.0,0.0,0.0,"[4, 'block 2 (G first)']",0,1,0,0.5,5.0,-0.33333333333333337,0.25,0.11538461538461539,1.0,0.25,4,0.5,0.25,Design 2,Design 2,"Have an option between Design #1 and Design #2,",5.0,5.0,5.0
380,382,4,Player object (1091),sell,2023-02-25 02:49:59.355919+00:00,"{""priceA"": 120, ""sharesA"": 0, ""secs_since_round_starts"": 481, ""market"": ""A""}",205.0,50.0,8.0,5c7udvpd,vmu7c279,FULL STUDY,190.0,s3,1,120,85.0,1,35.0,1,buy,0,sell,0.5591364702939366,14,0,1,block 2 (G first),23.0,10.0,Male,1.0,0.0,0.0,"[4, 'block 2 (G first)']",0,1,0,0.5,5.0,-0.33333333333333337,0.25,0.11538461538461539,1.0,0.25,4,0.5,0.25,Design 2,Design 2,"Have an option between Design #1 and Design #2,",5.0,5.0,5.0
381,383,4,Player object (1091),buy,2023-02-25 02:50:09.003306+00:00,"{""priceA"": 90, ""sharesA"": 1, ""secs_since_round_starts"": 491, ""market"": ""A""}",115.0,52.0,9.0,5c7udvpd,vmu7c279,FULL STUDY,190.0,s3,1,90,120.0,-1,,1,sell,0,sell,0.4694909620846048,14,0,0,block 2 (G first),23.0,10.0,Male,1.0,0.0,0.0,"[4, 'block 2 (G first)']",0,1,0,0.5,5.0,-0.33333333333333337,0.25,0.11538461538461539,1.0,0.25,4,0.5,0.25,Design 2,Design 2,"Have an option between Design #1 and Design #2,",5.0,5.0,5.0
382,384,4,Player object (1091),sell,2023-02-25 02:50:54.935984+00:00,"{""priceA"": 75, ""sharesA"": 0, ""secs_since_round_starts"": 537, ""market"": ""A""}",190.0,60.0,10.0,5c7udvpd,vmu7c279,FULL STUDY,190.0,s3,1,75,90.0,1,-15.0,1,buy,0,sell,0.5499940505093152,14,0,1,block 2 (G first),23.0,10.0,Male,1.0,0.0,0.0,"[4, 'block 2 (G first)']",0,1,0,0.5,5.0,-0.33333333333333337,0.25,0.11538461538461539,1.0,0.25,4,0.5,0.25,Design 2,Design 2,"Have an option between Design #1 and Design #2,",5.0,5.0,5.0
383,392,5,Player object (1211),sell,2023-02-25 02:53:17.181499+00:00,"{""priceA"": 105, ""sharesA"": 0, ""secs_since_round_starts"": 136, ""market"": ""A""}",155.0,24.0,3.0,5c7udvpd,vmu7c279,FULL STUDY,170.0,s3,1,105,70.0,1,35.0,1,,0,sell,0.5594334008058068,17,0,0,block 2 (G first),23.0,10.0,Male,1.0,0.0,0.0,"[5, 'block 2 (G first)']",0,0,0,0.5,5.0,-0.33333333333333337,0.3333333333333333,0.0,0.3333333333333333,0.0,5,0.25,1.0,Design 2,Design 2,"Have an option between Design #1 and Design #2,",5.0,5.0,5.0
384,393,5,Player object (1211),buy,2023-02-25 02:53:32.296081+00:00,"{""priceA"": 100, ""sharesA"": 1, ""secs_since_round_starts"": 151, ""market"": ""A""}",55.0,27.0,4.0,5c7udvpd,vmu7c279,FULL STUDY,170.0,s3,1,100,105.0,-1,,1,sell,0,sell,0.4777068930880888,17,0,0,block 2 (G first),23.0,10.0,Male,1.0,0.0,0.0,"[5, 'block 2 (G first)']",0,0,0,0.5,5.0,-0.33333333333333337,0.3333333333333333,0.0,0.3333333333333333,0.0,5,0.25,1.0,Design 2,Design 2,"Have an option between Design #1 and Design #2,",5.0,5.0,5.0
385,395,5,Player object (1211),sell,2023-02-25 02:54:11.643495+00:00,"{""priceA"": 110, ""sharesA"": 0, ""secs_since_round_starts"": 191, ""market"": ""A""}",165.0,33.0,5.0,5c7udvpd,vmu7c279,FULL STUDY,170.0,s3,1,110,100.0,1,10.0,1,buy,0,sell,0.5480287979668599,17,0,1,block 2 (G first),23.0,10.0,Male,1.0,0.0,0.0,"[5, 'block 2 (G first)']",0,0,0,0.5,5.0,-0.33333333333333337,0.3333333333333333,0.0,0.3333333333333333,0.0,5,0.25,1.0,Design 2,Design 2,"Have an option between Design #1 and Design #2,",5.0,5.0,5.0
386,396,5,Player object (1211),buy,2023-02-25 02:54:34.759620+00:00,"{""priceA"": 80, ""sharesA"": 1, ""secs_since_round_starts"": 214, ""market"": ""A""}",85.0,38.0,6.0,5c7udvpd,vmu7c279,FULL STUDY,170.0,s3,1,80,110.0,-1,,1,sell,0,sell,0.4515999245786187,17,1,0,block 2 (G first),23.0,10.0,Male,1.0,0.0,0.0,"[5, 'block 2 (G first)']",0,0,0,0.5,5.0,-0.33333333333333337,0.3333333333333333,0.0,0.3333333333333333,0.0,5,0.25,1.0,Design 2,Design 2,"Have an option between Design #1 and Design #2,",5.0,5.0,5.0
387,397,5,Player object (1211),sell,2023-02-25 02:55:02.468362+00:00,"{""priceA"": 110, ""sharesA"": 0, ""secs_since_round_starts"": 241, ""market"": ""A""}",195.0,43.0,7.0,5c7udvpd,vmu7c279,FULL STUDY,170.0,s3,1,110,80.0,1,30.0,1,buy,0,sell,0.571300234525265,17,0,0,block 2 (G first),23.0,10.0,Male,1.0,0.0,0.0,"[5, 'block 2 (G first)']",0,0,0,0.5,5.0,-0.33333333333333337,0.3333333333333333,0.0,0.3333333333333333,0.0,5,0.25,1.0,Design 2,Design 2,"Have an option between Design #1 and Design #2,",5.0,5.0,5.0
388,398,5,Player object (1211),buy,2023-02-25 02:55:24.447335+00:00,"{""priceA"": 90, ""sharesA"": 1, ""secs_since_round_starts"": 263, ""market"": ""A""}",105.0,47.0,8.0,5c7udvpd,vmu7c279,FULL STUDY,170.0,s3,1,90,110.0,-1,,1,sell,0,sell,0.4627742743797309,17,0,0,block 2 (G first),23.0,10.0,Male,1.0,0.0,0.0,"[5, 'block 2 (G first)']",0,0,0,0.5,5.0,-0.33333333333333337,0.3333333333333333,0.0,0.3333333333333333,0.0,5,0.25,1.0,Design 2,Design 2,"Have an option between Design #1 and Design #2,",5.0,5.0,5.0
389,3407,2,Player object (931),sell,2023-03-09 04:08:02.319565+00:00,"{""priceA"": 85, ""sharesA"": 0, ""secs_since_round_starts"": 49, ""market"": ""A""}",135.0,8.0,1.0,5gtepg45,vmu7c279,FULL STUDY,220.0,s1,1,85,,1,,1,,0,sell,0.4422758127435268,16,1,0,block 4 (G second),21.0,11.0,Male,1.0,1.0,1.0,"[2, 'block 4 (G second)']",0,1,1,0.5,6.0,-0.31666666666666665,0.2631578947368421,0.09090909090909091,0.5,0.3333333333333333,4,1.0,0.5,Design 2,Design 2,"Have an option between Design #1 and Design #2,",,4.0,4.0
390,3408,2,Player object (931),buy,2023-03-09 04:08:06.426187+00:00,"{""priceA"": 70, ""sharesA"": 1, ""secs_since_round_starts"": 53, ""market"": ""A""}",65.0,9.0,2.0,5gtepg45,vmu7c279,FULL STUDY,220.0,s1,1,70,85.0,-1,,1,sell,0,sell,0.4254536939069079,16,0,0,block 4 (G second),21.0,11.0,Male,1.0,1.0,1.0,"[2, 'block 4 (G second)']",0,1,1,0.5,6.0,-0.31666666666666665,0.2631578947368421,0.09090909090909091,0.5,0.3333333333333333,4,1.0,0.5,Design 2,Design 2,"Have an option between Design #1 and Design #2,",,4.0,4.0
391,3409,2,Player object (931),sell,2023-03-09 04:08:38.976370+00:00,"{""priceA"": 105, ""sharesA"": 0, ""secs_since_round_starts"": 86, ""market"": ""A""}",170.0,14.0,3.0,5gtepg45,vmu7c279,FULL STUDY,220.0,s1,1,105,70.0,1,35.0,1,buy,0,sell,0.5600744319669811,16,0,1,block 4 (G second),21.0,11.0,Male,1.0,1.0,1.0,"[2, 'block 4 (G second)']",0,1,1,0.5,6.0,-0.31666666666666665,0.2631578947368421,0.09090909090909091,0.5,0.3333333333333333,4,1.0,0.5,Design 2,Design 2,"Have an option between Design #1 and Design #2,",,4.0,4.0
392,3410,2,Player object (931),buy,2023-03-09 04:09:19.913722+00:00,"{""priceA"": 140, ""sharesA"": 1, ""secs_since_round_starts"": 127, ""market"": ""A""}",30.0,22.0,4.0,5gtepg45,vmu7c279,FULL STUDY,220.0,s1,1,140,105.0,-1,,1,sell,0,sell,0.5695815034421478,16,0,0,block 4 (G second),21.0,11.0,Male,1.0,1.0,1.0,"[2, 'block 4 (G second)']",0,1,1,0.5,6.0,-0.31666666666666665,0.2631578947368421,0.09090909090909091,0.5,0.3333333333333333,4,1.0,0.5,Design 2,Design 2,"Have an option between Design #1 and Design #2,",,4.0,4.0
393,3412,2,Player object (931),sell,2023-03-09 04:09:36.716473+00:00,"{""priceA"": 145, ""sharesA"": 0, ""secs_since_round_starts"": 143, ""market"": ""A""}",175.0,25.0,5.0,5gtepg45,vmu7c279,FULL STUDY,220.0,s1,1,145,140.0,1,5.0,1,buy,0,sell,0.5294358264188312,16,0,0,block 4 (G second),21.0,11.0,Male,1.0,1.0,1.0,"[2, 'block 4 (G second)']",0,1,1,0.5,6.0,-0.31666666666666665,0.2631578947368421,0.09090909090909091,0.5,0.3333333333333333,4,1.0,0.5,Design 2,Design 2,"Have an option between Design #1 and Design #2,",,4.0,4.0
394,3413,2,Player object (931),buy,2023-03-09 04:09:46.357244+00:00,"{""priceA"": 125, ""sharesA"": 1, ""secs_since_round_starts"": 153, ""market"": ""A""}",50.0,27.0,6.0,5gtepg45,vmu7c279,FULL STUDY,220.0,s1,1,125,145.0,-1,,1,sell,0,sell,0.4549942201992644,16,1,0,block 4 (G second),21.0,11.0,Male,1.0,1.0,1.0,"[2, 'block 4 (G second)']",0,1,1,0.5,6.0,-0.31666666666666665,0.2631578947368421,0.09090909090909091,0.5,0.3333333333333333,4,1.0,0.5,Design 2,Design 2,"Have an option between Design #1 and Design #2,",,4.0,4.0
395,3418,2,Player object (931),sell,2023-03-09 04:10:53.423155+00:00,"{""priceA"": 145, ""sharesA"": 0, ""secs_since_round_starts"": 220, ""market"": ""A""}",195.0,37.0,7.0,5gtepg45,vmu7c279,FULL STUDY,220.0,s1,1,145,125.0,1,20.0,1,buy,0,sell,0.494384744736363,16,0,0,block 4 (G second),21.0,11.0,Male,1.0,1.0,1.0,"[2, 'block 4 (G second)']",0,1,1,0.5,6.0,-0.31666666666666665,0.2631578947368421,0.09090909090909091,0.5,0.3333333333333333,4,1.0,0.5,Design 2,Design 2,"Have an option between Design #1 and Design #2,",,4.0,4.0
396,3423,2,Player object (931),buy,2023-03-09 04:11:13.550824+00:00,"{""priceA"": 140, ""sharesA"": 1, ""secs_since_round_starts"": 240, ""market"": ""A""}",55.0,40.0,8.0,5gtepg45,vmu7c279,FULL STUDY,220.0,s1,1,140,145.0,-1,,1,sell,0,sell,0.4916787423410894,16,0,0,block 4 (G second),21.0,11.0,Male,1.0,1.0,1.0,"[2, 'block 4 (G second)']",0,1,1,0.5,6.0,-0.31666666666666665,0.2631578947368421,0.09090909090909091,0.5,0.3333333333333333,4,1.0,0.5,Design 2,Design 2,"Have an option between Design #1 and Design #2,",,4.0,4.0
397,3424,2,Player object (931),sell,2023-03-09 04:11:43.016005+00:00,"{""priceA"": 155, ""sharesA"": 0, ""secs_since_round_starts"": 270, ""market"": ""A""}",210.0,46.0,9.0,5gtepg45,vmu7c279,FULL STUDY,220.0,s1,1,155,140.0,1,15.0,1,buy,0,sell,0.5495494947508355,16,0,1,block 4 (G second),21.0,11.0,Male,1.0,1.0,1.0,"[2, 'block 4 (G second)']",0,1,1,0.5,6.0,-0.31666666666666665,0.2631578947368421,0.09090909090909091,0.5,0.3333333333333333,4,1.0,0.5,Design 2,Design 2,"Have an option between Design #1 and Design #2,",,4.0,4.0
398,3425,2,Player object (931),buy,2023-03-09 04:12:16.120816+00:00,"{""priceA"": 125, ""sharesA"": 1, ""secs_since_round_starts"": 303, ""market"": ""A""}",85.0,52.0,10.0,5gtepg45,vmu7c279,FULL STUDY,220.0,s1,1,125,155.0,-1,,1,sell,0,sell,0.4439176376077041,16,1,0,block 4 (G second),21.0,11.0,Male,1.0,1.0,1.0,"[2, 'block 4 (G second)']",0,1,1,0.5,6.0,-0.31666666666666665,0.2631578947368421,0.09090909090909091,0.5,0.3333333333333333,4,1.0,0.5,Design 2,Design 2,"Have an option between Design #1 and Design #2,",,4.0,4.0
399,3427,2,Player object (931),sell,2023-03-09 04:12:34.777022+00:00,"{""priceA"": 135, ""sharesA"": 0, ""secs_since_round_starts"": 322, ""market"": ""A""}",220.0,55.0,11.0,5gtepg45,vmu7c279,FULL STUDY,220.0,s1,1,135,125.0,1,10.0,1,buy,0,sell,0.4873282494519479,16,0,0,block 4 (G second),21.0,11.0,Male,1.0,1.0,1.0,"[2, 'block 4 (G second)']",0,1,1,0.5,6.0,-0.31666666666666665,0.2631578947368421,0.09090909090909091,0.5,0.3333333333333333,4,1.0,0.5,Design 2,Design 2,"Have an option between Design #1 and Design #2,",,4.0,4.0
400,3428,2,Player object (931),buy,2023-03-09 04:12:38.173496+00:00,"{""priceA"": 125, ""sharesA"": 1, ""secs_since_round_starts"": 325, ""market"": ""A""}",95.0,56.0,12.0,5gtepg45,vmu7c279,FULL STUDY,220.0,s1,1,125,135.0,-1,,1,sell,0,sell,0.4562406760637778,16,0,0,block 4 (G second),21.0,11.0,Male,1.0,1.0,1.0,"[2, 'block 4 (G second)']",0,1,1,0.5,6.0,-0.31666666666666665,0.2631578947368421,0.09090909090909091,0.5,0.3333333333333333,4,1.0,0.5,Design 2,Design 2,"Have an option between Design #1 and Design #2,",,4.0,4.0
401,3433,3,Player object (1051),sell,2023-03-09 04:13:48.373759+00:00,"{""priceA"": 110, ""sharesA"": 0, ""secs_since_round_starts"": 40, ""market"": ""A""}",160.0,9.0,1.0,5gtepg45,vmu7c279,FULL STUDY,205.0,s1,1,110,,1,,1,,0,sell,0.5389563723055646,19,0,0,block 4 (G second),21.0,11.0,Male,1.0,1.0,1.0,"[3, 'block 4 (G second)']",0,0,1,1.0,6.0,-0.31666666666666665,0.4,0.058823529411764705,,0.0,4,1.0,0.5,Design 2,Design 2,"Have an option between Design #1 and Design #2,",,4.0,4.0
402,3435,3,Player object (1051),buy,2023-03-09 04:14:11.708799+00:00,"{""priceA"": 130, ""sharesA"": 1, ""secs_since_round_starts"": 64, ""market"": ""A""}",30.0,13.0,2.0,5gtepg45,vmu7c279,FULL STUDY,205.0,s1,1,130,110.0,-1,,1,sell,0,sell,0.5729625045047859,19,0,1,block 4 (G second),21.0,11.0,Male,1.0,1.0,1.0,"[3, 'block 4 (G second)']",0,0,1,1.0,6.0,-0.31666666666666665,0.4,0.058823529411764705,,0.0,4,1.0,0.5,Design 2,Design 2,"Have an option between Design #1 and Design #2,",,4.0,4.0
403,3437,3,Player object (1051),sell,2023-03-09 04:15:17.485579+00:00,"{""priceA"": 110, ""sharesA"": 0, ""secs_since_round_starts"": 129, ""market"": ""A""}",140.0,25.0,3.0,5gtepg45,vmu7c279,FULL STUDY,205.0,s1,1,110,130.0,1,-20.0,1,buy,0,sell,0.4872943409941583,19,0,0,block 4 (G second),21.0,11.0,Male,1.0,1.0,1.0,"[3, 'block 4 (G second)']",0,0,1,1.0,6.0,-0.31666666666666665,0.4,0.058823529411764705,,0.0,4,1.0,0.5,Design 2,Design 2,"Have an option between Design #1 and Design #2,",,4.0,4.0
404,3443,3,Player object (1051),buy,2023-03-09 04:16:01.130302+00:00,"{""priceA"": 100, ""sharesA"": 1, ""secs_since_round_starts"": 172, ""market"": ""A""}",40.0,33.0,4.0,5gtepg45,vmu7c279,FULL STUDY,205.0,s1,1,100,110.0,-1,,1,sell,0,sell,0.4476889957041811,19,1,0,block 4 (G second),21.0,11.0,Male,1.0,1.0,1.0,"[3, 'block 4 (G second)']",0,0,1,1.0,6.0,-0.31666666666666665,0.4,0.058823529411764705,,0.0,4,1.0,0.5,Design 2,Design 2,"Have an option between Design #1 and Design #2,",,4.0,4.0
405,3444,3,Player object (1051),sell,2023-03-09 04:16:21.457313+00:00,"{""priceA"": 100, ""sharesA"": 0, ""secs_since_round_starts"": 193, ""market"": ""A""}",140.0,36.0,5.0,5gtepg45,vmu7c279,FULL STUDY,205.0,s1,1,100,100.0,1,0.0,1,buy,0,sell,0.440139794868048,19,0,0,block 4 (G second),21.0,11.0,Male,1.0,1.0,1.0,"[3, 'block 4 (G second)']",0,0,1,1.0,6.0,-0.31666666666666665,0.4,0.058823529411764705,,0.0,4,1.0,0.5,Design 2,Design 2,"Have an option between Design #1 and Design #2,",,4.0,4.0
406,3445,3,Player object (1051),buy,2023-03-09 04:16:25.529182+00:00,"{""priceA"": 95, ""sharesA"": 1, ""secs_since_round_starts"": 197, ""market"": ""A""}",45.0,37.0,6.0,5gtepg45,vmu7c279,FULL STUDY,205.0,s1,1,95,100.0,-1,,1,sell,0,sell,0.4240076400585448,19,1,0,block 4 (G second),21.0,11.0,Male,1.0,1.0,1.0,"[3, 'block 4 (G second)']",0,0,1,1.0,6.0,-0.31666666666666665,0.4,0.058823529411764705,,0.0,4,1.0,0.5,Design 2,Design 2,"Have an option between Design #1 and Design #2,",,4.0,4.0
407,3448,3,Player object (1051),sell,2023-03-09 04:16:36.722587+00:00,"{""priceA"": 115, ""sharesA"": 0, ""secs_since_round_starts"": 208, ""market"": ""A""}",160.0,39.0,7.0,5gtepg45,vmu7c279,FULL STUDY,205.0,s1,1,115,95.0,1,20.0,1,buy,0,sell,0.5221490272476892,19,0,0,block 4 (G second),21.0,11.0,Male,1.0,1.0,1.0,"[3, 'block 4 (G second)']",0,0,1,1.0,6.0,-0.31666666666666665,0.4,0.058823529411764705,,0.0,4,1.0,0.5,Design 2,Design 2,"Have an option between Design #1 and Design #2,",,4.0,4.0
408,3449,3,Player object (1051),buy,2023-03-09 04:16:40.795762+00:00,"{""priceA"": 100, ""sharesA"": 1, ""secs_since_round_starts"": 212, ""market"": ""A""}",60.0,40.0,8.0,5gtepg45,vmu7c279,FULL STUDY,205.0,s1,1,100,115.0,-1,,1,sell,0,sell,0.4804175727303482,19,0,0,block 4 (G second),21.0,11.0,Male,1.0,1.0,1.0,"[3, 'block 4 (G second)']",0,0,1,1.0,6.0,-0.31666666666666665,0.4,0.058823529411764705,,0.0,4,1.0,0.5,Design 2,Design 2,"Have an option between Design #1 and Design #2,",,4.0,4.0
409,3450,3,Player object (1051),sell,2023-03-09 04:16:56.707347+00:00,"{""priceA"": 120, ""sharesA"": 0, ""secs_since_round_starts"": 228, ""market"": ""A""}",180.0,43.0,9.0,5gtepg45,vmu7c279,FULL STUDY,205.0,s1,1,120,100.0,1,20.0,1,buy,0,sell,0.5357259670782416,19,0,0,block 4 (G second),21.0,11.0,Male,1.0,1.0,1.0,"[3, 'block 4 (G second)']",0,0,1,1.0,6.0,-0.31666666666666665,0.4,0.058823529411764705,,0.0,4,1.0,0.5,Design 2,Design 2,"Have an option between Design #1 and Design #2,",,4.0,4.0
410,3451,3,Player object (1051),buy,2023-03-09 04:17:40.726982+00:00,"{""priceA"": 120, ""sharesA"": 1, ""secs_since_round_starts"": 271, ""market"": ""A""}",60.0,51.0,10.0,5gtepg45,vmu7c279,FULL STUDY,205.0,s1,1,120,120.0,-1,,1,sell,0,sell,0.4588602748157505,19,0,0,block 4 (G second),21.0,11.0,Male,1.0,1.0,1.0,"[3, 'block 4 (G second)']",0,0,1,1.0,6.0,-0.31666666666666665,0.4,0.058823529411764705,,0.0,4,1.0,0.5,Design 2,Design 2,"Have an option between Design #1 and Design #2,",,4.0,4.0
411,3452,3,Player object (1051),sell,2023-03-09 04:17:57.294423+00:00,"{""priceA"": 145, ""sharesA"": 0, ""secs_since_round_starts"": 288, ""market"": ""A""}",205.0,54.0,11.0,5gtepg45,vmu7c279,FULL STUDY,205.0,s1,1,145,120.0,1,25.0,1,buy,0,sell,0.52846438705912,19,0,0,block 4 (G second),21.0,11.0,Male,1.0,1.0,1.0,"[3, 'block 4 (G second)']",0,0,1,1.0,6.0,-0.31666666666666665,0.4,0.058823529411764705,,0.0,4,1.0,0.5,Design 2,Design 2,"Have an option between Design #1 and Design #2,",,4.0,4.0
412,3453,3,Player object (1051),buy,2023-03-09 04:18:19.195731+00:00,"{""priceA"": 115, ""sharesA"": 1, ""secs_since_round_starts"": 310, ""market"": ""A""}",90.0,58.0,12.0,5gtepg45,vmu7c279,FULL STUDY,205.0,s1,1,115,145.0,-1,,1,sell,0,sell,0.442461876115205,19,1,0,block 4 (G second),21.0,11.0,Male,1.0,1.0,1.0,"[3, 'block 4 (G second)']",0,0,1,1.0,6.0,-0.31666666666666665,0.4,0.058823529411764705,,0.0,4,1.0,0.5,Design 2,Design 2,"Have an option between Design #1 and Design #2,",,4.0,4.0
413,3459,4,Player object (1171),sell,2023-03-09 04:19:33.846280+00:00,"{""priceA"": 90, ""sharesA"": 0, ""secs_since_round_starts"": 56, ""market"": ""A""}",140.0,12.0,2.0,5gtepg45,vmu7c279,FULL STUDY,170.0,s1,1,90,40.0,1,50.0,1,,0,sell,0.5210961257750505,14,0,0,block 4 (G second),21.0,11.0,Male,1.0,1.0,1.0,"[4, 'block 4 (G second)']",1,1,1,0.5,6.0,-0.31666666666666665,0.2857142857142857,0.041666666666666664,0.0,0.0,4,0.5,0.5,Design 2,Design 2,"Have an option between Design #1 and Design #2,",,4.0,4.0
414,3461,4,Player object (1171),buy,2023-03-09 04:20:09.252335+00:00,"{""priceA"": 70, ""sharesA"": 1, ""secs_since_round_starts"": 92, ""market"": ""A""}",70.0,18.0,3.0,5gtepg45,vmu7c279,FULL STUDY,170.0,s1,1,70,90.0,-1,,1,sell,0,sell,0.4407118028401492,14,1,0,block 4 (G second),21.0,11.0,Male,1.0,1.0,1.0,"[4, 'block 4 (G second)']",1,1,1,0.5,6.0,-0.31666666666666665,0.2857142857142857,0.041666666666666664,0.0,0.0,4,0.5,0.5,Design 2,Design 2,"Have an option between Design #1 and Design #2,",,4.0,4.0
415,3462,4,Player object (1171),sell,2023-03-09 04:21:08.028002+00:00,"{""priceA"": 90, ""sharesA"": 0, ""secs_since_round_starts"": 150, ""market"": ""A""}",160.0,29.0,4.0,5gtepg45,vmu7c279,FULL STUDY,170.0,s1,1,90,70.0,1,20.0,1,buy,0,sell,0.5712793841154561,14,0,0,block 4 (G second),21.0,11.0,Male,1.0,1.0,1.0,"[4, 'block 4 (G second)']",1,1,1,0.5,6.0,-0.31666666666666665,0.2857142857142857,0.041666666666666664,0.0,0.0,4,0.5,0.5,Design 2,Design 2,"Have an option between Design #1 and Design #2,",,4.0,4.0
416,3464,4,Player object (1171),buy,2023-03-09 04:21:54.847164+00:00,"{""priceA"": 70, ""sharesA"": 1, ""secs_since_round_starts"": 197, ""market"": ""A""}",90.0,37.0,5.0,5gtepg45,vmu7c279,FULL STUDY,170.0,s1,1,70,90.0,-1,,1,sell,0,sell,0.4570673777008929,14,0,0,block 4 (G second),21.0,11.0,Male,1.0,1.0,1.0,"[4, 'block 4 (G second)']",1,1,1,0.5,6.0,-0.31666666666666665,0.2857142857142857,0.041666666666666664,0.0,0.0,4,0.5,0.5,Design 2,Design 2,"Have an option between Design #1 and Design #2,",,4.0,4.0
417,3468,4,Player object (1171),sell,2023-03-09 04:22:26.054864+00:00,"{""priceA"": 95, ""sharesA"": 0, ""secs_since_round_starts"": 228, ""market"": ""A""}",185.0,42.0,6.0,5gtepg45,vmu7c279,FULL STUDY,170.0,s1,1,95,70.0,1,25.0,1,buy,0,sell,0.5388552795609507,14,0,0,block 4 (G second),21.0,11.0,Male,1.0,1.0,1.0,"[4, 'block 4 (G second)']",1,1,1,0.5,6.0,-0.31666666666666665,0.2857142857142857,0.041666666666666664,0.0,0.0,4,0.5,0.5,Design 2,Design 2,"Have an option between Design #1 and Design #2,",,4.0,4.0
418,3471,4,Player object (1171),buy,2023-03-09 04:23:18.522270+00:00,"{""priceA"": 90, ""sharesA"": 1, ""secs_since_round_starts"": 281, ""market"": ""A""}",95.0,52.0,7.0,5gtepg45,vmu7c279,FULL STUDY,170.0,s1,1,90,95.0,-1,,1,sell,0,sell,0.4694909620846048,14,0,0,block 4 (G second),21.0,11.0,Male,1.0,1.0,1.0,"[4, 'block 4 (G second)']",1,1,1,0.5,6.0,-0.31666666666666665,0.2857142857142857,0.041666666666666664,0.0,0.0,4,0.5,0.5,Design 2,Design 2,"Have an option between Design #1 and Design #2,",,4.0,4.0
419,3475,5,Player object (1291),sell,2023-03-09 04:24:31.253274+00:00,"{""priceA"": 95, ""sharesA"": 0, ""secs_since_round_starts"": 22, ""market"": ""A""}",145.0,6.0,1.0,5gtepg45,vmu7c279,FULL STUDY,240.0,s1,1,95,,1,,1,,0,sell,0.5560314405213382,17,0,1,block 4 (G second),21.0,11.0,Male,1.0,1.0,1.0,"[5, 'block 4 (G second)']",1,0,1,1.0,6.0,-0.31666666666666665,0.38461538461538464,0.21428571428571427,0.6666666666666666,0.3333333333333333,4,0.5,0.25,Design 2,Design 2,"Have an option between Design #1 and Design #2,",,4.0,4.0
420,3476,5,Player object (1291),buy,2023-03-09 04:24:48.031068+00:00,"{""priceA"": 80, ""sharesA"": 1, ""secs_since_round_starts"": 39, ""market"": ""A""}",65.0,9.0,2.0,5gtepg45,vmu7c279,FULL STUDY,240.0,s1,1,80,95.0,-1,,1,sell,0,sell,0.4765586288879626,17,0,0,block 4 (G second),21.0,11.0,Male,1.0,1.0,1.0,"[5, 'block 4 (G second)']",1,0,1,1.0,6.0,-0.31666666666666665,0.38461538461538464,0.21428571428571427,0.6666666666666666,0.3333333333333333,4,0.5,0.25,Design 2,Design 2,"Have an option between Design #1 and Design #2,",,4.0,4.0
421,3477,5,Player object (1291),sell,2023-03-09 04:25:05.769564+00:00,"{""priceA"": 100, ""sharesA"": 0, ""secs_since_round_starts"": 57, ""market"": ""A""}",165.0,12.0,3.0,5gtepg45,vmu7c279,FULL STUDY,240.0,s1,1,100,80.0,1,20.0,1,buy,0,sell,0.5344269279803172,17,0,0,block 4 (G second),21.0,11.0,Male,1.0,1.0,1.0,"[5, 'block 4 (G second)']",1,0,1,1.0,6.0,-0.31666666666666665,0.38461538461538464,0.21428571428571427,0.6666666666666666,0.3333333333333333,4,0.5,0.25,Design 2,Design 2,"Have an option between Design #1 and Design #2,",,4.0,4.0
422,3478,5,Player object (1291),buy,2023-03-09 04:25:14.509482+00:00,"{""priceA"": 80, ""sharesA"": 1, ""secs_since_round_starts"": 66, ""market"": ""A""}",85.0,14.0,4.0,5gtepg45,vmu7c279,FULL STUDY,240.0,s1,1,80,100.0,-1,,1,sell,0,sell,0.457409789643144,17,0,0,block 4 (G second),21.0,11.0,Male,1.0,1.0,1.0,"[5, 'block 4 (G second)']",1,0,1,1.0,6.0,-0.31666666666666665,0.38461538461538464,0.21428571428571427,0.6666666666666666,0.3333333333333333,4,0.5,0.25,Design 2,Design 2,"Have an option between Design #1 and Design #2,",,4.0,4.0
423,3481,5,Player object (1291),sell,2023-03-09 04:25:29.165377+00:00,"{""priceA"": 85, ""sharesA"": 0, ""secs_since_round_starts"": 80, ""market"": ""A""}",170.0,16.0,5.0,5gtepg45,vmu7c279,FULL STUDY,240.0,s1,1,85,80.0,1,5.0,1,buy,0,sell,0.4686291671454359,17,0,0,block 4 (G second),21.0,11.0,Male,1.0,1.0,1.0,"[5, 'block 4 (G second)']",1,0,1,1.0,6.0,-0.31666666666666665,0.38461538461538464,0.21428571428571427,0.6666666666666666,0.3333333333333333,4,0.5,0.25,Design 2,Design 2,"Have an option between Design #1 and Design #2,",,4.0,4.0
424,3482,5,Player object (1291),buy,2023-03-09 04:25:37.315714+00:00,"{""priceA"": 70, ""sharesA"": 1, ""secs_since_round_starts"": 88, ""market"": ""A""}",100.0,18.0,6.0,5gtepg45,vmu7c279,FULL STUDY,240.0,s1,1,70,85.0,-1,,1,sell,0,sell,0.42621223683237,17,1,0,block 4 (G second),21.0,11.0,Male,1.0,1.0,1.0,"[5, 'block 4 (G second)']",1,0,1,1.0,6.0,-0.31666666666666665,0.38461538461538464,0.21428571428571427,0.6666666666666666,0.3333333333333333,4,0.5,0.25,Design 2,Design 2,"Have an option between Design #1 and Design #2,",,4.0,4.0
425,3483,5,Player object (1291),sell,2023-03-09 04:25:53.742458+00:00,"{""priceA"": 105, ""sharesA"": 0, ""secs_since_round_starts"": 105, ""market"": ""A""}",205.0,21.0,7.0,5gtepg45,vmu7c279,FULL STUDY,240.0,s1,1,105,70.0,1,35.0,1,buy,0,sell,0.5510362930796925,17,0,1,block 4 (G second),21.0,11.0,Male,1.0,1.0,1.0,"[5, 'block 4 (G second)']",1,0,1,1.0,6.0,-0.31666666666666665,0.38461538461538464,0.21428571428571427,0.6666666666666666,0.3333333333333333,4,0.5,0.25,Design 2,Design 2,"Have an option between Design #1 and Design #2,",,4.0,4.0
426,3484,5,Player object (1291),buy,2023-03-09 04:26:33.596492+00:00,"{""priceA"": 85, ""sharesA"": 1, ""secs_since_round_starts"": 145, ""market"": ""A""}",120.0,28.0,8.0,5gtepg45,vmu7c279,FULL STUDY,240.0,s1,1,85,105.0,-1,,1,sell,0,sell,0.4496194529460131,17,1,0,block 4 (G second),21.0,11.0,Male,1.0,1.0,1.0,"[5, 'block 4 (G second)']",1,0,1,1.0,6.0,-0.31666666666666665,0.38461538461538464,0.21428571428571427,0.6666666666666666,0.3333333333333333,4,0.5,0.25,Design 2,Design 2,"Have an option between Design #1 and Design #2,",,4.0,4.0
427,3486,5,Player object (1291),sell,2023-03-09 04:27:05.494863+00:00,"{""priceA"": 120, ""sharesA"": 0, ""secs_since_round_starts"": 177, ""market"": ""A""}",240.0,34.0,9.0,5gtepg45,vmu7c279,FULL STUDY,240.0,s1,1,120,85.0,1,35.0,1,buy,0,sell,0.5679672812132522,17,0,0,block 4 (G second),21.0,11.0,Male,1.0,1.0,1.0,"[5, 'block 4 (G second)']",1,0,1,1.0,6.0,-0.31666666666666665,0.38461538461538464,0.21428571428571427,0.6666666666666666,0.3333333333333333,4,0.5,0.25,Design 2,Design 2,"Have an option between Design #1 and Design #2,",,4.0,4.0
428,3487,5,Player object (1291),buy,2023-03-09 04:27:26.849683+00:00,"{""priceA"": 80, ""sharesA"": 1, ""secs_since_round_starts"": 198, ""market"": ""A""}",160.0,38.0,10.0,5gtepg45,vmu7c279,FULL STUDY,240.0,s1,1,80,120.0,-1,,1,sell,0,sell,0.4515999245786187,17,1,0,block 4 (G second),21.0,11.0,Male,1.0,1.0,1.0,"[5, 'block 4 (G second)']",1,0,1,1.0,6.0,-0.31666666666666665,0.38461538461538464,0.21428571428571427,0.6666666666666666,0.3333333333333333,4,0.5,0.25,Design 2,Design 2,"Have an option between Design #1 and Design #2,",,4.0,4.0
429,3491,5,Player object (1291),sell,2023-03-09 04:27:52.367976+00:00,"{""priceA"": 100, ""sharesA"": 0, ""secs_since_round_starts"": 224, ""market"": ""A""}",260.0,42.0,11.0,5gtepg45,vmu7c279,FULL STUDY,240.0,s1,1,100,80.0,1,20.0,1,buy,0,sell,0.5529358605422235,17,0,1,block 4 (G second),21.0,11.0,Male,1.0,1.0,1.0,"[5, 'block 4 (G second)']",1,0,1,1.0,6.0,-0.31666666666666665,0.38461538461538464,0.21428571428571427,0.6666666666666666,0.3333333333333333,4,0.5,0.25,Design 2,Design 2,"Have an option between Design #1 and Design #2,",,4.0,4.0
430,3494,5,Player object (1291),buy,2023-03-09 04:28:20.275701+00:00,"{""priceA"": 90, ""sharesA"": 1, ""secs_since_round_starts"": 251, ""market"": ""A""}",170.0,47.0,12.0,5gtepg45,vmu7c279,FULL STUDY,240.0,s1,1,90,100.0,-1,,1,sell,0,sell,0.4627742743797309,17,0,0,block 4 (G second),21.0,11.0,Male,1.0,1.0,1.0,"[5, 'block 4 (G second)']",1,0,1,1.0,6.0,-0.31666666666666665,0.38461538461538464,0.21428571428571427,0.6666666666666666,0.3333333333333333,4,0.5,0.25,Design 2,Design 2,"Have an option between Design #1 and Design #2,",,4.0,4.0
431,3500,5,Player object (1291),sell,2023-03-09 04:28:53.396279+00:00,"{""priceA"": 85, ""sharesA"": 0, ""secs_since_round_starts"": 285, ""market"": ""A""}",255.0,53.0,13.0,5gtepg45,vmu7c279,FULL STUDY,240.0,s1,1,85,90.0,1,-5.0,1,buy,0,sell,0.4927925471404216,17,0,0,block 4 (G second),21.0,11.0,Male,1.0,1.0,1.0,"[5, 'block 4 (G second)']",1,0,1,1.0,6.0,-0.31666666666666665,0.38461538461538464,0.21428571428571427,0.6666666666666666,0.3333333333333333,4,0.5,0.25,Design 2,Design 2,"Have an option between Design #1 and Design #2,",,4.0,4.0
432,3501,5,Player object (1291),buy,2023-03-09 04:28:59.007104+00:00,"{""priceA"": 95, ""sharesA"": 1, ""secs_since_round_starts"": 290, ""market"": ""A""}",160.0,54.0,14.0,5gtepg45,vmu7c279,FULL STUDY,240.0,s1,1,95,85.0,-1,,1,sell,0,sell,0.5299980248683189,17,0,0,block 4 (G second),21.0,11.0,Male,1.0,1.0,1.0,"[5, 'block 4 (G second)']",1,0,1,1.0,6.0,-0.31666666666666665,0.38461538461538464,0.21428571428571427,0.6666666666666666,0.3333333333333333,4,0.5,0.25,Design 2,Design 2,"Have an option between Design #1 and Design #2,",,4.0,4.0
433,3503,5,Player object (1291),sell,2023-03-09 04:29:14.647362+00:00,"{""priceA"": 85, ""sharesA"": 0, ""secs_since_round_starts"": 306, ""market"": ""A""}",245.0,57.0,15.0,5gtepg45,vmu7c279,FULL STUDY,240.0,s1,1,85,95.0,1,-10.0,1,buy,0,sell,0.4825596920859898,17,0,0,block 4 (G second),21.0,11.0,Male,1.0,1.0,1.0,"[5, 'block 4 (G second)']",1,0,1,1.0,6.0,-0.31666666666666665,0.38461538461538464,0.21428571428571427,0.6666666666666666,0.3333333333333333,4,0.5,0.25,Design 2,Design 2,"Have an option between Design #1 and Design #2,",,4.0,4.0
434,3506,5,Player object (1291),buy,2023-03-09 04:29:29.788608+00:00,"{""priceA"": 70, ""sharesA"": 1, ""secs_since_round_starts"": 321, ""market"": ""A""}",175.0,59.0,16.0,5gtepg45,vmu7c279,FULL STUDY,240.0,s1,1,70,85.0,-1,,1,sell,0,sell,0.4327023062729965,17,1,0,block 4 (G second),21.0,11.0,Male,1.0,1.0,1.0,"[5, 'block 4 (G second)']",1,0,1,1.0,6.0,-0.31666666666666665,0.38461538461538464,0.21428571428571427,0.6666666666666666,0.3333333333333333,4,0.5,0.25,Design 2,Design 2,"Have an option between Design #1 and Design #2,",,4.0,4.0
435,4470,2,Player object (949),sell,2023-03-09 23:19:08.327659+00:00,"{""priceA"": 90, ""sharesA"": 0, ""secs_since_round_starts"": 77, ""market"": ""A""}",140.0,13.0,1.0,5kbeb2zm,vmu7c279,FULL STUDY,170.0,s1,1,90,,1,,1,,0,sell,0.5364461838942041,16,0,0,block 3 (G second),22.0,12.0,Female,1.0,0.0,0.0,"[2, 'block 3 (G second)']",0,0,1,0.5,6.0,-0.4,0.05555555555555555,0.09090909090909091,0.5,0.0,3,0.75,0.25,Design 1,Design 1,"Have an option between Design #1 and Design #2,",,4.0,1.0
436,4471,2,Player object (949),buy,2023-03-09 23:20:24.356216+00:00,"{""priceA"": 125, ""sharesA"": 1, ""secs_since_round_starts"": 153, ""market"": ""A""}",15.0,27.0,2.0,5kbeb2zm,vmu7c279,FULL STUDY,170.0,s1,1,125,90.0,-1,,1,sell,0,sell,0.4549942201992644,16,1,0,block 3 (G second),22.0,12.0,Female,1.0,0.0,0.0,"[2, 'block 3 (G second)']",0,0,1,0.5,6.0,-0.4,0.05555555555555555,0.09090909090909091,0.5,0.0,3,0.75,0.25,Design 1,Design 1,"Have an option between Design #1 and Design #2,",,4.0,1.0
437,4473,2,Player object (949),sell,2023-03-09 23:22:16.727809+00:00,"{""priceA"": 155, ""sharesA"": 0, ""secs_since_round_starts"": 265, ""market"": ""A""}",170.0,46.0,3.0,5kbeb2zm,vmu7c279,FULL STUDY,170.0,s1,1,155,125.0,1,30.0,1,buy,0,sell,0.5495494947508355,16,0,1,block 3 (G second),22.0,12.0,Female,1.0,0.0,0.0,"[2, 'block 3 (G second)']",0,0,1,0.5,6.0,-0.4,0.05555555555555555,0.09090909090909091,0.5,0.0,3,0.75,0.25,Design 1,Design 1,"Have an option between Design #1 and Design #2,",,4.0,1.0
438,4474,2,Player object (949),buy,2023-03-09 23:22:50.772806+00:00,"{""priceA"": 125, ""sharesA"": 1, ""secs_since_round_starts"": 299, ""market"": ""A""}",45.0,52.0,4.0,5kbeb2zm,vmu7c279,FULL STUDY,170.0,s1,1,125,155.0,-1,,1,sell,0,sell,0.4439176376077041,16,1,0,block 3 (G second),22.0,12.0,Female,1.0,0.0,0.0,"[2, 'block 3 (G second)']",0,0,1,0.5,6.0,-0.4,0.05555555555555555,0.09090909090909091,0.5,0.0,3,0.75,0.25,Design 1,Design 1,"Have an option between Design #1 and Design #2,",,4.0,1.0
439,4478,3,Player object (1069),sell,2023-03-09 23:26:23.736551+00:00,"{""priceA"": 120, ""sharesA"": 0, ""secs_since_round_starts"": 162, ""market"": ""A""}",170.0,30.0,1.0,5kbeb2zm,vmu7c279,FULL STUDY,190.0,s1,1,120,,1,,1,,0,sell,0.570054331362491,19,0,1,block 3 (G second),22.0,12.0,Female,1.0,0.0,0.0,"[3, 'block 3 (G second)']",0,1,1,0.5,6.0,-0.4,0.1,0.0,0.3333333333333333,0.0,2,0.5,0.25,Design 1,Design 1,"Have an option between Design #1 and Design #2,",,4.0,1.0
440,4480,3,Player object (1069),buy,2023-03-09 23:26:54.961599+00:00,"{""priceA"": 100, ""sharesA"": 1, ""secs_since_round_starts"": 193, ""market"": ""A""}",70.0,36.0,2.0,5kbeb2zm,vmu7c279,FULL STUDY,190.0,s1,1,100,120.0,-1,,1,sell,0,sell,0.440139794868048,19,0,0,block 3 (G second),22.0,12.0,Female,1.0,0.0,0.0,"[3, 'block 3 (G second)']",0,1,1,0.5,6.0,-0.4,0.1,0.0,0.3333333333333333,0.0,2,0.5,0.25,Design 1,Design 1,"Have an option between Design #1 and Design #2,",,4.0,1.0
441,4481,3,Player object (1069),sell,2023-03-09 23:27:34.008453+00:00,"{""priceA"": 120, ""sharesA"": 0, ""secs_since_round_starts"": 232, ""market"": ""A""}",190.0,43.0,3.0,5kbeb2zm,vmu7c279,FULL STUDY,190.0,s1,1,120,100.0,1,20.0,1,buy,0,sell,0.5357259670782416,19,0,0,block 3 (G second),22.0,12.0,Female,1.0,0.0,0.0,"[3, 'block 3 (G second)']",0,1,1,0.5,6.0,-0.4,0.1,0.0,0.3333333333333333,0.0,2,0.5,0.25,Design 1,Design 1,"Have an option between Design #1 and Design #2,",,4.0,1.0
442,4482,3,Player object (1069),buy,2023-03-09 23:29:07.587917+00:00,"{""priceA"": 115, ""sharesA"": 1, ""secs_since_round_starts"": 326, ""market"": ""A""}",75.0,60.0,4.0,5kbeb2zm,vmu7c279,FULL STUDY,190.0,s1,1,115,120.0,-1,,1,sell,0,sell,0.4613046310449969,19,0,0,block 3 (G second),22.0,12.0,Female,1.0,0.0,0.0,"[3, 'block 3 (G second)']",0,1,1,0.5,6.0,-0.4,0.1,0.0,0.3333333333333333,0.0,2,0.5,0.25,Design 1,Design 1,"Have an option between Design #1 and Design #2,",,4.0,1.0
443,4487,4,Player object (1189),sell,2023-03-09 23:32:18.690821+00:00,"{""priceA"": 95, ""sharesA"": 0, ""secs_since_round_starts"": 184, ""market"": ""A""}",145.0,34.0,1.0,5kbeb2zm,vmu7c279,FULL STUDY,180.0,s1,1,95,,1,,1,,0,sell,0.4981543075921684,14,0,0,block 3 (G second),22.0,12.0,Female,1.0,0.0,0.0,"[4, 'block 3 (G second)']",1,0,1,0.5,6.0,-0.4,0.16666666666666666,0.029411764705882353,1.0,0.0,4,0.5,0.25,Design 1,Design 1,"Have an option between Design #1 and Design #2,",,4.0,1.0
444,4488,4,Player object (1189),buy,2023-03-09 23:32:39.222876+00:00,"{""priceA"": 65, ""sharesA"": 1, ""secs_since_round_starts"": 204, ""market"": ""A""}",80.0,38.0,2.0,5kbeb2zm,vmu7c279,FULL STUDY,180.0,s1,1,65,95.0,-1,,1,sell,0,sell,0.4355009867455686,14,1,0,block 3 (G second),22.0,12.0,Female,1.0,0.0,0.0,"[4, 'block 3 (G second)']",1,0,1,0.5,6.0,-0.4,0.16666666666666666,0.029411764705882353,1.0,0.0,4,0.5,0.25,Design 1,Design 1,"Have an option between Design #1 and Design #2,",,4.0,1.0
445,4489,4,Player object (1189),sell,2023-03-09 23:33:06.108105+00:00,"{""priceA"": 100, ""sharesA"": 0, ""secs_since_round_starts"": 231, ""market"": ""A""}",180.0,43.0,3.0,5kbeb2zm,vmu7c279,FULL STUDY,180.0,s1,1,100,65.0,1,35.0,1,buy,0,sell,0.5617190733230237,14,0,1,block 3 (G second),22.0,12.0,Female,1.0,0.0,0.0,"[4, 'block 3 (G second)']",1,0,1,0.5,6.0,-0.4,0.16666666666666666,0.029411764705882353,1.0,0.0,4,0.5,0.25,Design 1,Design 1,"Have an option between Design #1 and Design #2,",,4.0,1.0
446,4490,4,Player object (1189),buy,2023-03-09 23:34:01.464402+00:00,"{""priceA"": 75, ""sharesA"": 1, ""secs_since_round_starts"": 287, ""market"": ""A""}",105.0,53.0,4.0,5kbeb2zm,vmu7c279,FULL STUDY,180.0,s1,1,75,100.0,-1,,1,sell,0,sell,0.4439854633835125,14,1,0,block 3 (G second),22.0,12.0,Female,1.0,0.0,0.0,"[4, 'block 3 (G second)']",1,0,1,0.5,6.0,-0.4,0.16666666666666666,0.029411764705882353,1.0,0.0,4,0.5,0.25,Design 1,Design 1,"Have an option between Design #1 and Design #2,",,4.0,1.0
447,4494,5,Player object (1309),sell,2023-03-09 23:37:14.059383+00:00,"{""priceA"": 105, ""sharesA"": 0, ""secs_since_round_starts"": 111, ""market"": ""A""}",155.0,21.0,1.0,5kbeb2zm,vmu7c279,FULL STUDY,200.0,s1,1,105,,1,,1,,0,sell,0.5510362930796925,17,0,1,block 3 (G second),22.0,12.0,Female,1.0,0.0,0.0,"[5, 'block 3 (G second)']",1,1,1,0.5,6.0,-0.4,0.08695652173913043,0.0,0.25,0.0,4,0.5,0.25,Design 1,Design 1,"Have an option between Design #1 and Design #2,",,4.0,1.0
448,4495,5,Player object (1309),buy,2023-03-09 23:38:03.018962+00:00,"{""priceA"": 70, ""sharesA"": 1, ""secs_since_round_starts"": 160, ""market"": ""A""}",85.0,30.0,2.0,5kbeb2zm,vmu7c279,FULL STUDY,200.0,s1,1,70,105.0,-1,,1,sell,0,sell,0.4174526841611717,17,0,0,block 3 (G second),22.0,12.0,Female,1.0,0.0,0.0,"[5, 'block 3 (G second)']",1,1,1,0.5,6.0,-0.4,0.08695652173913043,0.0,0.25,0.0,4,0.5,0.25,Design 1,Design 1,"Have an option between Design #1 and Design #2,",,4.0,1.0
449,4497,5,Player object (1309),sell,2023-03-09 23:38:26.252896+00:00,"{""priceA"": 120, ""sharesA"": 0, ""secs_since_round_starts"": 183, ""market"": ""A""}",205.0,34.0,3.0,5kbeb2zm,vmu7c279,FULL STUDY,200.0,s1,1,120,70.0,1,50.0,1,buy,0,sell,0.5679672812132522,17,0,0,block 3 (G second),22.0,12.0,Female,1.0,0.0,0.0,"[5, 'block 3 (G second)']",1,1,1,0.5,6.0,-0.4,0.08695652173913043,0.0,0.25,0.0,4,0.5,0.25,Design 1,Design 1,"Have an option between Design #1 and Design #2,",,4.0,1.0
450,4498,5,Player object (1309),buy,2023-03-09 23:38:52.549847+00:00,"{""priceA"": 70, ""sharesA"": 1, ""secs_since_round_starts"": 209, ""market"": ""A""}",135.0,39.0,4.0,5kbeb2zm,vmu7c279,FULL STUDY,200.0,s1,1,70,120.0,-1,,1,sell,0,sell,0.4317803147869401,17,0,0,block 3 (G second),22.0,12.0,Female,1.0,0.0,0.0,"[5, 'block 3 (G second)']",1,1,1,0.5,6.0,-0.4,0.08695652173913043,0.0,0.25,0.0,4,0.5,0.25,Design 1,Design 1,"Have an option between Design #1 and Design #2,",,4.0,1.0
451,4993,2,Player object (956),sell,2023-03-10 11:37:31.983051+00:00,"{""priceA"": 130, ""sharesA"": 0, ""secs_since_round_starts"": 180, ""market"": ""A""}",180.0,19.0,1.0,5wgi88t6,vmu7c279,FULL STUDY,225.0,s1,1,130,,1,,1,,0,sell,0.5813773703663461,16,0,1,block 4 (G second),22.0,11.0,Male,1.0,0.0,0.0,"[2, 'block 4 (G second)']",0,1,1,0.0,6.0,-0.31666666666666665,0.08333333333333333,0.0,0.4,0.0,4,1.0,0.75,Design 2,Design 2,Only trade on Design #1,,4.0,3.0
452,4994,2,Player object (956),buy,2023-03-10 11:38:32.869021+00:00,"{""priceA"": 125, ""sharesA"": 1, ""secs_since_round_starts"": 241, ""market"": ""A""}",55.0,30.0,2.0,5wgi88t6,vmu7c279,FULL STUDY,225.0,s1,1,125,130.0,-1,,1,sell,0,sell,0.4785999259850118,16,0,0,block 4 (G second),22.0,11.0,Male,1.0,0.0,0.0,"[2, 'block 4 (G second)']",0,1,1,0.0,6.0,-0.31666666666666665,0.08333333333333333,0.0,0.4,0.0,4,1.0,0.75,Design 2,Design 2,Only trade on Design #1,,4.0,3.0
453,4996,2,Player object (956),sell,2023-03-10 11:40:10.655277+00:00,"{""priceA"": 155, ""sharesA"": 0, ""secs_since_round_starts"": 338, ""market"": ""A""}",210.0,46.0,3.0,5wgi88t6,vmu7c279,FULL STUDY,225.0,s1,1,155,125.0,1,30.0,1,buy,0,sell,0.5495494947508355,16,0,1,block 4 (G second),22.0,11.0,Male,1.0,0.0,0.0,"[2, 'block 4 (G second)']",0,1,1,0.0,6.0,-0.31666666666666665,0.08333333333333333,0.0,0.4,0.0,4,1.0,0.75,Design 2,Design 2,Only trade on Design #1,,4.0,3.0
454,4997,2,Player object (956),buy,2023-03-10 11:41:10.631111+00:00,"{""priceA"": 110, ""sharesA"": 1, ""secs_since_round_starts"": 398, ""market"": ""A""}",100.0,57.0,4.0,5wgi88t6,vmu7c279,FULL STUDY,225.0,s1,1,110,155.0,-1,,1,sell,0,sell,0.4349378880511929,16,1,0,block 4 (G second),22.0,11.0,Male,1.0,0.0,0.0,"[2, 'block 4 (G second)']",0,1,1,0.0,6.0,-0.31666666666666665,0.08333333333333333,0.0,0.4,0.0,4,1.0,0.75,Design 2,Design 2,Only trade on Design #1,,4.0,3.0
455,5002,3,Player object (1076),sell,2023-03-10 11:48:12.919227+00:00,"{""priceA"": 120, ""sharesA"": 0, ""secs_since_round_starts"": 398, ""market"": ""A""}",170.0,43.0,1.0,5wgi88t6,vmu7c279,FULL STUDY,170.0,s1,1,120,,1,,1,,0,sell,0.5357259670782416,19,0,0,block 4 (G second),22.0,11.0,Male,1.0,0.0,0.0,"[3, 'block 4 (G second)']",0,0,1,1.0,6.0,-0.31666666666666665,0.04,0.0,0.0,0.0,2,0.5,0.5,Design 2,Design 2,Only trade on Design #1,,4.0,3.0
456,5003,3,Player object (1076),buy,2023-03-10 11:49:34.050534+00:00,"{""priceA"": 115, ""sharesA"": 1, ""secs_since_round_starts"": 479, ""market"": ""A""}",55.0,58.0,2.0,5wgi88t6,vmu7c279,FULL STUDY,170.0,s1,1,115,120.0,-1,,1,sell,0,sell,0.442461876115205,19,1,0,block 4 (G second),22.0,11.0,Male,1.0,0.0,0.0,"[3, 'block 4 (G second)']",0,0,1,1.0,6.0,-0.31666666666666665,0.04,0.0,0.0,0.0,2,0.5,0.5,Design 2,Design 2,Only trade on Design #1,,4.0,3.0
457,5007,4,Player object (1196),sell,2023-03-10 11:52:26.626402+00:00,"{""priceA"": 90, ""sharesA"": 0, ""secs_since_round_starts"": 154, ""market"": ""A""}",140.0,29.0,1.0,5wgi88t6,vmu7c279,FULL STUDY,175.0,s1,1,90,,1,,1,,0,sell,0.5712793841154561,14,0,0,block 4 (G second),22.0,11.0,Male,1.0,0.0,0.0,"[4, 'block 4 (G second)']",1,1,1,0.5,6.0,-0.31666666666666665,0.25,0.030303030303030304,0.0,0.0,4,0.5,0.75,Design 2,Design 2,Only trade on Design #1,,4.0,3.0
458,5009,4,Player object (1196),buy,2023-03-10 11:53:01.556317+00:00,"{""priceA"": 85, ""sharesA"": 1, ""secs_since_round_starts"": 189, ""market"": ""A""}",55.0,36.0,2.0,5wgi88t6,vmu7c279,FULL STUDY,175.0,s1,1,85,90.0,-1,,1,sell,0,sell,0.4885269486642424,14,0,0,block 4 (G second),22.0,11.0,Male,1.0,0.0,0.0,"[4, 'block 4 (G second)']",1,1,1,0.5,6.0,-0.31666666666666665,0.25,0.030303030303030304,0.0,0.0,4,0.5,0.75,Design 2,Design 2,Only trade on Design #1,,4.0,3.0
459,5010,4,Player object (1196),sell,2023-03-10 11:53:47.239294+00:00,"{""priceA"": 115, ""sharesA"": 0, ""secs_since_round_starts"": 234, ""market"": ""A""}",170.0,44.0,3.0,5wgi88t6,vmu7c279,FULL STUDY,175.0,s1,1,115,85.0,1,30.0,1,buy,0,sell,0.5772497941838325,14,0,0,block 4 (G second),22.0,11.0,Male,1.0,0.0,0.0,"[4, 'block 4 (G second)']",1,1,1,0.5,6.0,-0.31666666666666665,0.25,0.030303030303030304,0.0,0.0,4,0.5,0.75,Design 2,Design 2,Only trade on Design #1,,4.0,3.0
460,5011,4,Player object (1196),buy,2023-03-10 11:54:46.114012+00:00,"{""priceA"": 70, ""sharesA"": 1, ""secs_since_round_starts"": 293, ""market"": ""A""}",100.0,55.0,4.0,5wgi88t6,vmu7c279,FULL STUDY,175.0,s1,1,70,115.0,-1,,1,sell,0,sell,0.4620518023886796,14,0,0,block 4 (G second),22.0,11.0,Male,1.0,0.0,0.0,"[4, 'block 4 (G second)']",1,1,1,0.5,6.0,-0.31666666666666665,0.25,0.030303030303030304,0.0,0.0,4,0.5,0.75,Design 2,Design 2,Only trade on Design #1,,4.0,3.0
461,5015,5,Player object (1316),sell,2023-03-10 11:57:08.504476+00:00,"{""priceA"": 105, ""sharesA"": 0, ""secs_since_round_starts"": 107, ""market"": ""A""}",155.0,21.0,1.0,5wgi88t6,vmu7c279,FULL STUDY,190.0,s1,1,105,,1,,1,,0,sell,0.5510362930796925,17,0,1,block 4 (G second),22.0,11.0,Male,1.0,0.0,0.0,"[5, 'block 4 (G second)']",1,0,1,1.0,6.0,-0.31666666666666665,0.21428571428571427,0.0,0.6666666666666666,0.0,4,0.5,0.75,Design 2,Design 2,Only trade on Design #1,,4.0,3.0
462,5016,5,Player object (1316),buy,2023-03-10 11:57:50.444391+00:00,"{""priceA"": 80, ""sharesA"": 1, ""secs_since_round_starts"": 149, ""market"": ""A""}",75.0,29.0,2.0,5wgi88t6,vmu7c279,FULL STUDY,190.0,s1,1,80,105.0,-1,,1,sell,0,sell,0.4304345659865384,17,0,0,block 4 (G second),22.0,11.0,Male,1.0,0.0,0.0,"[5, 'block 4 (G second)']",1,0,1,1.0,6.0,-0.31666666666666665,0.21428571428571427,0.0,0.6666666666666666,0.0,4,0.5,0.75,Design 2,Design 2,Only trade on Design #1,,4.0,3.0
463,5018,5,Player object (1316),sell,2023-03-10 11:58:24.013991+00:00,"{""priceA"": 120, ""sharesA"": 0, ""secs_since_round_starts"": 183, ""market"": ""A""}",195.0,34.0,3.0,5wgi88t6,vmu7c279,FULL STUDY,190.0,s1,1,120,80.0,1,40.0,1,buy,0,sell,0.5679672812132522,17,0,0,block 4 (G second),22.0,11.0,Male,1.0,0.0,0.0,"[5, 'block 4 (G second)']",1,0,1,1.0,6.0,-0.31666666666666665,0.21428571428571427,0.0,0.6666666666666666,0.0,4,0.5,0.75,Design 2,Design 2,Only trade on Design #1,,4.0,3.0
464,5019,5,Player object (1316),buy,2023-03-10 11:58:38.586910+00:00,"{""priceA"": 95, ""sharesA"": 1, ""secs_since_round_starts"": 197, ""market"": ""A""}",100.0,37.0,4.0,5wgi88t6,vmu7c279,FULL STUDY,190.0,s1,1,95,120.0,-1,,1,sell,0,sell,0.4805886028013266,17,0,0,block 4 (G second),22.0,11.0,Male,1.0,0.0,0.0,"[5, 'block 4 (G second)']",1,0,1,1.0,6.0,-0.31666666666666665,0.21428571428571427,0.0,0.6666666666666666,0.0,4,0.5,0.75,Design 2,Design 2,Only trade on Design #1,,4.0,3.0
465,5020,5,Player object (1316),sell,2023-03-10 11:59:09.496475+00:00,"{""priceA"": 100, ""sharesA"": 0, ""secs_since_round_starts"": 228, ""market"": ""A""}",200.0,42.0,5.0,5wgi88t6,vmu7c279,FULL STUDY,190.0,s1,1,100,95.0,1,5.0,1,buy,0,sell,0.5529358605422235,17,0,1,block 4 (G second),22.0,11.0,Male,1.0,0.0,0.0,"[5, 'block 4 (G second)']",1,0,1,1.0,6.0,-0.31666666666666665,0.21428571428571427,0.0,0.6666666666666666,0.0,4,0.5,0.75,Design 2,Design 2,Only trade on Design #1,,4.0,3.0
466,5021,5,Player object (1316),buy,2023-03-10 11:59:40.410895+00:00,"{""priceA"": 75, ""sharesA"": 1, ""secs_since_round_starts"": 259, ""market"": ""A""}",125.0,48.0,6.0,5wgi88t6,vmu7c279,FULL STUDY,190.0,s1,1,75,100.0,-1,,1,sell,0,sell,0.4393932183506925,17,1,0,block 4 (G second),22.0,11.0,Male,1.0,0.0,0.0,"[5, 'block 4 (G second)']",1,0,1,1.0,6.0,-0.31666666666666665,0.21428571428571427,0.0,0.6666666666666666,0.0,4,0.5,0.75,Design 2,Design 2,Only trade on Design #1,,4.0,3.0
467,2591,2,Player object (912),sell,2023-03-08 08:16:11.169849+00:00,"{""priceA"": 100, ""sharesA"": 0, ""secs_since_round_starts"": 73, ""market"": ""A""}",150.0,7.0,1.0,5ymfsw49,vmu7c279,FULL STUDY,205.0,s4,1,100,,1,,1,,0,sell,0.5,0,0,0,block 4 (G second),22.0,12.0,Male,1.0,1.0,1.0,"[2, 'block 4 (G second)']",0,1,1,0.0,6.0,-0.4,0.2916666666666667,1.0,0.0,,2,0.75,0.5,Design 1,Design 1,"Have an option between Design #1 and Design #2,",3.0,,
468,2592,2,Player object (912),buy,2023-03-08 08:16:16.562241+00:00,"{""priceA"": 105, ""sharesA"": 1, ""secs_since_round_starts"": 78, ""market"": ""A""}",45.0,8.0,2.0,5ymfsw49,vmu7c279,FULL STUDY,205.0,s4,1,105,100.0,-1,,1,sell,0,sell,0.5,0,0,0,block 4 (G second),22.0,12.0,Male,1.0,1.0,1.0,"[2, 'block 4 (G second)']",0,1,1,0.0,6.0,-0.4,0.2916666666666667,1.0,0.0,,2,0.75,0.5,Design 1,Design 1,"Have an option between Design #1 and Design #2,",3.0,,
469,2593,2,Player object (912),sell,2023-03-08 08:16:21.963344+00:00,"{""priceA"": 90, ""sharesA"": 0, ""secs_since_round_starts"": 84, ""market"": ""A""}",135.0,9.0,3.0,5ymfsw49,vmu7c279,FULL STUDY,205.0,s4,1,90,105.0,1,-15.0,1,buy,0,sell,0.5,0,0,0,block 4 (G second),22.0,12.0,Male,1.0,1.0,1.0,"[2, 'block 4 (G second)']",0,1,1,0.0,6.0,-0.4,0.2916666666666667,1.0,0.0,,2,0.75,0.5,Design 1,Design 1,"Have an option between Design #1 and Design #2,",3.0,,
470,2594,2,Player object (912),buy,2023-03-08 08:16:32.771911+00:00,"{""priceA"": 85, ""sharesA"": 1, ""secs_since_round_starts"": 94, ""market"": ""A""}",50.0,11.0,4.0,5ymfsw49,vmu7c279,FULL STUDY,205.0,s4,1,85,90.0,-1,,1,sell,0,sell,0.5,0,0,0,block 4 (G second),22.0,12.0,Male,1.0,1.0,1.0,"[2, 'block 4 (G second)']",0,1,1,0.0,6.0,-0.4,0.2916666666666667,1.0,0.0,,2,0.75,0.5,Design 1,Design 1,"Have an option between Design #1 and Design #2,",3.0,,
471,2595,2,Player object (912),sell,2023-03-08 08:16:44.292514+00:00,"{""priceA"": 85, ""sharesA"": 0, ""secs_since_round_starts"": 106, ""market"": ""A""}",135.0,13.0,5.0,5ymfsw49,vmu7c279,FULL STUDY,205.0,s4,1,85,85.0,1,0.0,1,buy,0,sell,0.5,0,0,0,block 4 (G second),22.0,12.0,Male,1.0,1.0,1.0,"[2, 'block 4 (G second)']",0,1,1,0.0,6.0,-0.4,0.2916666666666667,1.0,0.0,,2,0.75,0.5,Design 1,Design 1,"Have an option between Design #1 and Design #2,",3.0,,
472,2596,2,Player object (912),buy,2023-03-08 08:17:06.305484+00:00,"{""priceA"": 60, ""sharesA"": 1, ""secs_since_round_starts"": 128, ""market"": ""A""}",75.0,17.0,6.0,5ymfsw49,vmu7c279,FULL STUDY,205.0,s4,1,60,85.0,-1,,1,sell,0,sell,0.5,0,0,0,block 4 (G second),22.0,12.0,Male,1.0,1.0,1.0,"[2, 'block 4 (G second)']",0,1,1,0.0,6.0,-0.4,0.2916666666666667,1.0,0.0,,2,0.75,0.5,Design 1,Design 1,"Have an option between Design #1 and Design #2,",3.0,,
473,2597,2,Player object (912),sell,2023-03-08 08:17:28.693941+00:00,"{""priceA"": 70, ""sharesA"": 0, ""secs_since_round_starts"": 150, ""market"": ""A""}",145.0,21.0,7.0,5ymfsw49,vmu7c279,FULL STUDY,205.0,s4,1,70,60.0,1,10.0,1,buy,0,sell,0.5,0,0,0,block 4 (G second),22.0,12.0,Male,1.0,1.0,1.0,"[2, 'block 4 (G second)']",0,1,1,0.0,6.0,-0.4,0.2916666666666667,1.0,0.0,,2,0.75,0.5,Design 1,Design 1,"Have an option between Design #1 and Design #2,",3.0,,
474,2598,2,Player object (912),buy,2023-03-08 08:17:33.625051+00:00,"{""priceA"": 75, ""sharesA"": 1, ""secs_since_round_starts"": 155, ""market"": ""A""}",70.0,22.0,8.0,5ymfsw49,vmu7c279,FULL STUDY,205.0,s4,1,75,70.0,-1,,1,sell,0,sell,0.5,0,0,0,block 4 (G second),22.0,12.0,Male,1.0,1.0,1.0,"[2, 'block 4 (G second)']",0,1,1,0.0,6.0,-0.4,0.2916666666666667,1.0,0.0,,2,0.75,0.5,Design 1,Design 1,"Have an option between Design #1 and Design #2,",3.0,,
475,2599,2,Player object (912),sell,2023-03-08 08:17:44.977809+00:00,"{""priceA"": 85, ""sharesA"": 0, ""secs_since_round_starts"": 167, ""market"": ""A""}",155.0,24.0,9.0,5ymfsw49,vmu7c279,FULL STUDY,205.0,s4,1,85,75.0,1,10.0,1,buy,0,sell,0.5,0,0,0,block 4 (G second),22.0,12.0,Male,1.0,1.0,1.0,"[2, 'block 4 (G second)']",0,1,1,0.0,6.0,-0.4,0.2916666666666667,1.0,0.0,,2,0.75,0.5,Design 1,Design 1,"Have an option between Design #1 and Design #2,",3.0,,
476,2600,2,Player object (912),buy,2023-03-08 08:17:55.710345+00:00,"{""priceA"": 80, ""sharesA"": 1, ""secs_since_round_starts"": 177, ""market"": ""A""}",75.0,26.0,10.0,5ymfsw49,vmu7c279,FULL STUDY,205.0,s4,1,80,85.0,-1,,1,sell,0,sell,0.5,0,0,0,block 4 (G second),22.0,12.0,Male,1.0,1.0,1.0,"[2, 'block 4 (G second)']",0,1,1,0.0,6.0,-0.4,0.2916666666666667,1.0,0.0,,2,0.75,0.5,Design 1,Design 1,"Have an option between Design #1 and Design #2,",3.0,,
477,2601,2,Player object (912),sell,2023-03-08 08:18:03.803805+00:00,"{""priceA"": 75, ""sharesA"": 0, ""secs_since_round_starts"": 185, ""market"": ""A""}",150.0,27.0,11.0,5ymfsw49,vmu7c279,FULL STUDY,205.0,s4,1,75,80.0,1,-5.0,1,buy,0,sell,0.5,0,0,0,block 4 (G second),22.0,12.0,Male,1.0,1.0,1.0,"[2, 'block 4 (G second)']",0,1,1,0.0,6.0,-0.4,0.2916666666666667,1.0,0.0,,2,0.75,0.5,Design 1,Design 1,"Have an option between Design #1 and Design #2,",3.0,,
478,2602,2,Player object (912),buy,2023-03-08 08:18:06.771877+00:00,"{""priceA"": 80, ""sharesA"": 1, ""secs_since_round_starts"": 188, ""market"": ""A""}",70.0,28.0,12.0,5ymfsw49,vmu7c279,FULL STUDY,205.0,s4,1,80,75.0,-1,,1,sell,0,sell,0.5,0,0,0,block 4 (G second),22.0,12.0,Male,1.0,1.0,1.0,"[2, 'block 4 (G second)']",0,1,1,0.0,6.0,-0.4,0.2916666666666667,1.0,0.0,,2,0.75,0.5,Design 1,Design 1,"Have an option between Design #1 and Design #2,",3.0,,
479,2604,2,Player object (912),sell,2023-03-08 08:19:07.268832+00:00,"{""priceA"": 95, ""sharesA"": 0, ""secs_since_round_starts"": 249, ""market"": ""A""}",165.0,32.0,13.0,5ymfsw49,vmu7c279,FULL STUDY,205.0,s4,1,95,80.0,1,15.0,1,buy,0,sell,0.5,0,0,0,block 4 (G second),22.0,12.0,Male,1.0,1.0,1.0,"[2, 'block 4 (G second)']",0,1,1,0.0,6.0,-0.4,0.2916666666666667,1.0,0.0,,2,0.75,0.5,Design 1,Design 1,"Have an option between Design #1 and Design #2,",3.0,,
480,2605,2,Player object (912),buy,2023-03-08 08:19:21.300436+00:00,"{""priceA"": 80, ""sharesA"": 1, ""secs_since_round_starts"": 263, ""market"": ""A""}",85.0,35.0,14.0,5ymfsw49,vmu7c279,FULL STUDY,205.0,s4,1,80,95.0,-1,,1,sell,0,sell,0.5,0,0,0,block 4 (G second),22.0,12.0,Male,1.0,1.0,1.0,"[2, 'block 4 (G second)']",0,1,1,0.0,6.0,-0.4,0.2916666666666667,1.0,0.0,,2,0.75,0.5,Design 1,Design 1,"Have an option between Design #1 and Design #2,",3.0,,
481,2606,2,Player object (912),sell,2023-03-08 08:19:27.475363+00:00,"{""priceA"": 65, ""sharesA"": 0, ""secs_since_round_starts"": 269, ""market"": ""A""}",150.0,36.0,15.0,5ymfsw49,vmu7c279,FULL STUDY,205.0,s4,1,65,80.0,1,-15.0,1,buy,0,sell,0.5,0,0,0,block 4 (G second),22.0,12.0,Male,1.0,1.0,1.0,"[2, 'block 4 (G second)']",0,1,1,0.0,6.0,-0.4,0.2916666666666667,1.0,0.0,,2,0.75,0.5,Design 1,Design 1,"Have an option between Design #1 and Design #2,",3.0,,
482,2607,2,Player object (912),buy,2023-03-08 08:19:49.319328+00:00,"{""priceA"": 50, ""sharesA"": 1, ""secs_since_round_starts"": 291, ""market"": ""A""}",100.0,40.0,16.0,5ymfsw49,vmu7c279,FULL STUDY,205.0,s4,1,50,65.0,-1,,1,sell,0,sell,0.5,0,0,0,block 4 (G second),22.0,12.0,Male,1.0,1.0,1.0,"[2, 'block 4 (G second)']",0,1,1,0.0,6.0,-0.4,0.2916666666666667,1.0,0.0,,2,0.75,0.5,Design 1,Design 1,"Have an option between Design #1 and Design #2,",3.0,,
483,2608,2,Player object (912),sell,2023-03-08 08:20:05.599966+00:00,"{""priceA"": 60, ""sharesA"": 0, ""secs_since_round_starts"": 307, ""market"": ""A""}",160.0,43.0,17.0,5ymfsw49,vmu7c279,FULL STUDY,205.0,s4,1,60,50.0,1,10.0,1,buy,0,sell,0.5,0,0,0,block 4 (G second),22.0,12.0,Male,1.0,1.0,1.0,"[2, 'block 4 (G second)']",0,1,1,0.0,6.0,-0.4,0.2916666666666667,1.0,0.0,,2,0.75,0.5,Design 1,Design 1,"Have an option between Design #1 and Design #2,",3.0,,
484,2609,2,Player object (912),buy,2023-03-08 08:20:16.971277+00:00,"{""priceA"": 50, ""sharesA"": 1, ""secs_since_round_starts"": 319, ""market"": ""A""}",110.0,45.0,18.0,5ymfsw49,vmu7c279,FULL STUDY,205.0,s4,1,50,60.0,-1,,1,sell,0,sell,0.5,0,0,0,block 4 (G second),22.0,12.0,Male,1.0,1.0,1.0,"[2, 'block 4 (G second)']",0,1,1,0.0,6.0,-0.4,0.2916666666666667,1.0,0.0,,2,0.75,0.5,Design 1,Design 1,"Have an option between Design #1 and Design #2,",3.0,,
485,2610,2,Player object (912),sell,2023-03-08 08:20:21.881897+00:00,"{""priceA"": 35, ""sharesA"": 0, ""secs_since_round_starts"": 323, ""market"": ""A""}",145.0,46.0,19.0,5ymfsw49,vmu7c279,FULL STUDY,205.0,s4,1,35,50.0,1,-15.0,1,buy,0,sell,0.5,0,0,0,block 4 (G second),22.0,12.0,Male,1.0,1.0,1.0,"[2, 'block 4 (G second)']",0,1,1,0.0,6.0,-0.4,0.2916666666666667,1.0,0.0,,2,0.75,0.5,Design 1,Design 1,"Have an option between Design #1 and Design #2,",3.0,,
486,2611,2,Player object (912),buy,2023-03-08 08:20:27.575604+00:00,"{""priceA"": 40, ""sharesA"": 1, ""secs_since_round_starts"": 329, ""market"": ""A""}",105.0,47.0,20.0,5ymfsw49,vmu7c279,FULL STUDY,205.0,s4,1,40,35.0,-1,,1,sell,0,sell,0.5,0,0,0,block 4 (G second),22.0,12.0,Male,1.0,1.0,1.0,"[2, 'block 4 (G second)']",0,1,1,0.0,6.0,-0.4,0.2916666666666667,1.0,0.0,,2,0.75,0.5,Design 1,Design 1,"Have an option between Design #1 and Design #2,",3.0,,
487,2612,2,Player object (912),sell,2023-03-08 08:20:43.926413+00:00,"{""priceA"": 60, ""sharesA"": 0, ""secs_since_round_starts"": 346, ""market"": ""A""}",165.0,50.0,21.0,5ymfsw49,vmu7c279,FULL STUDY,205.0,s4,1,60,40.0,1,20.0,1,buy,0,sell,0.5,0,0,0,block 4 (G second),22.0,12.0,Male,1.0,1.0,1.0,"[2, 'block 4 (G second)']",0,1,1,0.0,6.0,-0.4,0.2916666666666667,1.0,0.0,,2,0.75,0.5,Design 1,Design 1,"Have an option between Design #1 and Design #2,",3.0,,
488,2613,2,Player object (912),buy,2023-03-08 08:20:50.525166+00:00,"{""priceA"": 75, ""sharesA"": 1, ""secs_since_round_starts"": 352, ""market"": ""A""}",90.0,51.0,22.0,5ymfsw49,vmu7c279,FULL STUDY,205.0,s4,1,75,60.0,-1,,1,sell,0,sell,0.5,0,0,0,block 4 (G second),22.0,12.0,Male,1.0,1.0,1.0,"[2, 'block 4 (G second)']",0,1,1,0.0,6.0,-0.4,0.2916666666666667,1.0,0.0,,2,0.75,0.5,Design 1,Design 1,"Have an option between Design #1 and Design #2,",3.0,,
489,2614,2,Player object (912),sell,2023-03-08 08:21:06.295250+00:00,"{""priceA"": 95, ""sharesA"": 0, ""secs_since_round_starts"": 368, ""market"": ""A""}",185.0,54.0,23.0,5ymfsw49,vmu7c279,FULL STUDY,205.0,s4,1,95,75.0,1,20.0,1,buy,0,sell,0.5,0,0,0,block 4 (G second),22.0,12.0,Male,1.0,1.0,1.0,"[2, 'block 4 (G second)']",0,1,1,0.0,6.0,-0.4,0.2916666666666667,1.0,0.0,,2,0.75,0.5,Design 1,Design 1,"Have an option between Design #1 and Design #2,",3.0,,
490,2615,2,Player object (912),buy,2023-03-08 08:21:17.400009+00:00,"{""priceA"": 85, ""sharesA"": 1, ""secs_since_round_starts"": 379, ""market"": ""A""}",100.0,56.0,24.0,5ymfsw49,vmu7c279,FULL STUDY,205.0,s4,1,85,95.0,-1,,1,sell,0,sell,0.5,0,0,0,block 4 (G second),22.0,12.0,Male,1.0,1.0,1.0,"[2, 'block 4 (G second)']",0,1,1,0.0,6.0,-0.4,0.2916666666666667,1.0,0.0,,2,0.75,0.5,Design 1,Design 1,"Have an option between Design #1 and Design #2,",3.0,,
491,2616,2,Player object (912),sell,2023-03-08 08:21:33.840575+00:00,"{""priceA"": 105, ""sharesA"": 0, ""secs_since_round_starts"": 395, ""market"": ""A""}",205.0,59.0,25.0,5ymfsw49,vmu7c279,FULL STUDY,205.0,s4,1,105,85.0,1,20.0,1,buy,0,sell,0.5,0,0,0,block 4 (G second),22.0,12.0,Male,1.0,1.0,1.0,"[2, 'block 4 (G second)']",0,1,1,0.0,6.0,-0.4,0.2916666666666667,1.0,0.0,,2,0.75,0.5,Design 1,Design 1,"Have an option between Design #1 and Design #2,",3.0,,
492,2620,3,Player object (1032),sell,2023-03-08 08:23:00.561871+00:00,"{""priceA"": 105, ""sharesA"": 0, ""secs_since_round_starts"": 59, ""market"": ""A""}",155.0,7.0,1.0,5ymfsw49,vmu7c279,FULL STUDY,220.0,s4,1,105,,1,,1,,0,sell,0.5,0,0,0,block 4 (G second),22.0,12.0,Male,1.0,1.0,1.0,"[3, 'block 4 (G second)']",0,0,1,0.0,6.0,-0.4,0.18518518518518517,0.8,0.0,0.0,1,0.5,0.5,Design 1,Design 1,"Have an option between Design #1 and Design #2,",3.0,,
493,2621,3,Player object (1032),buy,2023-03-08 08:23:05.761560+00:00,"{""priceA"": 120, ""sharesA"": 1, ""secs_since_round_starts"": 64, ""market"": ""A""}",35.0,8.0,2.0,5ymfsw49,vmu7c279,FULL STUDY,220.0,s4,1,120,105.0,-1,,1,sell,0,sell,0.5,0,0,0,block 4 (G second),22.0,12.0,Male,1.0,1.0,1.0,"[3, 'block 4 (G second)']",0,0,1,0.0,6.0,-0.4,0.18518518518518517,0.8,0.0,0.0,1,0.5,0.5,Design 1,Design 1,"Have an option between Design #1 and Design #2,",3.0,,
494,2622,3,Player object (1032),sell,2023-03-08 08:23:33.460396+00:00,"{""priceA"": 125, ""sharesA"": 0, ""secs_since_round_starts"": 92, ""market"": ""A""}",160.0,13.0,3.0,5ymfsw49,vmu7c279,FULL STUDY,220.0,s4,1,125,120.0,1,5.0,1,buy,0,sell,0.5,0,0,0,block 4 (G second),22.0,12.0,Male,1.0,1.0,1.0,"[3, 'block 4 (G second)']",0,0,1,0.0,6.0,-0.4,0.18518518518518517,0.8,0.0,0.0,1,0.5,0.5,Design 1,Design 1,"Have an option between Design #1 and Design #2,",3.0,,
495,2623,3,Player object (1032),buy,2023-03-08 08:23:38.578113+00:00,"{""priceA"": 135, ""sharesA"": 1, ""secs_since_round_starts"": 97, ""market"": ""A""}",25.0,14.0,4.0,5ymfsw49,vmu7c279,FULL STUDY,220.0,s4,1,135,125.0,-1,,1,sell,0,sell,0.5,0,0,0,block 4 (G second),22.0,12.0,Male,1.0,1.0,1.0,"[3, 'block 4 (G second)']",0,0,1,0.0,6.0,-0.4,0.18518518518518517,0.8,0.0,0.0,1,0.5,0.5,Design 1,Design 1,"Have an option between Design #1 and Design #2,",3.0,,
496,2624,3,Player object (1032),sell,2023-03-08 08:23:55.302204+00:00,"{""priceA"": 155, ""sharesA"": 0, ""secs_since_round_starts"": 114, ""market"": ""A""}",180.0,17.0,5.0,5ymfsw49,vmu7c279,FULL STUDY,220.0,s4,1,155,135.0,1,20.0,1,buy,0,sell,0.5,0,0,0,block 4 (G second),22.0,12.0,Male,1.0,1.0,1.0,"[3, 'block 4 (G second)']",0,0,1,0.0,6.0,-0.4,0.18518518518518517,0.8,0.0,0.0,1,0.5,0.5,Design 1,Design 1,"Have an option between Design #1 and Design #2,",3.0,,
497,2625,3,Player object (1032),buy,2023-03-08 08:24:00.597391+00:00,"{""priceA"": 165, ""sharesA"": 1, ""secs_since_round_starts"": 119, ""market"": ""A""}",15.0,18.0,6.0,5ymfsw49,vmu7c279,FULL STUDY,220.0,s4,1,165,155.0,-1,,1,sell,0,sell,0.5,0,0,0,block 4 (G second),22.0,12.0,Male,1.0,1.0,1.0,"[3, 'block 4 (G second)']",0,0,1,0.0,6.0,-0.4,0.18518518518518517,0.8,0.0,0.0,1,0.5,0.5,Design 1,Design 1,"Have an option between Design #1 and Design #2,",3.0,,
498,2626,3,Player object (1032),sell,2023-03-08 08:24:06.331929+00:00,"{""priceA"": 150, ""sharesA"": 0, ""secs_since_round_starts"": 125, ""market"": ""A""}",165.0,19.0,7.0,5ymfsw49,vmu7c279,FULL STUDY,220.0,s4,1,150,165.0,1,-15.0,1,buy,0,sell,0.5,0,0,0,block 4 (G second),22.0,12.0,Male,1.0,1.0,1.0,"[3, 'block 4 (G second)']",0,0,1,0.0,6.0,-0.4,0.18518518518518517,0.8,0.0,0.0,1,0.5,0.5,Design 1,Design 1,"Have an option between Design #1 and Design #2,",3.0,,
499,2627,3,Player object (1032),buy,2023-03-08 08:24:28.525077+00:00,"{""priceA"": 130, ""sharesA"": 1, ""secs_since_round_starts"": 147, ""market"": ""A""}",35.0,23.0,8.0,5ymfsw49,vmu7c279,FULL STUDY,220.0,s4,1,130,150.0,-1,,1,sell,0,sell,0.5,0,0,0,block 4 (G second),22.0,12.0,Male,1.0,1.0,1.0,"[3, 'block 4 (G second)']",0,0,1,0.0,6.0,-0.4,0.18518518518518517,0.8,0.0,0.0,1,0.5,0.5,Design 1,Design 1,"Have an option between Design #1 and Design #2,",3.0,,
500,2628,3,Player object (1032),sell,2023-03-08 08:24:50.387341+00:00,"{""priceA"": 155, ""sharesA"": 0, ""secs_since_round_starts"": 169, ""market"": ""A""}",190.0,27.0,9.0,5ymfsw49,vmu7c279,FULL STUDY,220.0,s4,1,155,130.0,1,25.0,1,buy,0,sell,0.5,0,0,0,block 4 (G second),22.0,12.0,Male,1.0,1.0,1.0,"[3, 'block 4 (G second)']",0,0,1,0.0,6.0,-0.4,0.18518518518518517,0.8,0.0,0.0,1,0.5,0.5,Design 1,Design 1,"Have an option between Design #1 and Design #2,",3.0,,
501,2629,3,Player object (1032),buy,2023-03-08 08:25:01.338396+00:00,"{""priceA"": 160, ""sharesA"": 1, ""secs_since_round_starts"": 180, ""market"": ""A""}",30.0,29.0,10.0,5ymfsw49,vmu7c279,FULL STUDY,220.0,s4,1,160,155.0,-1,,1,sell,0,sell,0.5,0,0,0,block 4 (G second),22.0,12.0,Male,1.0,1.0,1.0,"[3, 'block 4 (G second)']",0,0,1,0.0,6.0,-0.4,0.18518518518518517,0.8,0.0,0.0,1,0.5,0.5,Design 1,Design 1,"Have an option between Design #1 and Design #2,",3.0,,
502,2631,3,Player object (1032),sell,2023-03-08 08:25:39.336342+00:00,"{""priceA"": 150, ""sharesA"": 0, ""secs_since_round_starts"": 218, ""market"": ""A""}",180.0,32.0,11.0,5ymfsw49,vmu7c279,FULL STUDY,220.0,s4,1,150,160.0,1,-10.0,1,buy,0,sell,0.5,0,0,0,block 4 (G second),22.0,12.0,Male,1.0,1.0,1.0,"[3, 'block 4 (G second)']",0,0,1,0.0,6.0,-0.4,0.18518518518518517,0.8,0.0,0.0,1,0.5,0.5,Design 1,Design 1,"Have an option between Design #1 and Design #2,",3.0,,
503,2632,3,Player object (1032),buy,2023-03-08 08:25:49.213640+00:00,"{""priceA"": 145, ""sharesA"": 1, ""secs_since_round_starts"": 228, ""market"": ""A""}",35.0,34.0,12.0,5ymfsw49,vmu7c279,FULL STUDY,220.0,s4,1,145,150.0,-1,,1,sell,0,sell,0.5,0,0,0,block 4 (G second),22.0,12.0,Male,1.0,1.0,1.0,"[3, 'block 4 (G second)']",0,0,1,0.0,6.0,-0.4,0.18518518518518517,0.8,0.0,0.0,1,0.5,0.5,Design 1,Design 1,"Have an option between Design #1 and Design #2,",3.0,,
504,2633,3,Player object (1032),sell,2023-03-08 08:26:05.106296+00:00,"{""priceA"": 145, ""sharesA"": 0, ""secs_since_round_starts"": 244, ""market"": ""A""}",180.0,37.0,13.0,5ymfsw49,vmu7c279,FULL STUDY,220.0,s4,1,145,145.0,1,0.0,1,buy,0,sell,0.5,0,0,0,block 4 (G second),22.0,12.0,Male,1.0,1.0,1.0,"[3, 'block 4 (G second)']",0,0,1,0.0,6.0,-0.4,0.18518518518518517,0.8,0.0,0.0,1,0.5,0.5,Design 1,Design 1,"Have an option between Design #1 and Design #2,",3.0,,
505,2634,3,Player object (1032),buy,2023-03-08 08:26:16.183084+00:00,"{""priceA"": 145, ""sharesA"": 1, ""secs_since_round_starts"": 255, ""market"": ""A""}",35.0,39.0,14.0,5ymfsw49,vmu7c279,FULL STUDY,220.0,s4,1,145,145.0,-1,,1,sell,0,sell,0.5,0,0,0,block 4 (G second),22.0,12.0,Male,1.0,1.0,1.0,"[3, 'block 4 (G second)']",0,0,1,0.0,6.0,-0.4,0.18518518518518517,0.8,0.0,0.0,1,0.5,0.5,Design 1,Design 1,"Have an option between Design #1 and Design #2,",3.0,,
506,2635,3,Player object (1032),sell,2023-03-08 08:26:21.732183+00:00,"{""priceA"": 130, ""sharesA"": 0, ""secs_since_round_starts"": 260, ""market"": ""A""}",165.0,40.0,15.0,5ymfsw49,vmu7c279,FULL STUDY,220.0,s4,1,130,145.0,1,-15.0,1,buy,0,sell,0.5,0,0,0,block 4 (G second),22.0,12.0,Male,1.0,1.0,1.0,"[3, 'block 4 (G second)']",0,0,1,0.0,6.0,-0.4,0.18518518518518517,0.8,0.0,0.0,1,0.5,0.5,Design 1,Design 1,"Have an option between Design #1 and Design #2,",3.0,,
507,2636,3,Player object (1032),buy,2023-03-08 08:26:33.059208+00:00,"{""priceA"": 140, ""sharesA"": 1, ""secs_since_round_starts"": 272, ""market"": ""A""}",25.0,42.0,16.0,5ymfsw49,vmu7c279,FULL STUDY,220.0,s4,1,140,130.0,-1,,1,sell,0,sell,0.5,0,0,0,block 4 (G second),22.0,12.0,Male,1.0,1.0,1.0,"[3, 'block 4 (G second)']",0,0,1,0.0,6.0,-0.4,0.18518518518518517,0.8,0.0,0.0,1,0.5,0.5,Design 1,Design 1,"Have an option between Design #1 and Design #2,",3.0,,
508,2637,3,Player object (1032),sell,2023-03-08 08:26:38.961123+00:00,"{""priceA"": 135, ""sharesA"": 0, ""secs_since_round_starts"": 278, ""market"": ""A""}",160.0,43.0,17.0,5ymfsw49,vmu7c279,FULL STUDY,220.0,s4,1,135,140.0,1,-5.0,1,buy,0,sell,0.5,0,0,0,block 4 (G second),22.0,12.0,Male,1.0,1.0,1.0,"[3, 'block 4 (G second)']",0,0,1,0.0,6.0,-0.4,0.18518518518518517,0.8,0.0,0.0,1,0.5,0.5,Design 1,Design 1,"Have an option between Design #1 and Design #2,",3.0,,
509,2638,3,Player object (1032),buy,2023-03-08 08:26:43.863288+00:00,"{""priceA"": 140, ""sharesA"": 1, ""secs_since_round_starts"": 283, ""market"": ""A""}",20.0,44.0,18.0,5ymfsw49,vmu7c279,FULL STUDY,220.0,s4,1,140,135.0,-1,,1,sell,0,sell,0.5,0,0,0,block 4 (G second),22.0,12.0,Male,1.0,1.0,1.0,"[3, 'block 4 (G second)']",0,0,1,0.0,6.0,-0.4,0.18518518518518517,0.8,0.0,0.0,1,0.5,0.5,Design 1,Design 1,"Have an option between Design #1 and Design #2,",3.0,,
510,2639,3,Player object (1032),sell,2023-03-08 08:27:00.392592+00:00,"{""priceA"": 140, ""sharesA"": 0, ""secs_since_round_starts"": 299, ""market"": ""A""}",160.0,47.0,19.0,5ymfsw49,vmu7c279,FULL STUDY,220.0,s4,1,140,140.0,1,0.0,1,buy,0,sell,0.5,0,0,0,block 4 (G second),22.0,12.0,Male,1.0,1.0,1.0,"[3, 'block 4 (G second)']",0,0,1,0.0,6.0,-0.4,0.18518518518518517,0.8,0.0,0.0,1,0.5,0.5,Design 1,Design 1,"Have an option between Design #1 and Design #2,",3.0,,
511,2640,3,Player object (1032),buy,2023-03-08 08:27:06.135973+00:00,"{""priceA"": 150, ""sharesA"": 1, ""secs_since_round_starts"": 305, ""market"": ""A""}",10.0,48.0,20.0,5ymfsw49,vmu7c279,FULL STUDY,220.0,s4,1,150,140.0,-1,,1,sell,0,sell,0.5,0,0,0,block 4 (G second),22.0,12.0,Male,1.0,1.0,1.0,"[3, 'block 4 (G second)']",0,0,1,0.0,6.0,-0.4,0.18518518518518517,0.8,0.0,0.0,1,0.5,0.5,Design 1,Design 1,"Have an option between Design #1 and Design #2,",3.0,,
512,2641,3,Player object (1032),sell,2023-03-08 08:27:39.242855+00:00,"{""priceA"": 200, ""sharesA"": 0, ""secs_since_round_starts"": 338, ""market"": ""A""}",210.0,54.0,21.0,5ymfsw49,vmu7c279,FULL STUDY,220.0,s4,1,200,150.0,1,50.0,1,buy,0,sell,0.5,0,0,0,block 4 (G second),22.0,12.0,Male,1.0,1.0,1.0,"[3, 'block 4 (G second)']",0,0,1,0.0,6.0,-0.4,0.18518518518518517,0.8,0.0,0.0,1,0.5,0.5,Design 1,Design 1,"Have an option between Design #1 and Design #2,",3.0,,
513,2642,3,Player object (1032),buy,2023-03-08 08:28:09.282849+00:00,"{""priceA"": 170, ""sharesA"": 1, ""secs_since_round_starts"": 368, ""market"": ""A""}",40.0,59.0,22.0,5ymfsw49,vmu7c279,FULL STUDY,220.0,s4,1,170,200.0,-1,,1,sell,0,sell,0.5,0,0,0,block 4 (G second),22.0,12.0,Male,1.0,1.0,1.0,"[3, 'block 4 (G second)']",0,0,1,0.0,6.0,-0.4,0.18518518518518517,0.8,0.0,0.0,1,0.5,0.5,Design 1,Design 1,"Have an option between Design #1 and Design #2,",3.0,,
514,2646,4,Player object (1152),sell,2023-03-08 08:29:10.985037+00:00,"{""priceA"": 130, ""sharesA"": 0, ""secs_since_round_starts"": 43, ""market"": ""A""}",180.0,8.0,1.0,5ymfsw49,vmu7c279,FULL STUDY,180.0,s4,1,130,,1,,1,,0,sell,0.5,0,0,0,block 4 (G second),22.0,12.0,Male,1.0,1.0,1.0,"[4, 'block 4 (G second)']",1,1,1,0.0,6.0,-0.4,0.18181818181818182,1.0,0.0,,4,0.75,0.5,Design 1,Design 1,"Have an option between Design #1 and Design #2,",3.0,,
515,2647,4,Player object (1152),buy,2023-03-08 08:29:16.391096+00:00,"{""priceA"": 140, ""sharesA"": 1, ""secs_since_round_starts"": 49, ""market"": ""A""}",40.0,9.0,2.0,5ymfsw49,vmu7c279,FULL STUDY,180.0,s4,1,140,130.0,-1,,1,sell,0,sell,0.5,0,0,0,block 4 (G second),22.0,12.0,Male,1.0,1.0,1.0,"[4, 'block 4 (G second)']",1,1,1,0.0,6.0,-0.4,0.18181818181818182,1.0,0.0,,4,0.75,0.5,Design 1,Design 1,"Have an option between Design #1 and Design #2,",3.0,,
516,2648,4,Player object (1152),sell,2023-03-08 08:29:22.597326+00:00,"{""priceA"": 135, ""sharesA"": 0, ""secs_since_round_starts"": 55, ""market"": ""A""}",175.0,10.0,3.0,5ymfsw49,vmu7c279,FULL STUDY,180.0,s4,1,135,140.0,1,-5.0,1,buy,0,sell,0.5,0,0,0,block 4 (G second),22.0,12.0,Male,1.0,1.0,1.0,"[4, 'block 4 (G second)']",1,1,1,0.0,6.0,-0.4,0.18181818181818182,1.0,0.0,,4,0.75,0.5,Design 1,Design 1,"Have an option between Design #1 and Design #2,",3.0,,
517,2649,4,Player object (1152),buy,2023-03-08 08:29:38.476790+00:00,"{""priceA"": 115, ""sharesA"": 1, ""secs_since_round_starts"": 71, ""market"": ""A""}",60.0,13.0,4.0,5ymfsw49,vmu7c279,FULL STUDY,180.0,s4,1,115,135.0,-1,,1,sell,0,sell,0.5,0,0,0,block 4 (G second),22.0,12.0,Male,1.0,1.0,1.0,"[4, 'block 4 (G second)']",1,1,1,0.0,6.0,-0.4,0.18181818181818182,1.0,0.0,,4,0.75,0.5,Design 1,Design 1,"Have an option between Design #1 and Design #2,",3.0,,
518,2650,4,Player object (1152),sell,2023-03-08 08:29:44.637598+00:00,"{""priceA"": 110, ""sharesA"": 0, ""secs_since_round_starts"": 77, ""market"": ""A""}",170.0,14.0,5.0,5ymfsw49,vmu7c279,FULL STUDY,180.0,s4,1,110,115.0,1,-5.0,1,buy,0,sell,0.5,0,0,0,block 4 (G second),22.0,12.0,Male,1.0,1.0,1.0,"[4, 'block 4 (G second)']",1,1,1,0.0,6.0,-0.4,0.18181818181818182,1.0,0.0,,4,0.75,0.5,Design 1,Design 1,"Have an option between Design #1 and Design #2,",3.0,,
519,2651,4,Player object (1152),buy,2023-03-08 08:30:00.730702+00:00,"{""priceA"": 90, ""sharesA"": 1, ""secs_since_round_starts"": 93, ""market"": ""A""}",80.0,17.0,6.0,5ymfsw49,vmu7c279,FULL STUDY,180.0,s4,1,90,110.0,-1,,1,sell,0,sell,0.5,0,0,0,block 4 (G second),22.0,12.0,Male,1.0,1.0,1.0,"[4, 'block 4 (G second)']",1,1,1,0.0,6.0,-0.4,0.18181818181818182,1.0,0.0,,4,0.75,0.5,Design 1,Design 1,"Have an option between Design #1 and Design #2,",3.0,,
520,2652,4,Player object (1152),sell,2023-03-08 08:30:06.127297+00:00,"{""priceA"": 80, ""sharesA"": 0, ""secs_since_round_starts"": 98, ""market"": ""A""}",160.0,18.0,7.0,5ymfsw49,vmu7c279,FULL STUDY,180.0,s4,1,80,90.0,1,-10.0,1,buy,0,sell,0.5,0,0,0,block 4 (G second),22.0,12.0,Male,1.0,1.0,1.0,"[4, 'block 4 (G second)']",1,1,1,0.0,6.0,-0.4,0.18181818181818182,1.0,0.0,,4,0.75,0.5,Design 1,Design 1,"Have an option between Design #1 and Design #2,",3.0,,
521,2653,4,Player object (1152),buy,2023-03-08 08:30:11.993545+00:00,"{""priceA"": 85, ""sharesA"": 1, ""secs_since_round_starts"": 104, ""market"": ""A""}",75.0,19.0,8.0,5ymfsw49,vmu7c279,FULL STUDY,180.0,s4,1,85,80.0,-1,,1,sell,0,sell,0.5,0,0,0,block 4 (G second),22.0,12.0,Male,1.0,1.0,1.0,"[4, 'block 4 (G second)']",1,1,1,0.0,6.0,-0.4,0.18181818181818182,1.0,0.0,,4,0.75,0.5,Design 1,Design 1,"Have an option between Design #1 and Design #2,",3.0,,
522,2654,4,Player object (1152),sell,2023-03-08 08:30:17.087498+00:00,"{""priceA"": 75, ""sharesA"": 0, ""secs_since_round_starts"": 109, ""market"": ""A""}",150.0,20.0,9.0,5ymfsw49,vmu7c279,FULL STUDY,180.0,s4,1,75,85.0,1,-10.0,1,buy,0,sell,0.5,0,0,0,block 4 (G second),22.0,12.0,Male,1.0,1.0,1.0,"[4, 'block 4 (G second)']",1,1,1,0.0,6.0,-0.4,0.18181818181818182,1.0,0.0,,4,0.75,0.5,Design 1,Design 1,"Have an option between Design #1 and Design #2,",3.0,,
523,2655,4,Player object (1152),buy,2023-03-08 08:30:33.622014+00:00,"{""priceA"": 65, ""sharesA"": 1, ""secs_since_round_starts"": 126, ""market"": ""A""}",85.0,23.0,10.0,5ymfsw49,vmu7c279,FULL STUDY,180.0,s4,1,65,75.0,-1,,1,sell,0,sell,0.5,0,0,0,block 4 (G second),22.0,12.0,Male,1.0,1.0,1.0,"[4, 'block 4 (G second)']",1,1,1,0.0,6.0,-0.4,0.18181818181818182,1.0,0.0,,4,0.75,0.5,Design 1,Design 1,"Have an option between Design #1 and Design #2,",3.0,,
524,2656,4,Player object (1152),sell,2023-03-08 08:30:39.244276+00:00,"{""priceA"": 50, ""sharesA"": 0, ""secs_since_round_starts"": 131, ""market"": ""A""}",135.0,24.0,11.0,5ymfsw49,vmu7c279,FULL STUDY,180.0,s4,1,50,65.0,1,-15.0,1,buy,0,sell,0.5,0,0,0,block 4 (G second),22.0,12.0,Male,1.0,1.0,1.0,"[4, 'block 4 (G second)']",1,1,1,0.0,6.0,-0.4,0.18181818181818182,1.0,0.0,,4,0.75,0.5,Design 1,Design 1,"Have an option between Design #1 and Design #2,",3.0,,
525,2657,4,Player object (1152),buy,2023-03-08 08:30:56.021393+00:00,"{""priceA"": 45, ""sharesA"": 1, ""secs_since_round_starts"": 148, ""market"": ""A""}",90.0,27.0,12.0,5ymfsw49,vmu7c279,FULL STUDY,180.0,s4,1,45,50.0,-1,,1,sell,0,sell,0.5,0,0,0,block 4 (G second),22.0,12.0,Male,1.0,1.0,1.0,"[4, 'block 4 (G second)']",1,1,1,0.0,6.0,-0.4,0.18181818181818182,1.0,0.0,,4,0.75,0.5,Design 1,Design 1,"Have an option between Design #1 and Design #2,",3.0,,
526,2659,4,Player object (1152),sell,2023-03-08 08:31:30.497588+00:00,"{""priceA"": 45, ""sharesA"": 0, ""secs_since_round_starts"": 183, ""market"": ""A""}",135.0,32.0,13.0,5ymfsw49,vmu7c279,FULL STUDY,180.0,s4,1,45,45.0,1,0.0,1,buy,0,sell,0.5,0,0,0,block 4 (G second),22.0,12.0,Male,1.0,1.0,1.0,"[4, 'block 4 (G second)']",1,1,1,0.0,6.0,-0.4,0.18181818181818182,1.0,0.0,,4,0.75,0.5,Design 1,Design 1,"Have an option between Design #1 and Design #2,",3.0,,
527,2660,4,Player object (1152),buy,2023-03-08 08:31:34.324701+00:00,"{""priceA"": 60, ""sharesA"": 1, ""secs_since_round_starts"": 186, ""market"": ""A""}",75.0,33.0,14.0,5ymfsw49,vmu7c279,FULL STUDY,180.0,s4,1,60,45.0,-1,,1,sell,0,sell,0.5,0,0,0,block 4 (G second),22.0,12.0,Male,1.0,1.0,1.0,"[4, 'block 4 (G second)']",1,1,1,0.0,6.0,-0.4,0.18181818181818182,1.0,0.0,,4,0.75,0.5,Design 1,Design 1,"Have an option between Design #1 and Design #2,",3.0,,
528,2661,4,Player object (1152),sell,2023-03-08 08:31:56.233739+00:00,"{""priceA"": 85, ""sharesA"": 0, ""secs_since_round_starts"": 208, ""market"": ""A""}",160.0,37.0,15.0,5ymfsw49,vmu7c279,FULL STUDY,180.0,s4,1,85,60.0,1,25.0,1,buy,0,sell,0.5,0,0,0,block 4 (G second),22.0,12.0,Male,1.0,1.0,1.0,"[4, 'block 4 (G second)']",1,1,1,0.0,6.0,-0.4,0.18181818181818182,1.0,0.0,,4,0.75,0.5,Design 1,Design 1,"Have an option between Design #1 and Design #2,",3.0,,
529,2662,4,Player object (1152),buy,2023-03-08 08:32:01.594670+00:00,"{""priceA"": 90, ""sharesA"": 1, ""secs_since_round_starts"": 214, ""market"": ""A""}",70.0,38.0,16.0,5ymfsw49,vmu7c279,FULL STUDY,180.0,s4,1,90,85.0,-1,,1,sell,0,sell,0.5,0,0,0,block 4 (G second),22.0,12.0,Male,1.0,1.0,1.0,"[4, 'block 4 (G second)']",1,1,1,0.0,6.0,-0.4,0.18181818181818182,1.0,0.0,,4,0.75,0.5,Design 1,Design 1,"Have an option between Design #1 and Design #2,",3.0,,
530,2663,4,Player object (1152),sell,2023-03-08 08:32:07.386612+00:00,"{""priceA"": 85, ""sharesA"": 0, ""secs_since_round_starts"": 220, ""market"": ""A""}",155.0,39.0,17.0,5ymfsw49,vmu7c279,FULL STUDY,180.0,s4,1,85,90.0,1,-5.0,1,buy,0,sell,0.5,0,0,0,block 4 (G second),22.0,12.0,Male,1.0,1.0,1.0,"[4, 'block 4 (G second)']",1,1,1,0.0,6.0,-0.4,0.18181818181818182,1.0,0.0,,4,0.75,0.5,Design 1,Design 1,"Have an option between Design #1 and Design #2,",3.0,,
531,2664,4,Player object (1152),buy,2023-03-08 08:32:12.623185+00:00,"{""priceA"": 90, ""sharesA"": 1, ""secs_since_round_starts"": 225, ""market"": ""A""}",65.0,40.0,18.0,5ymfsw49,vmu7c279,FULL STUDY,180.0,s4,1,90,85.0,-1,,1,sell,0,sell,0.5,0,0,0,block 4 (G second),22.0,12.0,Male,1.0,1.0,1.0,"[4, 'block 4 (G second)']",1,1,1,0.0,6.0,-0.4,0.18181818181818182,1.0,0.0,,4,0.75,0.5,Design 1,Design 1,"Have an option between Design #1 and Design #2,",3.0,,
532,2665,4,Player object (1152),sell,2023-03-08 08:32:18.155313+00:00,"{""priceA"": 80, ""sharesA"": 0, ""secs_since_round_starts"": 230, ""market"": ""A""}",145.0,41.0,19.0,5ymfsw49,vmu7c279,FULL STUDY,180.0,s4,1,80,90.0,1,-10.0,1,buy,0,sell,0.5,0,0,0,block 4 (G second),22.0,12.0,Male,1.0,1.0,1.0,"[4, 'block 4 (G second)']",1,1,1,0.0,6.0,-0.4,0.18181818181818182,1.0,0.0,,4,0.75,0.5,Design 1,Design 1,"Have an option between Design #1 and Design #2,",3.0,,
533,2666,4,Player object (1152),buy,2023-03-08 08:32:23.798931+00:00,"{""priceA"": 90, ""sharesA"": 1, ""secs_since_round_starts"": 236, ""market"": ""A""}",55.0,42.0,20.0,5ymfsw49,vmu7c279,FULL STUDY,180.0,s4,1,90,80.0,-1,,1,sell,0,sell,0.5,0,0,0,block 4 (G second),22.0,12.0,Male,1.0,1.0,1.0,"[4, 'block 4 (G second)']",1,1,1,0.0,6.0,-0.4,0.18181818181818182,1.0,0.0,,4,0.75,0.5,Design 1,Design 1,"Have an option between Design #1 and Design #2,",3.0,,
534,2667,4,Player object (1152),sell,2023-03-08 08:32:34.919598+00:00,"{""priceA"": 100, ""sharesA"": 0, ""secs_since_round_starts"": 247, ""market"": ""A""}",155.0,44.0,21.0,5ymfsw49,vmu7c279,FULL STUDY,180.0,s4,1,100,90.0,1,10.0,1,buy,0,sell,0.5,0,0,0,block 4 (G second),22.0,12.0,Male,1.0,1.0,1.0,"[4, 'block 4 (G second)']",1,1,1,0.0,6.0,-0.4,0.18181818181818182,1.0,0.0,,4,0.75,0.5,Design 1,Design 1,"Have an option between Design #1 and Design #2,",3.0,,
535,2668,4,Player object (1152),buy,2023-03-08 08:32:40.176390+00:00,"{""priceA"": 110, ""sharesA"": 1, ""secs_since_round_starts"": 252, ""market"": ""A""}",45.0,45.0,22.0,5ymfsw49,vmu7c279,FULL STUDY,180.0,s4,1,110,100.0,-1,,1,sell,0,sell,0.5,0,0,0,block 4 (G second),22.0,12.0,Male,1.0,1.0,1.0,"[4, 'block 4 (G second)']",1,1,1,0.0,6.0,-0.4,0.18181818181818182,1.0,0.0,,4,0.75,0.5,Design 1,Design 1,"Have an option between Design #1 and Design #2,",3.0,,
536,2669,4,Player object (1152),sell,2023-03-08 08:32:46.093587+00:00,"{""priceA"": 100, ""sharesA"": 0, ""secs_since_round_starts"": 258, ""market"": ""A""}",145.0,46.0,23.0,5ymfsw49,vmu7c279,FULL STUDY,180.0,s4,1,100,110.0,1,-10.0,1,buy,0,sell,0.5,0,0,0,block 4 (G second),22.0,12.0,Male,1.0,1.0,1.0,"[4, 'block 4 (G second)']",1,1,1,0.0,6.0,-0.4,0.18181818181818182,1.0,0.0,,4,0.75,0.5,Design 1,Design 1,"Have an option between Design #1 and Design #2,",3.0,,
537,2670,4,Player object (1152),buy,2023-03-08 08:32:51.316074+00:00,"{""priceA"": 110, ""sharesA"": 1, ""secs_since_round_starts"": 263, ""market"": ""A""}",35.0,47.0,24.0,5ymfsw49,vmu7c279,FULL STUDY,180.0,s4,1,110,100.0,-1,,1,sell,0,sell,0.5,0,0,0,block 4 (G second),22.0,12.0,Male,1.0,1.0,1.0,"[4, 'block 4 (G second)']",1,1,1,0.0,6.0,-0.4,0.18181818181818182,1.0,0.0,,4,0.75,0.5,Design 1,Design 1,"Have an option between Design #1 and Design #2,",3.0,,
538,2671,4,Player object (1152),sell,2023-03-08 08:33:13.341351+00:00,"{""priceA"": 130, ""sharesA"": 0, ""secs_since_round_starts"": 285, ""market"": ""A""}",165.0,51.0,25.0,5ymfsw49,vmu7c279,FULL STUDY,180.0,s4,1,130,110.0,1,20.0,1,buy,0,sell,0.5,0,0,0,block 4 (G second),22.0,12.0,Male,1.0,1.0,1.0,"[4, 'block 4 (G second)']",1,1,1,0.0,6.0,-0.4,0.18181818181818182,1.0,0.0,,4,0.75,0.5,Design 1,Design 1,"Have an option between Design #1 and Design #2,",3.0,,
539,2672,4,Player object (1152),buy,2023-03-08 08:33:29.693354+00:00,"{""priceA"": 130, ""sharesA"": 1, ""secs_since_round_starts"": 302, ""market"": ""A""}",35.0,54.0,26.0,5ymfsw49,vmu7c279,FULL STUDY,180.0,s4,1,130,130.0,-1,,1,sell,0,sell,0.5,0,0,0,block 4 (G second),22.0,12.0,Male,1.0,1.0,1.0,"[4, 'block 4 (G second)']",1,1,1,0.0,6.0,-0.4,0.18181818181818182,1.0,0.0,,4,0.75,0.5,Design 1,Design 1,"Have an option between Design #1 and Design #2,",3.0,,
540,2673,4,Player object (1152),sell,2023-03-08 08:33:41.193443+00:00,"{""priceA"": 120, ""sharesA"": 0, ""secs_since_round_starts"": 313, ""market"": ""A""}",155.0,56.0,27.0,5ymfsw49,vmu7c279,FULL STUDY,180.0,s4,1,120,130.0,1,-10.0,1,buy,0,sell,0.5,0,0,0,block 4 (G second),22.0,12.0,Male,1.0,1.0,1.0,"[4, 'block 4 (G second)']",1,1,1,0.0,6.0,-0.4,0.18181818181818182,1.0,0.0,,4,0.75,0.5,Design 1,Design 1,"Have an option between Design #1 and Design #2,",3.0,,
541,2674,4,Player object (1152),buy,2023-03-08 08:33:46.390252+00:00,"{""priceA"": 135, ""sharesA"": 1, ""secs_since_round_starts"": 318, ""market"": ""A""}",20.0,57.0,28.0,5ymfsw49,vmu7c279,FULL STUDY,180.0,s4,1,135,120.0,-1,,1,sell,0,sell,0.5,0,0,0,block 4 (G second),22.0,12.0,Male,1.0,1.0,1.0,"[4, 'block 4 (G second)']",1,1,1,0.0,6.0,-0.4,0.18181818181818182,1.0,0.0,,4,0.75,0.5,Design 1,Design 1,"Have an option between Design #1 and Design #2,",3.0,,
542,2678,5,Player object (1272),sell,2023-03-08 08:34:54.025401+00:00,"{""priceA"": 125, ""sharesA"": 0, ""secs_since_round_starts"": 34, ""market"": ""A""}",175.0,7.0,1.0,5ymfsw49,vmu7c279,FULL STUDY,80.0,s4,1,125,,1,,1,,0,sell,0.5,0,0,0,block 4 (G second),22.0,12.0,Male,1.0,1.0,1.0,"[5, 'block 4 (G second)']",1,0,1,0.0,6.0,-0.4,0.2857142857142857,1.0,0.0,,2,0.75,0.5,Design 1,Design 1,"Have an option between Design #1 and Design #2,",3.0,,
543,2679,5,Player object (1272),buy,2023-03-08 08:34:59.377197+00:00,"{""priceA"": 135, ""sharesA"": 1, ""secs_since_round_starts"": 39, ""market"": ""A""}",40.0,8.0,2.0,5ymfsw49,vmu7c279,FULL STUDY,80.0,s4,1,135,125.0,-1,,1,sell,0,sell,0.5,0,0,0,block 4 (G second),22.0,12.0,Male,1.0,1.0,1.0,"[5, 'block 4 (G second)']",1,0,1,0.0,6.0,-0.4,0.2857142857142857,1.0,0.0,,2,0.75,0.5,Design 1,Design 1,"Have an option between Design #1 and Design #2,",3.0,,
544,2680,5,Player object (1272),sell,2023-03-08 08:35:04.961751+00:00,"{""priceA"": 120, ""sharesA"": 0, ""secs_since_round_starts"": 45, ""market"": ""A""}",160.0,9.0,3.0,5ymfsw49,vmu7c279,FULL STUDY,80.0,s4,1,120,135.0,1,-15.0,1,buy,0,sell,0.5,0,0,0,block 4 (G second),22.0,12.0,Male,1.0,1.0,1.0,"[5, 'block 4 (G second)']",1,0,1,0.0,6.0,-0.4,0.2857142857142857,1.0,0.0,,2,0.75,0.5,Design 1,Design 1,"Have an option between Design #1 and Design #2,",3.0,,
545,2681,5,Player object (1272),buy,2023-03-08 08:35:10.367005+00:00,"{""priceA"": 135, ""sharesA"": 1, ""secs_since_round_starts"": 50, ""market"": ""A""}",25.0,10.0,4.0,5ymfsw49,vmu7c279,FULL STUDY,80.0,s4,1,135,120.0,-1,,1,sell,0,sell,0.5,0,0,0,block 4 (G second),22.0,12.0,Male,1.0,1.0,1.0,"[5, 'block 4 (G second)']",1,0,1,0.0,6.0,-0.4,0.2857142857142857,1.0,0.0,,2,0.75,0.5,Design 1,Design 1,"Have an option between Design #1 and Design #2,",3.0,,
546,2682,5,Player object (1272),sell,2023-03-08 08:35:16.092681+00:00,"{""priceA"": 130, ""sharesA"": 0, ""secs_since_round_starts"": 56, ""market"": ""A""}",155.0,11.0,5.0,5ymfsw49,vmu7c279,FULL STUDY,80.0,s4,1,130,135.0,1,-5.0,1,buy,0,sell,0.5,0,0,0,block 4 (G second),22.0,12.0,Male,1.0,1.0,1.0,"[5, 'block 4 (G second)']",1,0,1,0.0,6.0,-0.4,0.2857142857142857,1.0,0.0,,2,0.75,0.5,Design 1,Design 1,"Have an option between Design #1 and Design #2,",3.0,,
547,2683,5,Player object (1272),buy,2023-03-08 08:35:27.048225+00:00,"{""priceA"": 135, ""sharesA"": 1, ""secs_since_round_starts"": 67, ""market"": ""A""}",20.0,13.0,6.0,5ymfsw49,vmu7c279,FULL STUDY,80.0,s4,1,135,130.0,-1,,1,sell,0,sell,0.5,0,0,0,block 4 (G second),22.0,12.0,Male,1.0,1.0,1.0,"[5, 'block 4 (G second)']",1,0,1,0.0,6.0,-0.4,0.2857142857142857,1.0,0.0,,2,0.75,0.5,Design 1,Design 1,"Have an option between Design #1 and Design #2,",3.0,,
548,2684,5,Player object (1272),sell,2023-03-08 08:35:43.745807+00:00,"{""priceA"": 140, ""sharesA"": 0, ""secs_since_round_starts"": 83, ""market"": ""A""}",160.0,16.0,7.0,5ymfsw49,vmu7c279,FULL STUDY,80.0,s4,1,140,135.0,1,5.0,1,buy,0,sell,0.5,0,0,0,block 4 (G second),22.0,12.0,Male,1.0,1.0,1.0,"[5, 'block 4 (G second)']",1,0,1,0.0,6.0,-0.4,0.2857142857142857,1.0,0.0,,2,0.75,0.5,Design 1,Design 1,"Have an option between Design #1 and Design #2,",3.0,,
549,2685,5,Player object (1272),buy,2023-03-08 08:36:05.712911+00:00,"{""priceA"": 115, ""sharesA"": 1, ""secs_since_round_starts"": 105, ""market"": ""A""}",45.0,20.0,8.0,5ymfsw49,vmu7c279,FULL STUDY,80.0,s4,1,115,140.0,-1,,1,sell,0,sell,0.5,0,0,0,block 4 (G second),22.0,12.0,Male,1.0,1.0,1.0,"[5, 'block 4 (G second)']",1,0,1,0.0,6.0,-0.4,0.2857142857142857,1.0,0.0,,2,0.75,0.5,Design 1,Design 1,"Have an option between Design #1 and Design #2,",3.0,,
550,2686,5,Player object (1272),sell,2023-03-08 08:36:33.405875+00:00,"{""priceA"": 150, ""sharesA"": 0, ""secs_since_round_starts"": 133, ""market"": ""A""}",195.0,25.0,9.0,5ymfsw49,vmu7c279,FULL STUDY,80.0,s4,1,150,115.0,1,35.0,1,buy,0,sell,0.5,0,0,0,block 4 (G second),22.0,12.0,Male,1.0,1.0,1.0,"[5, 'block 4 (G second)']",1,0,1,0.0,6.0,-0.4,0.2857142857142857,1.0,0.0,,2,0.75,0.5,Design 1,Design 1,"Have an option between Design #1 and Design #2,",3.0,,
551,2687,5,Player object (1272),buy,2023-03-08 08:36:44.395607+00:00,"{""priceA"": 145, ""sharesA"": 1, ""secs_since_round_starts"": 144, ""market"": ""A""}",50.0,27.0,10.0,5ymfsw49,vmu7c279,FULL STUDY,80.0,s4,1,145,150.0,-1,,1,sell,0,sell,0.5,0,0,0,block 4 (G second),22.0,12.0,Male,1.0,1.0,1.0,"[5, 'block 4 (G second)']",1,0,1,0.0,6.0,-0.4,0.2857142857142857,1.0,0.0,,2,0.75,0.5,Design 1,Design 1,"Have an option between Design #1 and Design #2,",3.0,,
552,2688,5,Player object (1272),sell,2023-03-08 08:36:49.829982+00:00,"{""priceA"": 140, ""sharesA"": 0, ""secs_since_round_starts"": 149, ""market"": ""A""}",190.0,28.0,11.0,5ymfsw49,vmu7c279,FULL STUDY,80.0,s4,1,140,145.0,1,-5.0,1,buy,0,sell,0.5,0,0,0,block 4 (G second),22.0,12.0,Male,1.0,1.0,1.0,"[5, 'block 4 (G second)']",1,0,1,0.0,6.0,-0.4,0.2857142857142857,1.0,0.0,,2,0.75,0.5,Design 1,Design 1,"Have an option between Design #1 and Design #2,",3.0,,
553,2690,5,Player object (1272),buy,2023-03-08 08:37:19.793182+00:00,"{""priceA"": 140, ""sharesA"": 1, ""secs_since_round_starts"": 179, ""market"": ""A""}",50.0,32.0,12.0,5ymfsw49,vmu7c279,FULL STUDY,80.0,s4,1,140,140.0,-1,,1,sell,0,sell,0.5,0,0,0,block 4 (G second),22.0,12.0,Male,1.0,1.0,1.0,"[5, 'block 4 (G second)']",1,0,1,0.0,6.0,-0.4,0.2857142857142857,1.0,0.0,,2,0.75,0.5,Design 1,Design 1,"Have an option between Design #1 and Design #2,",3.0,,
554,2691,5,Player object (1272),sell,2023-03-08 08:37:23.358857+00:00,"{""priceA"": 125, ""sharesA"": 0, ""secs_since_round_starts"": 183, ""market"": ""A""}",175.0,33.0,13.0,5ymfsw49,vmu7c279,FULL STUDY,80.0,s4,1,125,140.0,1,-15.0,1,buy,0,sell,0.5,0,0,0,block 4 (G second),22.0,12.0,Male,1.0,1.0,1.0,"[5, 'block 4 (G second)']",1,0,1,0.0,6.0,-0.4,0.2857142857142857,1.0,0.0,,2,0.75,0.5,Design 1,Design 1,"Have an option between Design #1 and Design #2,",3.0,,
555,2692,5,Player object (1272),buy,2023-03-08 08:37:28.852429+00:00,"{""priceA"": 140, ""sharesA"": 1, ""secs_since_round_starts"": 188, ""market"": ""A""}",35.0,34.0,14.0,5ymfsw49,vmu7c279,FULL STUDY,80.0,s4,1,140,125.0,-1,,1,sell,0,sell,0.5,0,0,0,block 4 (G second),22.0,12.0,Male,1.0,1.0,1.0,"[5, 'block 4 (G second)']",1,0,1,0.0,6.0,-0.4,0.2857142857142857,1.0,0.0,,2,0.75,0.5,Design 1,Design 1,"Have an option between Design #1 and Design #2,",3.0,,
556,2693,5,Player object (1272),sell,2023-03-08 08:37:34.192044+00:00,"{""priceA"": 125, ""sharesA"": 0, ""secs_since_round_starts"": 194, ""market"": ""A""}",160.0,35.0,15.0,5ymfsw49,vmu7c279,FULL STUDY,80.0,s4,1,125,140.0,1,-15.0,1,buy,0,sell,0.5,0,0,0,block 4 (G second),22.0,12.0,Male,1.0,1.0,1.0,"[5, 'block 4 (G second)']",1,0,1,0.0,6.0,-0.4,0.2857142857142857,1.0,0.0,,2,0.75,0.5,Design 1,Design 1,"Have an option between Design #1 and Design #2,",3.0,,
557,2694,5,Player object (1272),buy,2023-03-08 08:37:40.158127+00:00,"{""priceA"": 140, ""sharesA"": 1, ""secs_since_round_starts"": 200, ""market"": ""A""}",20.0,36.0,16.0,5ymfsw49,vmu7c279,FULL STUDY,80.0,s4,1,140,125.0,-1,,1,sell,0,sell,0.5,0,0,0,block 4 (G second),22.0,12.0,Male,1.0,1.0,1.0,"[5, 'block 4 (G second)']",1,0,1,0.0,6.0,-0.4,0.2857142857142857,1.0,0.0,,2,0.75,0.5,Design 1,Design 1,"Have an option between Design #1 and Design #2,",3.0,,
558,2695,5,Player object (1272),sell,2023-03-08 08:37:45.966083+00:00,"{""priceA"": 135, ""sharesA"": 0, ""secs_since_round_starts"": 206, ""market"": ""A""}",155.0,37.0,17.0,5ymfsw49,vmu7c279,FULL STUDY,80.0,s4,1,135,140.0,1,-5.0,1,buy,0,sell,0.5,0,0,0,block 4 (G second),22.0,12.0,Male,1.0,1.0,1.0,"[5, 'block 4 (G second)']",1,0,1,0.0,6.0,-0.4,0.2857142857142857,1.0,0.0,,2,0.75,0.5,Design 1,Design 1,"Have an option between Design #1 and Design #2,",3.0,,
559,2696,5,Player object (1272),buy,2023-03-08 08:37:56.358792+00:00,"{""priceA"": 135, ""sharesA"": 1, ""secs_since_round_starts"": 216, ""market"": ""A""}",20.0,39.0,18.0,5ymfsw49,vmu7c279,FULL STUDY,80.0,s4,1,135,135.0,-1,,1,sell,0,sell,0.5,0,0,0,block 4 (G second),22.0,12.0,Male,1.0,1.0,1.0,"[5, 'block 4 (G second)']",1,0,1,0.0,6.0,-0.4,0.2857142857142857,1.0,0.0,,2,0.75,0.5,Design 1,Design 1,"Have an option between Design #1 and Design #2,",3.0,,
560,2697,5,Player object (1272),sell,2023-03-08 08:38:01.929492+00:00,"{""priceA"": 125, ""sharesA"": 0, ""secs_since_round_starts"": 222, ""market"": ""A""}",145.0,40.0,19.0,5ymfsw49,vmu7c279,FULL STUDY,80.0,s4,1,125,135.0,1,-10.0,1,buy,0,sell,0.5,0,0,0,block 4 (G second),22.0,12.0,Male,1.0,1.0,1.0,"[5, 'block 4 (G second)']",1,0,1,0.0,6.0,-0.4,0.2857142857142857,1.0,0.0,,2,0.75,0.5,Design 1,Design 1,"Have an option between Design #1 and Design #2,",3.0,,
561,2698,5,Player object (1272),buy,2023-03-08 08:38:14.460656+00:00,"{""priceA"": 130, ""sharesA"": 1, ""secs_since_round_starts"": 234, ""market"": ""A""}",15.0,42.0,20.0,5ymfsw49,vmu7c279,FULL STUDY,80.0,s4,1,130,125.0,-1,,1,sell,0,sell,0.5,0,0,0,block 4 (G second),22.0,12.0,Male,1.0,1.0,1.0,"[5, 'block 4 (G second)']",1,0,1,0.0,6.0,-0.4,0.2857142857142857,1.0,0.0,,2,0.75,0.5,Design 1,Design 1,"Have an option between Design #1 and Design #2,",3.0,,
562,2699,5,Player object (1272),sell,2023-03-08 08:38:18.322188+00:00,"{""priceA"": 115, ""sharesA"": 0, ""secs_since_round_starts"": 238, ""market"": ""A""}",130.0,43.0,21.0,5ymfsw49,vmu7c279,FULL STUDY,80.0,s4,1,115,130.0,1,-15.0,1,buy,0,sell,0.5,0,0,0,block 4 (G second),22.0,12.0,Male,1.0,1.0,1.0,"[5, 'block 4 (G second)']",1,0,1,0.0,6.0,-0.4,0.2857142857142857,1.0,0.0,,2,0.75,0.5,Design 1,Design 1,"Have an option between Design #1 and Design #2,",3.0,,
563,2700,5,Player object (1272),buy,2023-03-08 08:38:24.190750+00:00,"{""priceA"": 125, ""sharesA"": 1, ""secs_since_round_starts"": 244, ""market"": ""A""}",5.0,44.0,22.0,5ymfsw49,vmu7c279,FULL STUDY,80.0,s4,1,125,115.0,-1,,1,sell,0,sell,0.5,0,0,0,block 4 (G second),22.0,12.0,Male,1.0,1.0,1.0,"[5, 'block 4 (G second)']",1,0,1,0.0,6.0,-0.4,0.2857142857142857,1.0,0.0,,2,0.75,0.5,Design 1,Design 1,"Have an option between Design #1 and Design #2,",3.0,,
564,2701,5,Player object (1272),sell,2023-03-08 08:38:29.389349+00:00,"{""priceA"": 120, ""sharesA"": 0, ""secs_since_round_starts"": 249, ""market"": ""A""}",125.0,45.0,23.0,5ymfsw49,vmu7c279,FULL STUDY,80.0,s4,1,120,125.0,1,-5.0,1,buy,0,sell,0.5,0,0,0,block 4 (G second),22.0,12.0,Male,1.0,1.0,1.0,"[5, 'block 4 (G second)']",1,0,1,0.0,6.0,-0.4,0.2857142857142857,1.0,0.0,,2,0.75,0.5,Design 1,Design 1,"Have an option between Design #1 and Design #2,",3.0,,
565,2702,5,Player object (1272),buy,2023-03-08 08:38:35.214238+00:00,"{""priceA"": 130, ""sharesA"": 1, ""secs_since_round_starts"": 255, ""market"": ""A""}",-5.0,46.0,24.0,5ymfsw49,vmu7c279,FULL STUDY,80.0,s4,1,130,120.0,-1,,1,sell,0,sell,0.5,0,0,0,block 4 (G second),22.0,12.0,Male,1.0,1.0,1.0,"[5, 'block 4 (G second)']",1,0,1,0.0,6.0,-0.4,0.2857142857142857,1.0,0.0,,2,0.75,0.5,Design 1,Design 1,"Have an option between Design #1 and Design #2,",3.0,,
566,2703,5,Player object (1272),sell,2023-03-08 08:38:40.530087+00:00,"{""priceA"": 115, ""sharesA"": 0, ""secs_since_round_starts"": 260, ""market"": ""A""}",110.0,47.0,25.0,5ymfsw49,vmu7c279,FULL STUDY,80.0,s4,1,115,130.0,1,-15.0,1,buy,0,sell,0.5,0,0,0,block 4 (G second),22.0,12.0,Male,1.0,1.0,1.0,"[5, 'block 4 (G second)']",1,0,1,0.0,6.0,-0.4,0.2857142857142857,1.0,0.0,,2,0.75,0.5,Design 1,Design 1,"Have an option between Design #1 and Design #2,",3.0,,
567,2704,5,Player object (1272),buy,2023-03-08 08:38:56.956189+00:00,"{""priceA"": 105, ""sharesA"": 1, ""secs_since_round_starts"": 277, ""market"": ""A""}",5.0,50.0,26.0,5ymfsw49,vmu7c279,FULL STUDY,80.0,s4,1,105,115.0,-1,,1,sell,0,sell,0.5,0,0,0,block 4 (G second),22.0,12.0,Male,1.0,1.0,1.0,"[5, 'block 4 (G second)']",1,0,1,0.0,6.0,-0.4,0.2857142857142857,1.0,0.0,,2,0.75,0.5,Design 1,Design 1,"Have an option between Design #1 and Design #2,",3.0,,
568,2705,5,Player object (1272),sell,2023-03-08 08:39:04.639391+00:00,"{""priceA"": 100, ""sharesA"": 0, ""secs_since_round_starts"": 284, ""market"": ""A""}",105.0,51.0,27.0,5ymfsw49,vmu7c279,FULL STUDY,80.0,s4,1,100,105.0,1,-5.0,1,buy,0,sell,0.5,0,0,0,block 4 (G second),22.0,12.0,Male,1.0,1.0,1.0,"[5, 'block 4 (G second)']",1,0,1,0.0,6.0,-0.4,0.2857142857142857,1.0,0.0,,2,0.75,0.5,Design 1,Design 1,"Have an option between Design #1 and Design #2,",3.0,,
569,2706,5,Player object (1272),buy,2023-03-08 08:39:07.971057+00:00,"{""priceA"": 115, ""sharesA"": 1, ""secs_since_round_starts"": 288, ""market"": ""A""}",-10.0,52.0,28.0,5ymfsw49,vmu7c279,FULL STUDY,80.0,s4,1,115,100.0,-1,,1,sell,0,sell,0.5,0,0,0,block 4 (G second),22.0,12.0,Male,1.0,1.0,1.0,"[5, 'block 4 (G second)']",1,0,1,0.0,6.0,-0.4,0.2857142857142857,1.0,0.0,,2,0.75,0.5,Design 1,Design 1,"Have an option between Design #1 and Design #2,",3.0,,
570,2707,5,Player object (1272),sell,2023-03-08 08:39:13.622907+00:00,"{""priceA"": 100, ""sharesA"": 0, ""secs_since_round_starts"": 293, ""market"": ""A""}",90.0,53.0,29.0,5ymfsw49,vmu7c279,FULL STUDY,80.0,s4,1,100,115.0,1,-15.0,1,buy,0,sell,0.5,0,0,0,block 4 (G second),22.0,12.0,Male,1.0,1.0,1.0,"[5, 'block 4 (G second)']",1,0,1,0.0,6.0,-0.4,0.2857142857142857,1.0,0.0,,2,0.75,0.5,Design 1,Design 1,"Have an option between Design #1 and Design #2,",3.0,,
571,2708,5,Player object (1272),buy,2023-03-08 08:39:19.169436+00:00,"{""priceA"": 105, ""sharesA"": 1, ""secs_since_round_starts"": 299, ""market"": ""A""}",-15.0,54.0,30.0,5ymfsw49,vmu7c279,FULL STUDY,80.0,s4,1,105,100.0,-1,,1,sell,0,sell,0.5,0,0,0,block 4 (G second),22.0,12.0,Male,1.0,1.0,1.0,"[5, 'block 4 (G second)']",1,0,1,0.0,6.0,-0.4,0.2857142857142857,1.0,0.0,,2,0.75,0.5,Design 1,Design 1,"Have an option between Design #1 and Design #2,",3.0,,
572,2709,5,Player object (1272),sell,2023-03-08 08:39:24.659948+00:00,"{""priceA"": 90, ""sharesA"": 0, ""secs_since_round_starts"": 304, ""market"": ""A""}",75.0,55.0,31.0,5ymfsw49,vmu7c279,FULL STUDY,80.0,s4,1,90,105.0,1,-15.0,1,buy,0,sell,0.5,0,0,0,block 4 (G second),22.0,12.0,Male,1.0,1.0,1.0,"[5, 'block 4 (G second)']",1,0,1,0.0,6.0,-0.4,0.2857142857142857,1.0,0.0,,2,0.75,0.5,Design 1,Design 1,"Have an option between Design #1 and Design #2,",3.0,,
573,2710,5,Player object (1272),buy,2023-03-08 08:39:35.933249+00:00,"{""priceA"": 90, ""sharesA"": 1, ""secs_since_round_starts"": 316, ""market"": ""A""}",-15.0,57.0,32.0,5ymfsw49,vmu7c279,FULL STUDY,80.0,s4,1,90,90.0,-1,,1,sell,0,sell,0.5,0,0,0,block 4 (G second),22.0,12.0,Male,1.0,1.0,1.0,"[5, 'block 4 (G second)']",1,0,1,0.0,6.0,-0.4,0.2857142857142857,1.0,0.0,,2,0.75,0.5,Design 1,Design 1,"Have an option between Design #1 and Design #2,",3.0,,
574,2711,5,Player object (1272),sell,2023-03-08 08:39:52.204192+00:00,"{""priceA"": 95, ""sharesA"": 0, ""secs_since_round_starts"": 332, ""market"": ""A""}",80.0,60.0,33.0,5ymfsw49,vmu7c279,FULL STUDY,80.0,s4,1,95,90.0,1,5.0,1,buy,0,sell,0.5,0,0,0,block 4 (G second),22.0,12.0,Male,1.0,1.0,1.0,"[5, 'block 4 (G second)']",1,0,1,0.0,6.0,-0.4,0.2857142857142857,1.0,0.0,,2,0.75,0.5,Design 1,Design 1,"Have an option between Design #1 and Design #2,",3.0,,
575,1656,2,Player object (886),sell,2023-03-07 04:07:09.412026+00:00,"{""priceA"": 120, ""sharesA"": 0, ""secs_since_round_starts"": 92, ""market"": ""A""}",170.0,15.0,1.0,7eu86eyg,vmu7c279,FULL STUDY,200.0,s2,1,120,,1,,1,,0,sell,0.5761373211134116,16,0,0,block 4 (G second),22.0,12.0,Male,1.0,0.0,1.0,"[2, 'block 4 (G second)']",0,1,1,0.0,5.0,-0.5,0.36363636363636365,0.0,0.0,0.0,4,1.0,0.75,Design 1,Design 2,"Have an option between Design #1 and Design #2,",3.0,,
576,1657,2,Player object (886),buy,2023-03-07 04:08:07.528466+00:00,"{""priceA"": 140, ""sharesA"": 1, ""secs_since_round_starts"": 150, ""market"": ""A""}",30.0,26.0,2.0,7eu86eyg,vmu7c279,FULL STUDY,200.0,s2,1,140,120.0,-1,,1,sell,0,sell,0.4855198313469848,16,0,0,block 4 (G second),22.0,12.0,Male,1.0,0.0,1.0,"[2, 'block 4 (G second)']",0,1,1,0.0,5.0,-0.5,0.36363636363636365,0.0,0.0,0.0,4,1.0,0.75,Design 1,Design 2,"Have an option between Design #1 and Design #2,",3.0,,
577,1659,2,Player object (886),sell,2023-03-07 04:09:12.136957+00:00,"{""priceA"": 145, ""sharesA"": 0, ""secs_since_round_starts"": 215, ""market"": ""A""}",175.0,37.0,3.0,7eu86eyg,vmu7c279,FULL STUDY,200.0,s2,1,145,140.0,1,5.0,1,buy,0,sell,0.494384744736363,16,0,0,block 4 (G second),22.0,12.0,Male,1.0,0.0,1.0,"[2, 'block 4 (G second)']",0,1,1,0.0,5.0,-0.5,0.36363636363636365,0.0,0.0,0.0,4,1.0,0.75,Design 1,Design 2,"Have an option between Design #1 and Design #2,",3.0,,
578,1660,2,Player object (886),buy,2023-03-07 04:09:25.845518+00:00,"{""priceA"": 125, ""sharesA"": 1, ""secs_since_round_starts"": 228, ""market"": ""A""}",50.0,39.0,4.0,7eu86eyg,vmu7c279,FULL STUDY,200.0,s2,1,125,145.0,-1,,1,sell,0,sell,0.4382592777609274,16,1,0,block 4 (G second),22.0,12.0,Male,1.0,0.0,1.0,"[2, 'block 4 (G second)']",0,1,1,0.0,5.0,-0.5,0.36363636363636365,0.0,0.0,0.0,4,1.0,0.75,Design 1,Design 2,"Have an option between Design #1 and Design #2,",3.0,,
579,1661,2,Player object (886),sell,2023-03-07 04:09:29.379985+00:00,"{""priceA"": 140, ""sharesA"": 0, ""secs_since_round_starts"": 232, ""market"": ""A""}",190.0,40.0,5.0,7eu86eyg,vmu7c279,FULL STUDY,200.0,s2,1,140,125.0,1,15.0,1,buy,0,sell,0.4916787423410894,16,0,0,block 4 (G second),22.0,12.0,Male,1.0,0.0,1.0,"[2, 'block 4 (G second)']",0,1,1,0.0,5.0,-0.5,0.36363636363636365,0.0,0.0,0.0,4,1.0,0.75,Design 1,Design 2,"Have an option between Design #1 and Design #2,",3.0,,
580,1662,2,Player object (886),buy,2023-03-07 04:09:40.912249+00:00,"{""priceA"": 130, ""sharesA"": 1, ""secs_since_round_starts"": 243, ""market"": ""A""}",60.0,42.0,6.0,7eu86eyg,vmu7c279,FULL STUDY,200.0,s2,1,130,140.0,-1,,1,sell,0,sell,0.4369837361437204,16,0,0,block 4 (G second),22.0,12.0,Male,1.0,0.0,1.0,"[2, 'block 4 (G second)']",0,1,1,0.0,5.0,-0.5,0.36363636363636365,0.0,0.0,0.0,4,1.0,0.75,Design 1,Design 2,"Have an option between Design #1 and Design #2,",3.0,,
581,1663,2,Player object (886),sell,2023-03-07 04:09:56.658477+00:00,"{""priceA"": 140, ""sharesA"": 0, ""secs_since_round_starts"": 259, ""market"": ""A""}",200.0,45.0,7.0,7eu86eyg,vmu7c279,FULL STUDY,200.0,s2,1,140,130.0,1,10.0,1,buy,0,sell,0.5210834711709403,16,0,0,block 4 (G second),22.0,12.0,Male,1.0,0.0,1.0,"[2, 'block 4 (G second)']",0,1,1,0.0,5.0,-0.5,0.36363636363636365,0.0,0.0,0.0,4,1.0,0.75,Design 1,Design 2,"Have an option between Design #1 and Design #2,",3.0,,
582,1664,2,Player object (886),buy,2023-03-07 04:10:35.305722+00:00,"{""priceA"": 125, ""sharesA"": 1, ""secs_since_round_starts"": 298, ""market"": ""A""}",75.0,52.0,8.0,7eu86eyg,vmu7c279,FULL STUDY,200.0,s2,1,125,140.0,-1,,1,sell,0,sell,0.4439176376077041,16,1,0,block 4 (G second),22.0,12.0,Male,1.0,0.0,1.0,"[2, 'block 4 (G second)']",0,1,1,0.0,5.0,-0.5,0.36363636363636365,0.0,0.0,0.0,4,1.0,0.75,Design 1,Design 2,"Have an option between Design #1 and Design #2,",3.0,,
583,1668,3,Player object (1006),sell,2023-03-07 04:12:10.615784+00:00,"{""priceA"": 110, ""sharesA"": 0, ""secs_since_round_starts"": 42, ""market"": ""A""}",160.0,9.0,1.0,7eu86eyg,vmu7c279,FULL STUDY,195.0,s2,1,110,,1,,1,,0,sell,0.5389563723055646,19,0,0,block 4 (G second),22.0,12.0,Male,1.0,0.0,1.0,"[3, 'block 4 (G second)']",0,0,1,0.5,5.0,-0.5,0.6666666666666666,0.0,0.0,0.0,4,1.0,0.75,Design 1,Design 2,"Have an option between Design #1 and Design #2,",3.0,,
584,1669,3,Player object (1006),buy,2023-03-07 04:12:16.217039+00:00,"{""priceA"": 95, ""sharesA"": 1, ""secs_since_round_starts"": 48, ""market"": ""A""}",65.0,10.0,2.0,7eu86eyg,vmu7c279,FULL STUDY,195.0,s2,1,95,110.0,-1,,1,sell,0,sell,0.4922087569005138,19,0,0,block 4 (G second),22.0,12.0,Male,1.0,0.0,1.0,"[3, 'block 4 (G second)']",0,0,1,0.5,5.0,-0.5,0.6666666666666666,0.0,0.0,0.0,4,1.0,0.75,Design 1,Design 2,"Have an option between Design #1 and Design #2,",3.0,,
585,1670,3,Player object (1006),sell,2023-03-07 04:12:21.307413+00:00,"{""priceA"": 110, ""sharesA"": 0, ""secs_since_round_starts"": 53, ""market"": ""A""}",175.0,11.0,3.0,7eu86eyg,vmu7c279,FULL STUDY,195.0,s2,1,110,95.0,1,15.0,1,buy,0,sell,0.5295922419004607,19,0,0,block 4 (G second),22.0,12.0,Male,1.0,0.0,1.0,"[3, 'block 4 (G second)']",0,0,1,0.5,5.0,-0.5,0.6666666666666666,0.0,0.0,0.0,4,1.0,0.75,Design 1,Design 2,"Have an option between Design #1 and Design #2,",3.0,,
586,1671,3,Player object (1006),buy,2023-03-07 04:12:46.673096+00:00,"{""priceA"": 110, ""sharesA"": 1, ""secs_since_round_starts"": 78, ""market"": ""A""}",65.0,15.0,4.0,7eu86eyg,vmu7c279,FULL STUDY,195.0,s2,1,110,110.0,-1,,1,sell,0,sell,0.4763410641166328,19,0,0,block 4 (G second),22.0,12.0,Male,1.0,0.0,1.0,"[3, 'block 4 (G second)']",0,0,1,0.5,5.0,-0.5,0.6666666666666666,0.0,0.0,0.0,4,1.0,0.75,Design 1,Design 2,"Have an option between Design #1 and Design #2,",3.0,,
587,1672,3,Player object (1006),sell,2023-03-07 04:13:44.829006+00:00,"{""priceA"": 115, ""sharesA"": 0, ""secs_since_round_starts"": 137, ""market"": ""A""}",180.0,26.0,5.0,7eu86eyg,vmu7c279,FULL STUDY,195.0,s2,1,115,110.0,1,5.0,1,buy,0,sell,0.526172546586359,19,0,0,block 4 (G second),22.0,12.0,Male,1.0,0.0,1.0,"[3, 'block 4 (G second)']",0,0,1,0.5,5.0,-0.5,0.6666666666666666,0.0,0.0,0.0,4,1.0,0.75,Design 1,Design 2,"Have an option between Design #1 and Design #2,",3.0,,
588,1674,3,Player object (1006),buy,2023-03-07 04:14:26.081783+00:00,"{""priceA"": 100, ""sharesA"": 1, ""secs_since_round_starts"": 178, ""market"": ""A""}",80.0,33.0,6.0,7eu86eyg,vmu7c279,FULL STUDY,195.0,s2,1,100,115.0,-1,,1,sell,0,sell,0.4476889957041811,19,1,0,block 4 (G second),22.0,12.0,Male,1.0,0.0,1.0,"[3, 'block 4 (G second)']",0,0,1,0.5,5.0,-0.5,0.6666666666666666,0.0,0.0,0.0,4,1.0,0.75,Design 1,Design 2,"Have an option between Design #1 and Design #2,",3.0,,
589,1675,3,Player object (1006),sell,2023-03-07 04:14:30.659933+00:00,"{""priceA"": 110, ""sharesA"": 0, ""secs_since_round_starts"": 182, ""market"": ""A""}",190.0,34.0,7.0,7eu86eyg,vmu7c279,FULL STUDY,195.0,s2,1,110,100.0,1,10.0,1,buy,0,sell,0.4983651933170437,19,0,0,block 4 (G second),22.0,12.0,Male,1.0,0.0,1.0,"[3, 'block 4 (G second)']",0,0,1,0.5,5.0,-0.5,0.6666666666666666,0.0,0.0,0.0,4,1.0,0.75,Design 1,Design 2,"Have an option between Design #1 and Design #2,",3.0,,
590,1676,3,Player object (1006),buy,2023-03-07 04:14:39.864680+00:00,"{""priceA"": 100, ""sharesA"": 1, ""secs_since_round_starts"": 192, ""market"": ""A""}",90.0,36.0,8.0,7eu86eyg,vmu7c279,FULL STUDY,195.0,s2,1,100,110.0,-1,,1,sell,0,sell,0.440139794868048,19,0,0,block 4 (G second),22.0,12.0,Male,1.0,0.0,1.0,"[3, 'block 4 (G second)']",0,0,1,0.5,5.0,-0.5,0.6666666666666666,0.0,0.0,0.0,4,1.0,0.75,Design 1,Design 2,"Have an option between Design #1 and Design #2,",3.0,,
591,1677,3,Player object (1006),sell,2023-03-07 04:14:56.955031+00:00,"{""priceA"": 115, ""sharesA"": 0, ""secs_since_round_starts"": 209, ""market"": ""A""}",205.0,39.0,9.0,7eu86eyg,vmu7c279,FULL STUDY,195.0,s2,1,115,100.0,1,15.0,1,buy,0,sell,0.5221490272476892,19,0,0,block 4 (G second),22.0,12.0,Male,1.0,0.0,1.0,"[3, 'block 4 (G second)']",0,0,1,0.5,5.0,-0.5,0.6666666666666666,0.0,0.0,0.0,4,1.0,0.75,Design 1,Design 2,"Have an option between Design #1 and Design #2,",3.0,,
592,1678,3,Player object (1006),buy,2023-03-07 04:15:01.836467+00:00,"{""priceA"": 100, ""sharesA"": 1, ""secs_since_round_starts"": 214, ""market"": ""A""}",105.0,40.0,10.0,7eu86eyg,vmu7c279,FULL STUDY,195.0,s2,1,100,115.0,-1,,1,sell,0,sell,0.4804175727303482,19,0,0,block 4 (G second),22.0,12.0,Male,1.0,0.0,1.0,"[3, 'block 4 (G second)']",0,0,1,0.5,5.0,-0.5,0.6666666666666666,0.0,0.0,0.0,4,1.0,0.75,Design 1,Design 2,"Have an option between Design #1 and Design #2,",3.0,,
593,1679,3,Player object (1006),sell,2023-03-07 04:15:14.322986+00:00,"{""priceA"": 105, ""sharesA"": 0, ""secs_since_round_starts"": 226, ""market"": ""A""}",210.0,42.0,11.0,7eu86eyg,vmu7c279,FULL STUDY,195.0,s2,1,105,100.0,1,5.0,1,buy,0,sell,0.5010477910686952,19,0,0,block 4 (G second),22.0,12.0,Male,1.0,0.0,1.0,"[3, 'block 4 (G second)']",0,0,1,0.5,5.0,-0.5,0.6666666666666666,0.0,0.0,0.0,4,1.0,0.75,Design 1,Design 2,"Have an option between Design #1 and Design #2,",3.0,,
594,1680,3,Player object (1006),buy,2023-03-07 04:16:38.101264+00:00,"{""priceA"": 130, ""sharesA"": 1, ""secs_since_round_starts"": 310, ""market"": ""A""}",80.0,57.0,12.0,7eu86eyg,vmu7c279,FULL STUDY,195.0,s2,1,130,105.0,-1,,1,sell,0,sell,0.46726452652799,19,0,0,block 4 (G second),22.0,12.0,Male,1.0,0.0,1.0,"[3, 'block 4 (G second)']",0,0,1,0.5,5.0,-0.5,0.6666666666666666,0.0,0.0,0.0,4,1.0,0.75,Design 1,Design 2,"Have an option between Design #1 and Design #2,",3.0,,
595,1684,4,Player object (1126),sell,2023-03-07 04:17:57.751950+00:00,"{""priceA"": 90, ""sharesA"": 0, ""secs_since_round_starts"": 59, ""market"": ""A""}",140.0,12.0,1.0,7eu86eyg,vmu7c279,FULL STUDY,155.0,s2,1,90,,1,,1,,0,sell,0.5210961257750505,14,0,0,block 4 (G second),22.0,12.0,Male,1.0,0.0,1.0,"[4, 'block 4 (G second)']",1,1,1,0.5,5.0,-0.5,0.4,0.041666666666666664,,0.0,4,0.5,1.0,Design 1,Design 2,"Have an option between Design #1 and Design #2,",3.0,,
596,1685,4,Player object (1126),buy,2023-03-07 04:18:25.608983+00:00,"{""priceA"": 85, ""sharesA"": 1, ""secs_since_round_starts"": 86, ""market"": ""A""}",55.0,17.0,2.0,7eu86eyg,vmu7c279,FULL STUDY,155.0,s2,1,85,90.0,-1,,1,sell,0,sell,0.4647046911342559,14,0,0,block 4 (G second),22.0,12.0,Male,1.0,0.0,1.0,"[4, 'block 4 (G second)']",1,1,1,0.5,5.0,-0.5,0.4,0.041666666666666664,,0.0,4,0.5,1.0,Design 1,Design 2,"Have an option between Design #1 and Design #2,",3.0,,
597,1686,4,Player object (1126),sell,2023-03-07 04:19:31.046730+00:00,"{""priceA"": 90, ""sharesA"": 0, ""secs_since_round_starts"": 152, ""market"": ""A""}",145.0,29.0,3.0,7eu86eyg,vmu7c279,FULL STUDY,155.0,s2,1,90,85.0,1,5.0,1,buy,0,sell,0.5712793841154561,14,0,0,block 4 (G second),22.0,12.0,Male,1.0,0.0,1.0,"[4, 'block 4 (G second)']",1,1,1,0.5,5.0,-0.5,0.4,0.041666666666666664,,0.0,4,0.5,1.0,Design 1,Design 2,"Have an option between Design #1 and Design #2,",3.0,,
598,1689,4,Player object (1126),buy,2023-03-07 04:20:17.248211+00:00,"{""priceA"": 70, ""sharesA"": 1, ""secs_since_round_starts"": 198, ""market"": ""A""}",75.0,37.0,4.0,7eu86eyg,vmu7c279,FULL STUDY,155.0,s2,1,70,90.0,-1,,1,sell,0,sell,0.4570673777008929,14,0,0,block 4 (G second),22.0,12.0,Male,1.0,0.0,1.0,"[4, 'block 4 (G second)']",1,1,1,0.5,5.0,-0.5,0.4,0.041666666666666664,,0.0,4,0.5,1.0,Design 1,Design 2,"Have an option between Design #1 and Design #2,",3.0,,
599,1690,4,Player object (1126),sell,2023-03-07 04:20:38.003302+00:00,"{""priceA"": 80, ""sharesA"": 0, ""secs_since_round_starts"": 219, ""market"": ""A""}",155.0,41.0,5.0,7eu86eyg,vmu7c279,FULL STUDY,155.0,s2,1,80,70.0,1,10.0,1,buy,0,sell,0.5055693706451859,14,0,0,block 4 (G second),22.0,12.0,Male,1.0,0.0,1.0,"[4, 'block 4 (G second)']",1,1,1,0.5,5.0,-0.5,0.4,0.041666666666666664,,0.0,4,0.5,1.0,Design 1,Design 2,"Have an option between Design #1 and Design #2,",3.0,,
600,1694,4,Player object (1126),buy,2023-03-07 04:21:44.703000+00:00,"{""priceA"": 75, ""sharesA"": 1, ""secs_since_round_starts"": 286, ""market"": ""A""}",80.0,53.0,6.0,7eu86eyg,vmu7c279,FULL STUDY,155.0,s2,1,75,80.0,-1,,1,sell,0,sell,0.4439854633835125,14,1,0,block 4 (G second),22.0,12.0,Male,1.0,0.0,1.0,"[4, 'block 4 (G second)']",1,1,1,0.5,5.0,-0.5,0.4,0.041666666666666664,,0.0,4,0.5,1.0,Design 1,Design 2,"Have an option between Design #1 and Design #2,",3.0,,
601,1702,5,Player object (1246),sell,2023-03-07 04:23:45.320097+00:00,"{""priceA"": 90, ""sharesA"": 0, ""secs_since_round_starts"": 76, ""market"": ""A""}",140.0,15.0,1.0,7eu86eyg,vmu7c279,FULL STUDY,230.0,s2,1,90,,1,,1,,0,sell,0.505231414156075,17,0,0,block 4 (G second),22.0,12.0,Male,1.0,0.0,1.0,"[5, 'block 4 (G second)']",1,0,1,0.5,5.0,-0.5,0.45454545454545453,0.06666666666666667,1.0,0.0,5,0.25,1.0,Design 1,Design 2,"Have an option between Design #1 and Design #2,",3.0,,
602,1704,5,Player object (1246),buy,2023-03-07 04:23:59.658928+00:00,"{""priceA"": 70, ""sharesA"": 1, ""secs_since_round_starts"": 90, ""market"": ""A""}",70.0,18.0,2.0,7eu86eyg,vmu7c279,FULL STUDY,230.0,s2,1,70,90.0,-1,,1,sell,0,sell,0.42621223683237,17,1,0,block 4 (G second),22.0,12.0,Male,1.0,0.0,1.0,"[5, 'block 4 (G second)']",1,0,1,0.5,5.0,-0.5,0.45454545454545453,0.06666666666666667,1.0,0.0,5,0.25,1.0,Design 1,Design 2,"Have an option between Design #1 and Design #2,",3.0,,
603,1705,5,Player object (1246),sell,2023-03-07 04:24:10.516206+00:00,"{""priceA"": 95, ""sharesA"": 0, ""secs_since_round_starts"": 101, ""market"": ""A""}",165.0,20.0,3.0,7eu86eyg,vmu7c279,FULL STUDY,230.0,s2,1,95,70.0,1,25.0,1,buy,0,sell,0.5232479875730728,17,0,0,block 4 (G second),22.0,12.0,Male,1.0,0.0,1.0,"[5, 'block 4 (G second)']",1,0,1,0.5,5.0,-0.5,0.45454545454545453,0.06666666666666667,1.0,0.0,5,0.25,1.0,Design 1,Design 2,"Have an option between Design #1 and Design #2,",3.0,,
604,1707,5,Player object (1246),buy,2023-03-07 04:25:00.087191+00:00,"{""priceA"": 80, ""sharesA"": 1, ""secs_since_round_starts"": 151, ""market"": ""A""}",85.0,29.0,4.0,7eu86eyg,vmu7c279,FULL STUDY,230.0,s2,1,80,95.0,-1,,1,sell,0,sell,0.4304345659865384,17,0,0,block 4 (G second),22.0,12.0,Male,1.0,0.0,1.0,"[5, 'block 4 (G second)']",1,0,1,0.5,5.0,-0.5,0.45454545454545453,0.06666666666666667,1.0,0.0,5,0.25,1.0,Design 1,Design 2,"Have an option between Design #1 and Design #2,",3.0,,
605,1709,5,Player object (1246),sell,2023-03-07 04:25:21.904304+00:00,"{""priceA"": 110, ""sharesA"": 0, ""secs_since_round_starts"": 173, ""market"": ""A""}",195.0,33.0,5.0,7eu86eyg,vmu7c279,FULL STUDY,230.0,s2,1,110,80.0,1,30.0,1,buy,0,sell,0.5480287979668599,17,0,1,block 4 (G second),22.0,12.0,Male,1.0,0.0,1.0,"[5, 'block 4 (G second)']",1,0,1,0.5,5.0,-0.5,0.45454545454545453,0.06666666666666667,1.0,0.0,5,0.25,1.0,Design 1,Design 2,"Have an option between Design #1 and Design #2,",3.0,,
606,1710,5,Player object (1246),buy,2023-03-07 04:25:49.790109+00:00,"{""priceA"": 80, ""sharesA"": 1, ""secs_since_round_starts"": 200, ""market"": ""A""}",115.0,38.0,6.0,7eu86eyg,vmu7c279,FULL STUDY,230.0,s2,1,80,110.0,-1,,1,sell,0,sell,0.4515999245786187,17,1,0,block 4 (G second),22.0,12.0,Male,1.0,0.0,1.0,"[5, 'block 4 (G second)']",1,0,1,0.5,5.0,-0.5,0.45454545454545453,0.06666666666666667,1.0,0.0,5,0.25,1.0,Design 1,Design 2,"Have an option between Design #1 and Design #2,",3.0,,
607,1712,5,Player object (1246),sell,2023-03-07 04:26:11.313185+00:00,"{""priceA"": 100, ""sharesA"": 0, ""secs_since_round_starts"": 222, ""market"": ""A""}",215.0,42.0,7.0,7eu86eyg,vmu7c279,FULL STUDY,230.0,s2,1,100,80.0,1,20.0,1,buy,0,sell,0.5529358605422235,17,0,1,block 4 (G second),22.0,12.0,Male,1.0,0.0,1.0,"[5, 'block 4 (G second)']",1,0,1,0.5,5.0,-0.5,0.45454545454545453,0.06666666666666667,1.0,0.0,5,0.25,1.0,Design 1,Design 2,"Have an option between Design #1 and Design #2,",3.0,,
608,1714,5,Player object (1246),buy,2023-03-07 04:26:44.775731+00:00,"{""priceA"": 75, ""sharesA"": 1, ""secs_since_round_starts"": 255, ""market"": ""A""}",140.0,48.0,8.0,7eu86eyg,vmu7c279,FULL STUDY,230.0,s2,1,75,100.0,-1,,1,sell,0,sell,0.4393932183506925,17,1,0,block 4 (G second),22.0,12.0,Male,1.0,0.0,1.0,"[5, 'block 4 (G second)']",1,0,1,0.5,5.0,-0.5,0.45454545454545453,0.06666666666666667,1.0,0.0,5,0.25,1.0,Design 1,Design 2,"Have an option between Design #1 and Design #2,",3.0,,
609,1715,5,Player object (1246),sell,2023-03-07 04:27:08.031231+00:00,"{""priceA"": 95, ""sharesA"": 0, ""secs_since_round_starts"": 279, ""market"": ""A""}",235.0,52.0,9.0,7eu86eyg,vmu7c279,FULL STUDY,230.0,s2,1,95,75.0,1,20.0,1,buy,0,sell,0.5397855680881701,17,0,0,block 4 (G second),22.0,12.0,Male,1.0,0.0,1.0,"[5, 'block 4 (G second)']",1,0,1,0.5,5.0,-0.5,0.45454545454545453,0.06666666666666667,1.0,0.0,5,0.25,1.0,Design 1,Design 2,"Have an option between Design #1 and Design #2,",3.0,,
610,1716,5,Player object (1246),buy,2023-03-07 04:27:23.186942+00:00,"{""priceA"": 80, ""sharesA"": 1, ""secs_since_round_starts"": 294, ""market"": ""A""}",155.0,55.0,10.0,7eu86eyg,vmu7c279,FULL STUDY,230.0,s2,1,80,95.0,-1,,1,sell,0,sell,0.4859141076178286,17,0,0,block 4 (G second),22.0,12.0,Male,1.0,0.0,1.0,"[5, 'block 4 (G second)']",1,0,1,0.5,5.0,-0.5,0.45454545454545453,0.06666666666666667,1.0,0.0,5,0.25,1.0,Design 1,Design 2,"Have an option between Design #1 and Design #2,",3.0,,
611,1718,5,Player object (1246),sell,2023-03-07 04:27:27.203131+00:00,"{""priceA"": 95, ""sharesA"": 0, ""secs_since_round_starts"": 298, ""market"": ""A""}",250.0,56.0,11.0,7eu86eyg,vmu7c279,FULL STUDY,230.0,s2,1,95,80.0,1,15.0,1,buy,0,sell,0.5252108989343294,17,0,0,block 4 (G second),22.0,12.0,Male,1.0,0.0,1.0,"[5, 'block 4 (G second)']",1,0,1,0.5,5.0,-0.5,0.45454545454545453,0.06666666666666667,1.0,0.0,5,0.25,1.0,Design 1,Design 2,"Have an option between Design #1 and Design #2,",3.0,,
612,1720,5,Player object (1246),buy,2023-03-07 04:27:33.509965+00:00,"{""priceA"": 85, ""sharesA"": 1, ""secs_since_round_starts"": 304, ""market"": ""A""}",165.0,57.0,12.0,7eu86eyg,vmu7c279,FULL STUDY,230.0,s2,1,85,95.0,-1,,1,sell,0,sell,0.4825596920859898,17,0,0,block 4 (G second),22.0,12.0,Male,1.0,0.0,1.0,"[5, 'block 4 (G second)']",1,0,1,0.5,5.0,-0.5,0.45454545454545453,0.06666666666666667,1.0,0.0,5,0.25,1.0,Design 1,Design 2,"Have an option between Design #1 and Design #2,",3.0,,
613,208,2,Player object (850),sell,2023-02-25 00:12:05.781705+00:00,"{""priceA"": 110, ""sharesA"": 0, ""secs_since_round_starts"": 82, ""market"": ""A""}",160.0,6.0,1.0,7jonfg2l,vmu7c279,FULL STUDY,245.0,s2,1,110,,1,,1,,0,sell,0.5028735207100592,16,0,0,block 2 (G first),20.0,11.0,Male,1.0,1.0,1.0,"[2, 'block 2 (G first)']",1,1,0,0.0,6.0,-0.31666666666666665,0.2692307692307692,0.5,0.0,,4,1.0,0.75,Design 1,Design 1,"Have an option between Design #1 and Design #2,",2.0,,
614,209,2,Player object (850),buy,2023-02-25 00:12:26.488633+00:00,"{""priceA"": 75, ""sharesA"": 1, ""secs_since_round_starts"": 103, ""market"": ""A""}",85.0,10.0,2.0,7jonfg2l,vmu7c279,FULL STUDY,245.0,s2,1,75,110.0,-1,,1,sell,0,sell,0.4825575314143953,16,0,0,block 2 (G first),20.0,11.0,Male,1.0,1.0,1.0,"[2, 'block 2 (G first)']",1,1,0,0.0,6.0,-0.31666666666666665,0.2692307692307692,0.5,0.0,,4,1.0,0.75,Design 1,Design 1,"Have an option between Design #1 and Design #2,",2.0,,
615,210,2,Player object (850),sell,2023-02-25 00:12:59.918207+00:00,"{""priceA"": 105, ""sharesA"": 0, ""secs_since_round_starts"": 137, ""market"": ""A""}",190.0,16.0,3.0,7jonfg2l,vmu7c279,FULL STUDY,245.0,s2,1,105,75.0,1,30.0,1,buy,0,sell,0.5185790363913291,16,0,0,block 2 (G first),20.0,11.0,Male,1.0,1.0,1.0,"[2, 'block 2 (G first)']",1,1,0,0.0,6.0,-0.31666666666666665,0.2692307692307692,0.5,0.0,,4,1.0,0.75,Design 1,Design 1,"Have an option between Design #1 and Design #2,",2.0,,
616,211,2,Player object (850),buy,2023-02-25 00:13:06.644657+00:00,"{""priceA"": 110, ""sharesA"": 1, ""secs_since_round_starts"": 143, ""market"": ""A""}",80.0,17.0,4.0,7jonfg2l,vmu7c279,FULL STUDY,245.0,s2,1,110,105.0,-1,,1,sell,0,sell,0.5478276073026133,16,0,0,block 2 (G first),20.0,11.0,Male,1.0,1.0,1.0,"[2, 'block 2 (G first)']",1,1,0,0.0,6.0,-0.31666666666666665,0.2692307692307692,0.5,0.0,,4,1.0,0.75,Design 1,Design 1,"Have an option between Design #1 and Design #2,",2.0,,
617,212,2,Player object (850),sell,2023-02-25 00:13:22.224391+00:00,"{""priceA"": 125, ""sharesA"": 0, ""secs_since_round_starts"": 159, ""market"": ""A""}",205.0,20.0,5.0,7jonfg2l,vmu7c279,FULL STUDY,245.0,s2,1,125,110.0,1,15.0,1,buy,0,sell,0.5223275507294591,16,0,0,block 2 (G first),20.0,11.0,Male,1.0,1.0,1.0,"[2, 'block 2 (G first)']",1,1,0,0.0,6.0,-0.31666666666666665,0.2692307692307692,0.5,0.0,,4,1.0,0.75,Design 1,Design 1,"Have an option between Design #1 and Design #2,",2.0,,
618,213,2,Player object (850),buy,2023-02-25 00:13:30.126377+00:00,"{""priceA"": 130, ""sharesA"": 1, ""secs_since_round_starts"": 167, ""market"": ""A""}",75.0,21.0,6.0,7jonfg2l,vmu7c279,FULL STUDY,245.0,s2,1,130,125.0,-1,,1,sell,0,sell,0.5504042050217014,16,0,0,block 2 (G first),20.0,11.0,Male,1.0,1.0,1.0,"[2, 'block 2 (G first)']",1,1,0,0.0,6.0,-0.31666666666666665,0.2692307692307692,0.5,0.0,,4,1.0,0.75,Design 1,Design 1,"Have an option between Design #1 and Design #2,",2.0,,
619,214,2,Player object (850),sell,2023-02-25 00:13:49.802100+00:00,"{""priceA"": 145, ""sharesA"": 0, ""secs_since_round_starts"": 186, ""market"": ""A""}",220.0,25.0,7.0,7jonfg2l,vmu7c279,FULL STUDY,245.0,s2,1,145,130.0,1,15.0,1,buy,0,sell,0.5294358264188312,16,0,0,block 2 (G first),20.0,11.0,Male,1.0,1.0,1.0,"[2, 'block 2 (G first)']",1,1,0,0.0,6.0,-0.31666666666666665,0.2692307692307692,0.5,0.0,,4,1.0,0.75,Design 1,Design 1,"Have an option between Design #1 and Design #2,",2.0,,
620,215,2,Player object (850),buy,2023-02-25 00:14:16.988789+00:00,"{""priceA"": 125, ""sharesA"": 1, ""secs_since_round_starts"": 214, ""market"": ""A""}",95.0,30.0,8.0,7jonfg2l,vmu7c279,FULL STUDY,245.0,s2,1,125,145.0,-1,,1,sell,0,sell,0.4785999259850118,16,0,0,block 2 (G first),20.0,11.0,Male,1.0,1.0,1.0,"[2, 'block 2 (G first)']",1,1,0,0.0,6.0,-0.31666666666666665,0.2692307692307692,0.5,0.0,,4,1.0,0.75,Design 1,Design 1,"Have an option between Design #1 and Design #2,",2.0,,
621,217,2,Player object (850),sell,2023-02-25 00:14:36.514185+00:00,"{""priceA"": 130, ""sharesA"": 0, ""secs_since_round_starts"": 233, ""market"": ""A""}",225.0,33.0,9.0,7jonfg2l,vmu7c279,FULL STUDY,245.0,s2,1,130,125.0,1,5.0,1,buy,0,sell,0.499206602391208,16,0,0,block 2 (G first),20.0,11.0,Male,1.0,1.0,1.0,"[2, 'block 2 (G first)']",1,1,0,0.0,6.0,-0.31666666666666665,0.2692307692307692,0.5,0.0,,4,1.0,0.75,Design 1,Design 1,"Have an option between Design #1 and Design #2,",2.0,,
622,218,2,Player object (850),buy,2023-02-25 00:14:46.882798+00:00,"{""priceA"": 140, ""sharesA"": 1, ""secs_since_round_starts"": 244, ""market"": ""A""}",85.0,35.0,10.0,7jonfg2l,vmu7c279,FULL STUDY,245.0,s2,1,140,130.0,-1,,1,sell,0,sell,0.5101876173062244,16,0,0,block 2 (G first),20.0,11.0,Male,1.0,1.0,1.0,"[2, 'block 2 (G first)']",1,1,0,0.0,6.0,-0.31666666666666665,0.2692307692307692,0.5,0.0,,4,1.0,0.75,Design 1,Design 1,"Have an option between Design #1 and Design #2,",2.0,,
623,219,2,Player object (850),sell,2023-02-25 00:14:57.930554+00:00,"{""priceA"": 145, ""sharesA"": 0, ""secs_since_round_starts"": 255, ""market"": ""A""}",230.0,37.0,11.0,7jonfg2l,vmu7c279,FULL STUDY,245.0,s2,1,145,140.0,1,5.0,1,buy,0,sell,0.494384744736363,16,0,0,block 2 (G first),20.0,11.0,Male,1.0,1.0,1.0,"[2, 'block 2 (G first)']",1,1,0,0.0,6.0,-0.31666666666666665,0.2692307692307692,0.5,0.0,,4,1.0,0.75,Design 1,Design 1,"Have an option between Design #1 and Design #2,",2.0,,
624,220,2,Player object (850),buy,2023-02-25 00:15:14.380330+00:00,"{""priceA"": 140, ""sharesA"": 1, ""secs_since_round_starts"": 271, ""market"": ""A""}",90.0,40.0,12.0,7jonfg2l,vmu7c279,FULL STUDY,245.0,s2,1,140,145.0,-1,,1,sell,0,sell,0.4916787423410894,16,0,0,block 2 (G first),20.0,11.0,Male,1.0,1.0,1.0,"[2, 'block 2 (G first)']",1,1,0,0.0,6.0,-0.31666666666666665,0.2692307692307692,0.5,0.0,,4,1.0,0.75,Design 1,Design 1,"Have an option between Design #1 and Design #2,",2.0,,
625,221,2,Player object (850),sell,2023-02-25 00:15:21.101892+00:00,"{""priceA"": 135, ""sharesA"": 0, ""secs_since_round_starts"": 277, ""market"": ""A""}",225.0,41.0,13.0,7jonfg2l,vmu7c279,FULL STUDY,245.0,s2,1,135,140.0,1,-5.0,1,buy,0,sell,0.4592429496222846,16,0,0,block 2 (G first),20.0,11.0,Male,1.0,1.0,1.0,"[2, 'block 2 (G first)']",1,1,0,0.0,6.0,-0.31666666666666665,0.2692307692307692,0.5,0.0,,4,1.0,0.75,Design 1,Design 1,"Have an option between Design #1 and Design #2,",2.0,,
626,222,2,Player object (850),buy,2023-02-25 00:15:36.498062+00:00,"{""priceA"": 130, ""sharesA"": 1, ""secs_since_round_starts"": 293, ""market"": ""A""}",95.0,44.0,14.0,7jonfg2l,vmu7c279,FULL STUDY,245.0,s2,1,130,135.0,-1,,1,sell,0,sell,0.4799987600827208,16,0,0,block 2 (G first),20.0,11.0,Male,1.0,1.0,1.0,"[2, 'block 2 (G first)']",1,1,0,0.0,6.0,-0.31666666666666665,0.2692307692307692,0.5,0.0,,4,1.0,0.75,Design 1,Design 1,"Have an option between Design #1 and Design #2,",2.0,,
627,223,2,Player object (850),sell,2023-02-25 00:15:52.797215+00:00,"{""priceA"": 140, ""sharesA"": 0, ""secs_since_round_starts"": 309, ""market"": ""A""}",235.0,47.0,15.0,7jonfg2l,vmu7c279,FULL STUDY,245.0,s2,1,140,130.0,1,10.0,1,buy,0,sell,0.4996814899229063,16,0,0,block 2 (G first),20.0,11.0,Male,1.0,1.0,1.0,"[2, 'block 2 (G first)']",1,1,0,0.0,6.0,-0.31666666666666665,0.2692307692307692,0.5,0.0,,4,1.0,0.75,Design 1,Design 1,"Have an option between Design #1 and Design #2,",2.0,,
628,224,2,Player object (850),buy,2023-02-25 00:15:59.628878+00:00,"{""priceA"": 155, ""sharesA"": 1, ""secs_since_round_starts"": 316, ""market"": ""A""}",80.0,48.0,16.0,7jonfg2l,vmu7c279,FULL STUDY,245.0,s2,1,155,140.0,-1,,1,sell,0,sell,0.5347792584548927,16,0,0,block 2 (G first),20.0,11.0,Male,1.0,1.0,1.0,"[2, 'block 2 (G first)']",1,1,0,0.0,6.0,-0.31666666666666665,0.2692307692307692,0.5,0.0,,4,1.0,0.75,Design 1,Design 1,"Have an option between Design #1 and Design #2,",2.0,,
629,225,2,Player object (850),sell,2023-02-25 00:16:09.430531+00:00,"{""priceA"": 155, ""sharesA"": 0, ""secs_since_round_starts"": 326, ""market"": ""A""}",235.0,50.0,17.0,7jonfg2l,vmu7c279,FULL STUDY,245.0,s2,1,155,155.0,1,0.0,1,buy,0,sell,0.5063294801170398,16,0,0,block 2 (G first),20.0,11.0,Male,1.0,1.0,1.0,"[2, 'block 2 (G first)']",1,1,0,0.0,6.0,-0.31666666666666665,0.2692307692307692,0.5,0.0,,4,1.0,0.75,Design 1,Design 1,"Have an option between Design #1 and Design #2,",2.0,,
630,226,2,Player object (850),buy,2023-02-25 00:16:27.311556+00:00,"{""priceA"": 135, ""sharesA"": 1, ""secs_since_round_starts"": 344, ""market"": ""A""}",100.0,53.0,18.0,7jonfg2l,vmu7c279,FULL STUDY,245.0,s2,1,135,155.0,-1,,1,sell,0,sell,0.4956940487416096,16,0,0,block 2 (G first),20.0,11.0,Male,1.0,1.0,1.0,"[2, 'block 2 (G first)']",1,1,0,0.0,6.0,-0.31666666666666665,0.2692307692307692,0.5,0.0,,4,1.0,0.75,Design 1,Design 1,"Have an option between Design #1 and Design #2,",2.0,,
631,227,2,Player object (850),sell,2023-02-25 00:16:38.104686+00:00,"{""priceA"": 135, ""sharesA"": 0, ""secs_since_round_starts"": 355, ""market"": ""A""}",235.0,55.0,19.0,7jonfg2l,vmu7c279,FULL STUDY,245.0,s2,1,135,135.0,1,0.0,1,buy,0,sell,0.4873282494519479,16,0,0,block 2 (G first),20.0,11.0,Male,1.0,1.0,1.0,"[2, 'block 2 (G first)']",1,1,0,0.0,6.0,-0.31666666666666665,0.2692307692307692,0.5,0.0,,4,1.0,0.75,Design 1,Design 1,"Have an option between Design #1 and Design #2,",2.0,,
632,228,2,Player object (850),buy,2023-02-25 00:16:54.057658+00:00,"{""priceA"": 115, ""sharesA"": 1, ""secs_since_round_starts"": 371, ""market"": ""A""}",120.0,58.0,20.0,7jonfg2l,vmu7c279,FULL STUDY,245.0,s2,1,115,135.0,-1,,1,sell,0,sell,0.4893175166503174,16,0,0,block 2 (G first),20.0,11.0,Male,1.0,1.0,1.0,"[2, 'block 2 (G first)']",1,1,0,0.0,6.0,-0.31666666666666665,0.2692307692307692,0.5,0.0,,4,1.0,0.75,Design 1,Design 1,"Have an option between Design #1 and Design #2,",2.0,,
633,232,3,Player object (970),sell,2023-02-25 00:17:55.781260+00:00,"{""priceA"": 90, ""sharesA"": 0, ""secs_since_round_starts"": 39, ""market"": ""A""}",140.0,7.0,1.0,7jonfg2l,vmu7c279,FULL STUDY,175.0,s2,1,90,,1,,1,,0,sell,0.4580966810292103,19,0,0,block 2 (G first),20.0,11.0,Male,1.0,1.0,1.0,"[3, 'block 2 (G first)']",1,0,0,0.0,6.0,-0.31666666666666665,0.2777777777777778,0.7777777777777778,0.2,0.0,2,0.5,0.75,Design 1,Design 1,"Have an option between Design #1 and Design #2,",2.0,,
634,233,3,Player object (970),buy,2023-02-25 00:18:01.236304+00:00,"{""priceA"": 100, ""sharesA"": 1, ""secs_since_round_starts"": 44, ""market"": ""A""}",40.0,8.0,2.0,7jonfg2l,vmu7c279,FULL STUDY,175.0,s2,1,100,90.0,-1,,1,sell,0,sell,0.5057155770500936,19,0,0,block 2 (G first),20.0,11.0,Male,1.0,1.0,1.0,"[3, 'block 2 (G first)']",1,0,0,0.0,6.0,-0.31666666666666665,0.2777777777777778,0.7777777777777778,0.2,0.0,2,0.5,0.75,Design 1,Design 1,"Have an option between Design #1 and Design #2,",2.0,,
635,234,3,Player object (970),sell,2023-02-25 00:18:12.793044+00:00,"{""priceA"": 95, ""sharesA"": 0, ""secs_since_round_starts"": 56, ""market"": ""A""}",135.0,10.0,3.0,7jonfg2l,vmu7c279,FULL STUDY,175.0,s2,1,95,100.0,1,-5.0,1,buy,0,sell,0.4922087569005138,19,0,0,block 2 (G first),20.0,11.0,Male,1.0,1.0,1.0,"[3, 'block 2 (G first)']",1,0,0,0.0,6.0,-0.31666666666666665,0.2777777777777778,0.7777777777777778,0.2,0.0,2,0.5,0.75,Design 1,Design 1,"Have an option between Design #1 and Design #2,",2.0,,
636,235,3,Player object (970),buy,2023-02-25 00:18:18.016482+00:00,"{""priceA"": 110, ""sharesA"": 1, ""secs_since_round_starts"": 61, ""market"": ""A""}",25.0,11.0,4.0,7jonfg2l,vmu7c279,FULL STUDY,175.0,s2,1,110,95.0,-1,,1,sell,0,sell,0.5295922419004607,19,0,0,block 2 (G first),20.0,11.0,Male,1.0,1.0,1.0,"[3, 'block 2 (G first)']",1,0,0,0.0,6.0,-0.31666666666666665,0.2777777777777778,0.7777777777777778,0.2,0.0,2,0.5,0.75,Design 1,Design 1,"Have an option between Design #1 and Design #2,",2.0,,
637,236,3,Player object (970),sell,2023-02-25 00:18:34.410104+00:00,"{""priceA"": 125, ""sharesA"": 0, ""secs_since_round_starts"": 77, ""market"": ""A""}",150.0,14.0,5.0,7jonfg2l,vmu7c279,FULL STUDY,175.0,s2,1,125,110.0,1,15.0,1,buy,0,sell,0.5163117828594225,19,0,0,block 2 (G first),20.0,11.0,Male,1.0,1.0,1.0,"[3, 'block 2 (G first)']",1,0,0,0.0,6.0,-0.31666666666666665,0.2777777777777778,0.7777777777777778,0.2,0.0,2,0.5,0.75,Design 1,Design 1,"Have an option between Design #1 and Design #2,",2.0,,
638,237,3,Player object (970),buy,2023-02-25 00:18:50.361946+00:00,"{""priceA"": 105, ""sharesA"": 1, ""secs_since_round_starts"": 93, ""market"": ""A""}",45.0,17.0,6.0,7jonfg2l,vmu7c279,FULL STUDY,175.0,s2,1,105,125.0,-1,,1,sell,0,sell,0.4990675303551922,19,0,0,block 2 (G first),20.0,11.0,Male,1.0,1.0,1.0,"[3, 'block 2 (G first)']",1,0,0,0.0,6.0,-0.31666666666666665,0.2777777777777778,0.7777777777777778,0.2,0.0,2,0.5,0.75,Design 1,Design 1,"Have an option between Design #1 and Design #2,",2.0,,
639,238,3,Player object (970),sell,2023-02-25 00:19:07.885650+00:00,"{""priceA"": 115, ""sharesA"": 0, ""secs_since_round_starts"": 111, ""market"": ""A""}",160.0,20.0,7.0,7jonfg2l,vmu7c279,FULL STUDY,175.0,s2,1,115,105.0,1,10.0,1,buy,0,sell,0.5061230669509241,19,0,0,block 2 (G first),20.0,11.0,Male,1.0,1.0,1.0,"[3, 'block 2 (G first)']",1,0,0,0.0,6.0,-0.31666666666666665,0.2777777777777778,0.7777777777777778,0.2,0.0,2,0.5,0.75,Design 1,Design 1,"Have an option between Design #1 and Design #2,",2.0,,
640,239,3,Player object (970),buy,2023-02-25 00:19:23.131813+00:00,"{""priceA"": 100, ""sharesA"": 1, ""secs_since_round_starts"": 126, ""market"": ""A""}",60.0,23.0,8.0,7jonfg2l,vmu7c279,FULL STUDY,175.0,s2,1,100,115.0,-1,,1,sell,0,sell,0.4956244642879559,19,0,0,block 2 (G first),20.0,11.0,Male,1.0,1.0,1.0,"[3, 'block 2 (G first)']",1,0,0,0.0,6.0,-0.31666666666666665,0.2777777777777778,0.7777777777777778,0.2,0.0,2,0.5,0.75,Design 1,Design 1,"Have an option between Design #1 and Design #2,",2.0,,
641,240,3,Player object (970),sell,2023-02-25 00:19:34.726524+00:00,"{""priceA"": 110, ""sharesA"": 0, ""secs_since_round_starts"": 138, ""market"": ""A""}",170.0,25.0,9.0,7jonfg2l,vmu7c279,FULL STUDY,175.0,s2,1,110,100.0,1,10.0,1,buy,0,sell,0.4872943409941583,19,0,0,block 2 (G first),20.0,11.0,Male,1.0,1.0,1.0,"[3, 'block 2 (G first)']",1,0,0,0.0,6.0,-0.31666666666666665,0.2777777777777778,0.7777777777777778,0.2,0.0,2,0.5,0.75,Design 1,Design 1,"Have an option between Design #1 and Design #2,",2.0,,
642,241,3,Player object (970),buy,2023-02-25 00:19:40.190296+00:00,"{""priceA"": 115, ""sharesA"": 1, ""secs_since_round_starts"": 143, ""market"": ""A""}",55.0,26.0,10.0,7jonfg2l,vmu7c279,FULL STUDY,175.0,s2,1,115,110.0,-1,,1,sell,0,sell,0.526172546586359,19,0,0,block 2 (G first),20.0,11.0,Male,1.0,1.0,1.0,"[3, 'block 2 (G first)']",1,0,0,0.0,6.0,-0.31666666666666665,0.2777777777777778,0.7777777777777778,0.2,0.0,2,0.5,0.75,Design 1,Design 1,"Have an option between Design #1 and Design #2,",2.0,,
643,242,3,Player object (970),sell,2023-02-25 00:19:45.612515+00:00,"{""priceA"": 105, ""sharesA"": 0, ""secs_since_round_starts"": 149, ""market"": ""A""}",160.0,27.0,11.0,7jonfg2l,vmu7c279,FULL STUDY,175.0,s2,1,105,115.0,1,-10.0,1,buy,0,sell,0.4832330156747784,19,0,0,block 2 (G first),20.0,11.0,Male,1.0,1.0,1.0,"[3, 'block 2 (G first)']",1,0,0,0.0,6.0,-0.31666666666666665,0.2777777777777778,0.7777777777777778,0.2,0.0,2,0.5,0.75,Design 1,Design 1,"Have an option between Design #1 and Design #2,",2.0,,
644,243,3,Player object (970),buy,2023-02-25 00:19:51.453134+00:00,"{""priceA"": 110, ""sharesA"": 1, ""secs_since_round_starts"": 154, ""market"": ""A""}",50.0,28.0,12.0,7jonfg2l,vmu7c279,FULL STUDY,175.0,s2,1,110,105.0,-1,,1,sell,0,sell,0.5233413838959273,19,0,0,block 2 (G first),20.0,11.0,Male,1.0,1.0,1.0,"[3, 'block 2 (G first)']",1,0,0,0.0,6.0,-0.31666666666666665,0.2777777777777778,0.7777777777777778,0.2,0.0,2,0.5,0.75,Design 1,Design 1,"Have an option between Design #1 and Design #2,",2.0,,
645,245,3,Player object (970),sell,2023-02-25 00:20:24.160857+00:00,"{""priceA"": 110, ""sharesA"": 0, ""secs_since_round_starts"": 187, ""market"": ""A""}",160.0,32.0,13.0,7jonfg2l,vmu7c279,FULL STUDY,175.0,s2,1,110,110.0,1,0.0,1,buy,0,sell,0.4748947710808772,19,0,0,block 2 (G first),20.0,11.0,Male,1.0,1.0,1.0,"[3, 'block 2 (G first)']",1,0,0,0.0,6.0,-0.31666666666666665,0.2777777777777778,0.7777777777777778,0.2,0.0,2,0.5,0.75,Design 1,Design 1,"Have an option between Design #1 and Design #2,",2.0,,
646,246,3,Player object (970),buy,2023-02-25 00:20:32.651198+00:00,"{""priceA"": 110, ""sharesA"": 1, ""secs_since_round_starts"": 196, ""market"": ""A""}",50.0,34.0,14.0,7jonfg2l,vmu7c279,FULL STUDY,175.0,s2,1,110,110.0,-1,,1,sell,0,sell,0.4983651933170437,19,0,0,block 2 (G first),20.0,11.0,Male,1.0,1.0,1.0,"[3, 'block 2 (G first)']",1,0,0,0.0,6.0,-0.31666666666666665,0.2777777777777778,0.7777777777777778,0.2,0.0,2,0.5,0.75,Design 1,Design 1,"Have an option between Design #1 and Design #2,",2.0,,
647,247,3,Player object (970),sell,2023-02-25 00:20:38.502511+00:00,"{""priceA"": 105, ""sharesA"": 0, ""secs_since_round_starts"": 201, ""market"": ""A""}",155.0,35.0,15.0,7jonfg2l,vmu7c279,FULL STUDY,175.0,s2,1,105,110.0,1,-5.0,1,buy,0,sell,0.463867449269012,19,0,0,block 2 (G first),20.0,11.0,Male,1.0,1.0,1.0,"[3, 'block 2 (G first)']",1,0,0,0.0,6.0,-0.31666666666666665,0.2777777777777778,0.7777777777777778,0.2,0.0,2,0.5,0.75,Design 1,Design 1,"Have an option between Design #1 and Design #2,",2.0,,
648,248,3,Player object (970),buy,2023-02-25 00:20:54.311632+00:00,"{""priceA"": 100, ""sharesA"": 1, ""secs_since_round_starts"": 217, ""market"": ""A""}",55.0,38.0,16.0,7jonfg2l,vmu7c279,FULL STUDY,175.0,s2,1,100,105.0,-1,,1,sell,0,sell,0.4815245494229145,19,0,0,block 2 (G first),20.0,11.0,Male,1.0,1.0,1.0,"[3, 'block 2 (G first)']",1,0,0,0.0,6.0,-0.31666666666666665,0.2777777777777778,0.7777777777777778,0.2,0.0,2,0.5,0.75,Design 1,Design 1,"Have an option between Design #1 and Design #2,",2.0,,
649,249,3,Player object (970),sell,2023-02-25 00:21:06.560455+00:00,"{""priceA"": 100, ""sharesA"": 0, ""secs_since_round_starts"": 230, ""market"": ""A""}",155.0,40.0,17.0,7jonfg2l,vmu7c279,FULL STUDY,175.0,s2,1,100,100.0,1,0.0,1,buy,0,sell,0.4804175727303482,19,0,0,block 2 (G first),20.0,11.0,Male,1.0,1.0,1.0,"[3, 'block 2 (G first)']",1,0,0,0.0,6.0,-0.31666666666666665,0.2777777777777778,0.7777777777777778,0.2,0.0,2,0.5,0.75,Design 1,Design 1,"Have an option between Design #1 and Design #2,",2.0,,
650,250,3,Player object (970),buy,2023-02-25 00:21:16.530490+00:00,"{""priceA"": 105, ""sharesA"": 1, ""secs_since_round_starts"": 239, ""market"": ""A""}",50.0,42.0,18.0,7jonfg2l,vmu7c279,FULL STUDY,175.0,s2,1,105,100.0,-1,,1,sell,0,sell,0.5010477910686952,19,0,0,block 2 (G first),20.0,11.0,Male,1.0,1.0,1.0,"[3, 'block 2 (G first)']",1,0,0,0.0,6.0,-0.31666666666666665,0.2777777777777778,0.7777777777777778,0.2,0.0,2,0.5,0.75,Design 1,Design 1,"Have an option between Design #1 and Design #2,",2.0,,
651,251,3,Player object (970),sell,2023-02-25 00:21:32.799164+00:00,"{""priceA"": 125, ""sharesA"": 0, ""secs_since_round_starts"": 256, ""market"": ""A""}",175.0,45.0,19.0,7jonfg2l,vmu7c279,FULL STUDY,175.0,s2,1,125,105.0,1,20.0,1,buy,0,sell,0.5067886105922249,19,0,0,block 2 (G first),20.0,11.0,Male,1.0,1.0,1.0,"[3, 'block 2 (G first)']",1,0,0,0.0,6.0,-0.31666666666666665,0.2777777777777778,0.7777777777777778,0.2,0.0,2,0.5,0.75,Design 1,Design 1,"Have an option between Design #1 and Design #2,",2.0,,
652,252,3,Player object (970),buy,2023-02-25 00:21:38.976955+00:00,"{""priceA"": 135, ""sharesA"": 1, ""secs_since_round_starts"": 262, ""market"": ""A""}",40.0,46.0,20.0,7jonfg2l,vmu7c279,FULL STUDY,175.0,s2,1,135,125.0,-1,,1,sell,0,sell,0.5396981283875847,19,0,0,block 2 (G first),20.0,11.0,Male,1.0,1.0,1.0,"[3, 'block 2 (G first)']",1,0,0,0.0,6.0,-0.31666666666666665,0.2777777777777778,0.7777777777777778,0.2,0.0,2,0.5,0.75,Design 1,Design 1,"Have an option between Design #1 and Design #2,",2.0,,
653,253,3,Player object (970),sell,2023-02-25 00:21:44.324536+00:00,"{""priceA"": 130, ""sharesA"": 0, ""secs_since_round_starts"": 267, ""market"": ""A""}",170.0,47.0,21.0,7jonfg2l,vmu7c279,FULL STUDY,175.0,s2,1,130,135.0,1,-5.0,1,buy,0,sell,0.4927309765460438,19,0,0,block 2 (G first),20.0,11.0,Male,1.0,1.0,1.0,"[3, 'block 2 (G first)']",1,0,0,0.0,6.0,-0.31666666666666665,0.2777777777777778,0.7777777777777778,0.2,0.0,2,0.5,0.75,Design 1,Design 1,"Have an option between Design #1 and Design #2,",2.0,,
654,254,3,Player object (970),buy,2023-02-25 00:22:00.411927+00:00,"{""priceA"": 125, ""sharesA"": 1, ""secs_since_round_starts"": 283, ""market"": ""A""}",45.0,50.0,22.0,7jonfg2l,vmu7c279,FULL STUDY,175.0,s2,1,125,130.0,-1,,1,sell,0,sell,0.4911246412164243,19,0,0,block 2 (G first),20.0,11.0,Male,1.0,1.0,1.0,"[3, 'block 2 (G first)']",1,0,0,0.0,6.0,-0.31666666666666665,0.2777777777777778,0.7777777777777778,0.2,0.0,2,0.5,0.75,Design 1,Design 1,"Have an option between Design #1 and Design #2,",2.0,,
655,255,3,Player object (970),sell,2023-02-25 00:22:06.148908+00:00,"{""priceA"": 120, ""sharesA"": 0, ""secs_since_round_starts"": 289, ""market"": ""A""}",165.0,51.0,23.0,7jonfg2l,vmu7c279,FULL STUDY,175.0,s2,1,120,125.0,1,-5.0,1,buy,0,sell,0.4588602748157505,19,0,0,block 2 (G first),20.0,11.0,Male,1.0,1.0,1.0,"[3, 'block 2 (G first)']",1,0,0,0.0,6.0,-0.31666666666666665,0.2777777777777778,0.7777777777777778,0.2,0.0,2,0.5,0.75,Design 1,Design 1,"Have an option between Design #1 and Design #2,",2.0,,
656,256,3,Player object (970),buy,2023-02-25 00:22:17.542724+00:00,"{""priceA"": 130, ""sharesA"": 1, ""secs_since_round_starts"": 300, ""market"": ""A""}",35.0,53.0,24.0,7jonfg2l,vmu7c279,FULL STUDY,175.0,s2,1,130,120.0,-1,,1,sell,0,sell,0.4905868559773416,19,0,0,block 2 (G first),20.0,11.0,Male,1.0,1.0,1.0,"[3, 'block 2 (G first)']",1,0,0,0.0,6.0,-0.31666666666666665,0.2777777777777778,0.7777777777777778,0.2,0.0,2,0.5,0.75,Design 1,Design 1,"Have an option between Design #1 and Design #2,",2.0,,
657,257,3,Player object (970),sell,2023-02-25 00:22:32.403108+00:00,"{""priceA"": 150, ""sharesA"": 0, ""secs_since_round_starts"": 315, ""market"": ""A""}",185.0,55.0,25.0,7jonfg2l,vmu7c279,FULL STUDY,175.0,s2,1,150,130.0,1,20.0,1,buy,0,sell,0.5546141592279494,19,0,1,block 2 (G first),20.0,11.0,Male,1.0,1.0,1.0,"[3, 'block 2 (G first)']",1,0,0,0.0,6.0,-0.31666666666666665,0.2777777777777778,0.7777777777777778,0.2,0.0,2,0.5,0.75,Design 1,Design 1,"Have an option between Design #1 and Design #2,",2.0,,
658,258,3,Player object (970),buy,2023-02-25 00:22:50.001206+00:00,"{""priceA"": 125, ""sharesA"": 1, ""secs_since_round_starts"": 333, ""market"": ""A""}",60.0,59.0,26.0,7jonfg2l,vmu7c279,FULL STUDY,175.0,s2,1,125,150.0,-1,,1,sell,0,sell,0.4946618842475483,19,0,0,block 2 (G first),20.0,11.0,Male,1.0,1.0,1.0,"[3, 'block 2 (G first)']",1,0,0,0.0,6.0,-0.31666666666666665,0.2777777777777778,0.7777777777777778,0.2,0.0,2,0.5,0.75,Design 1,Design 1,"Have an option between Design #1 and Design #2,",2.0,,
659,259,3,Player object (970),sell,2023-02-25 00:22:56.945004+00:00,"{""priceA"": 115, ""sharesA"": 0, ""secs_since_round_starts"": 340, ""market"": ""A""}",175.0,60.0,27.0,7jonfg2l,vmu7c279,FULL STUDY,175.0,s2,1,115,125.0,1,-10.0,1,buy,0,sell,0.4613046310449969,19,0,0,block 2 (G first),20.0,11.0,Male,1.0,1.0,1.0,"[3, 'block 2 (G first)']",1,0,0,0.0,6.0,-0.31666666666666665,0.2777777777777778,0.7777777777777778,0.2,0.0,2,0.5,0.75,Design 1,Design 1,"Have an option between Design #1 and Design #2,",2.0,,
660,263,4,Player object (1090),sell,2023-02-25 00:24:13.321279+00:00,"{""priceA"": 90, ""sharesA"": 0, ""secs_since_round_starts"": 68, ""market"": ""A""}",140.0,12.0,1.0,7jonfg2l,vmu7c279,FULL STUDY,195.0,s2,1,90,,1,,1,,0,sell,0.5210961257750505,14,0,0,block 2 (G first),20.0,11.0,Male,1.0,1.0,1.0,"[4, 'block 2 (G first)']",0,1,0,0.0,6.0,-0.31666666666666665,0.2,0.36363636363636365,0.5,0.0,2,1.0,0.5,Design 1,Design 1,"Have an option between Design #1 and Design #2,",2.0,,
661,264,4,Player object (1090),buy,2023-02-25 00:24:24.611142+00:00,"{""priceA"": 90, ""sharesA"": 1, ""secs_since_round_starts"": 79, ""market"": ""A""}",50.0,14.0,2.0,7jonfg2l,vmu7c279,FULL STUDY,195.0,s2,1,90,90.0,-1,,1,sell,0,sell,0.5208618681016636,14,0,0,block 2 (G first),20.0,11.0,Male,1.0,1.0,1.0,"[4, 'block 2 (G first)']",0,1,0,0.0,6.0,-0.31666666666666665,0.2,0.36363636363636365,0.5,0.0,2,1.0,0.5,Design 1,Design 1,"Have an option between Design #1 and Design #2,",2.0,,
662,265,4,Player object (1090),sell,2023-02-25 00:24:37.182068+00:00,"{""priceA"": 90, ""sharesA"": 0, ""secs_since_round_starts"": 92, ""market"": ""A""}",140.0,16.0,3.0,7jonfg2l,vmu7c279,FULL STUDY,195.0,s2,1,90,90.0,1,0.0,1,buy,0,sell,0.4995738325599586,14,0,0,block 2 (G first),20.0,11.0,Male,1.0,1.0,1.0,"[4, 'block 2 (G first)']",0,1,0,0.0,6.0,-0.31666666666666665,0.2,0.36363636363636365,0.5,0.0,2,1.0,0.5,Design 1,Design 1,"Have an option between Design #1 and Design #2,",2.0,,
663,266,4,Player object (1090),buy,2023-02-25 00:24:48.387422+00:00,"{""priceA"": 70, ""sharesA"": 1, ""secs_since_round_starts"": 103, ""market"": ""A""}",70.0,18.0,4.0,7jonfg2l,vmu7c279,FULL STUDY,195.0,s2,1,70,90.0,-1,,1,sell,0,sell,0.4407118028401492,14,1,0,block 2 (G first),20.0,11.0,Male,1.0,1.0,1.0,"[4, 'block 2 (G first)']",0,1,0,0.0,6.0,-0.31666666666666665,0.2,0.36363636363636365,0.5,0.0,2,1.0,0.5,Design 1,Design 1,"Have an option between Design #1 and Design #2,",2.0,,
664,267,4,Player object (1090),sell,2023-02-25 00:24:58.128483+00:00,"{""priceA"": 70, ""sharesA"": 0, ""secs_since_round_starts"": 113, ""market"": ""A""}",140.0,20.0,5.0,7jonfg2l,vmu7c279,FULL STUDY,195.0,s2,1,70,70.0,1,0.0,1,buy,0,sell,0.4604462199730844,14,0,0,block 2 (G first),20.0,11.0,Male,1.0,1.0,1.0,"[4, 'block 2 (G first)']",0,1,0,0.0,6.0,-0.31666666666666665,0.2,0.36363636363636365,0.5,0.0,2,1.0,0.5,Design 1,Design 1,"Have an option between Design #1 and Design #2,",2.0,,
665,268,4,Player object (1090),buy,2023-02-25 00:25:12.472166+00:00,"{""priceA"": 55, ""sharesA"": 1, ""secs_since_round_starts"": 127, ""market"": ""A""}",85.0,22.0,6.0,7jonfg2l,vmu7c279,FULL STUDY,195.0,s2,1,55,70.0,-1,,1,sell,0,sell,0.4224279859932807,14,1,0,block 2 (G first),20.0,11.0,Male,1.0,1.0,1.0,"[4, 'block 2 (G first)']",0,1,0,0.0,6.0,-0.31666666666666665,0.2,0.36363636363636365,0.5,0.0,2,1.0,0.5,Design 1,Design 1,"Have an option between Design #1 and Design #2,",2.0,,
666,269,4,Player object (1090),sell,2023-02-25 00:25:21.011519+00:00,"{""priceA"": 55, ""sharesA"": 0, ""secs_since_round_starts"": 136, ""market"": ""A""}",140.0,24.0,7.0,7jonfg2l,vmu7c279,FULL STUDY,195.0,s2,1,55,55.0,1,0.0,1,buy,0,sell,0.4514670992379582,14,0,0,block 2 (G first),20.0,11.0,Male,1.0,1.0,1.0,"[4, 'block 2 (G first)']",0,1,0,0.0,6.0,-0.31666666666666665,0.2,0.36363636363636365,0.5,0.0,2,1.0,0.5,Design 1,Design 1,"Have an option between Design #1 and Design #2,",2.0,,
667,270,4,Player object (1090),buy,2023-02-25 00:25:30.426354+00:00,"{""priceA"": 55, ""sharesA"": 1, ""secs_since_round_starts"": 145, ""market"": ""A""}",85.0,26.0,8.0,7jonfg2l,vmu7c279,FULL STUDY,195.0,s2,1,55,55.0,-1,,1,sell,0,sell,0.4870054870256314,14,0,0,block 2 (G first),20.0,11.0,Male,1.0,1.0,1.0,"[4, 'block 2 (G first)']",0,1,0,0.0,6.0,-0.31666666666666665,0.2,0.36363636363636365,0.5,0.0,2,1.0,0.5,Design 1,Design 1,"Have an option between Design #1 and Design #2,",2.0,,
668,271,4,Player object (1090),sell,2023-02-25 00:25:53.866298+00:00,"{""priceA"": 85, ""sharesA"": 0, ""secs_since_round_starts"": 168, ""market"": ""A""}",170.0,30.0,9.0,7jonfg2l,vmu7c279,FULL STUDY,195.0,s2,1,85,55.0,1,30.0,1,buy,0,sell,0.5151109892827086,14,0,0,block 2 (G first),20.0,11.0,Male,1.0,1.0,1.0,"[4, 'block 2 (G first)']",0,1,0,0.0,6.0,-0.31666666666666665,0.2,0.36363636363636365,0.5,0.0,2,1.0,0.5,Design 1,Design 1,"Have an option between Design #1 and Design #2,",2.0,,
669,273,4,Player object (1090),buy,2023-02-25 00:26:08.237300+00:00,"{""priceA"": 95, ""sharesA"": 1, ""secs_since_round_starts"": 183, ""market"": ""A""}",75.0,32.0,10.0,7jonfg2l,vmu7c279,FULL STUDY,195.0,s2,1,95,85.0,-1,,1,sell,0,sell,0.5179404569050043,14,0,0,block 2 (G first),20.0,11.0,Male,1.0,1.0,1.0,"[4, 'block 2 (G first)']",0,1,0,0.0,6.0,-0.31666666666666665,0.2,0.36363636363636365,0.5,0.0,2,1.0,0.5,Design 1,Design 1,"Have an option between Design #1 and Design #2,",2.0,,
670,274,4,Player object (1090),sell,2023-02-25 00:26:17.917016+00:00,"{""priceA"": 95, ""sharesA"": 0, ""secs_since_round_starts"": 192, ""market"": ""A""}",170.0,34.0,11.0,7jonfg2l,vmu7c279,FULL STUDY,195.0,s2,1,95,95.0,1,0.0,1,buy,0,sell,0.4981543075921684,14,0,0,block 2 (G first),20.0,11.0,Male,1.0,1.0,1.0,"[4, 'block 2 (G first)']",0,1,0,0.0,6.0,-0.31666666666666665,0.2,0.36363636363636365,0.5,0.0,2,1.0,0.5,Design 1,Design 1,"Have an option between Design #1 and Design #2,",2.0,,
671,275,4,Player object (1090),buy,2023-02-25 00:26:24.295950+00:00,"{""priceA"": 100, ""sharesA"": 1, ""secs_since_round_starts"": 199, ""market"": ""A""}",70.0,35.0,12.0,7jonfg2l,vmu7c279,FULL STUDY,195.0,s2,1,100,95.0,-1,,1,sell,0,sell,0.5337204628349665,14,0,0,block 2 (G first),20.0,11.0,Male,1.0,1.0,1.0,"[4, 'block 2 (G first)']",0,1,0,0.0,6.0,-0.31666666666666665,0.2,0.36363636363636365,0.5,0.0,2,1.0,0.5,Design 1,Design 1,"Have an option between Design #1 and Design #2,",2.0,,
672,276,4,Player object (1090),sell,2023-02-25 00:26:29.347196+00:00,"{""priceA"": 85, ""sharesA"": 0, ""secs_since_round_starts"": 204, ""market"": ""A""}",155.0,36.0,13.0,7jonfg2l,vmu7c279,FULL STUDY,195.0,s2,1,85,100.0,1,-15.0,1,buy,0,sell,0.4885269486642424,14,0,0,block 2 (G first),20.0,11.0,Male,1.0,1.0,1.0,"[4, 'block 2 (G first)']",0,1,0,0.0,6.0,-0.31666666666666665,0.2,0.36363636363636365,0.5,0.0,2,1.0,0.5,Design 1,Design 1,"Have an option between Design #1 and Design #2,",2.0,,
673,277,4,Player object (1090),buy,2023-02-25 00:26:45.078328+00:00,"{""priceA"": 80, ""sharesA"": 1, ""secs_since_round_starts"": 220, ""market"": ""A""}",75.0,39.0,14.0,7jonfg2l,vmu7c279,FULL STUDY,195.0,s2,1,80,85.0,-1,,1,sell,0,sell,0.4897180556691627,14,0,0,block 2 (G first),20.0,11.0,Male,1.0,1.0,1.0,"[4, 'block 2 (G first)']",0,1,0,0.0,6.0,-0.31666666666666665,0.2,0.36363636363636365,0.5,0.0,2,1.0,0.5,Design 1,Design 1,"Have an option between Design #1 and Design #2,",2.0,,
674,278,4,Player object (1090),sell,2023-02-25 00:26:51.004477+00:00,"{""priceA"": 75, ""sharesA"": 0, ""secs_since_round_starts"": 226, ""market"": ""A""}",150.0,40.0,15.0,7jonfg2l,vmu7c279,FULL STUDY,195.0,s2,1,75,80.0,1,-5.0,1,buy,0,sell,0.4578892350765483,14,0,0,block 2 (G first),20.0,11.0,Male,1.0,1.0,1.0,"[4, 'block 2 (G first)']",0,1,0,0.0,6.0,-0.31666666666666665,0.2,0.36363636363636365,0.5,0.0,2,1.0,0.5,Design 1,Design 1,"Have an option between Design #1 and Design #2,",2.0,,
675,279,4,Player object (1090),buy,2023-02-25 00:26:56.101690+00:00,"{""priceA"": 80, ""sharesA"": 1, ""secs_since_round_starts"": 231, ""market"": ""A""}",70.0,41.0,16.0,7jonfg2l,vmu7c279,FULL STUDY,195.0,s2,1,80,75.0,-1,,1,sell,0,sell,0.5055693706451859,14,0,0,block 2 (G first),20.0,11.0,Male,1.0,1.0,1.0,"[4, 'block 2 (G first)']",0,1,0,0.0,6.0,-0.31666666666666665,0.2,0.36363636363636365,0.5,0.0,2,1.0,0.5,Design 1,Design 1,"Have an option between Design #1 and Design #2,",2.0,,
676,280,4,Player object (1090),sell,2023-02-25 00:27:08.552184+00:00,"{""priceA"": 100, ""sharesA"": 0, ""secs_since_round_starts"": 243, ""market"": ""A""}",170.0,43.0,17.0,7jonfg2l,vmu7c279,FULL STUDY,195.0,s2,1,100,80.0,1,20.0,1,buy,0,sell,0.5617190733230237,14,0,1,block 2 (G first),20.0,11.0,Male,1.0,1.0,1.0,"[4, 'block 2 (G first)']",0,1,0,0.0,6.0,-0.31666666666666665,0.2,0.36363636363636365,0.5,0.0,2,1.0,0.5,Design 1,Design 1,"Have an option between Design #1 and Design #2,",2.0,,
677,281,4,Player object (1090),buy,2023-02-25 00:27:34.748472+00:00,"{""priceA"": 100, ""sharesA"": 1, ""secs_since_round_starts"": 269, ""market"": ""A""}",70.0,48.0,18.0,7jonfg2l,vmu7c279,FULL STUDY,195.0,s2,1,100,100.0,-1,,1,sell,0,sell,0.500105737602651,14,0,0,block 2 (G first),20.0,11.0,Male,1.0,1.0,1.0,"[4, 'block 2 (G first)']",0,1,0,0.0,6.0,-0.31666666666666665,0.2,0.36363636363636365,0.5,0.0,2,1.0,0.5,Design 1,Design 1,"Have an option between Design #1 and Design #2,",2.0,,
678,282,4,Player object (1090),sell,2023-02-25 00:27:47.916002+00:00,"{""priceA"": 120, ""sharesA"": 0, ""secs_since_round_starts"": 283, ""market"": ""A""}",190.0,50.0,19.0,7jonfg2l,vmu7c279,FULL STUDY,195.0,s2,1,120,100.0,1,20.0,1,buy,0,sell,0.5591364702939366,14,0,1,block 2 (G first),20.0,11.0,Male,1.0,1.0,1.0,"[4, 'block 2 (G first)']",0,1,0,0.0,6.0,-0.31666666666666665,0.2,0.36363636363636365,0.5,0.0,2,1.0,0.5,Design 1,Design 1,"Have an option between Design #1 and Design #2,",2.0,,
679,283,4,Player object (1090),buy,2023-02-25 00:28:07.555842+00:00,"{""priceA"": 85, ""sharesA"": 1, ""secs_since_round_starts"": 302, ""market"": ""A""}",105.0,54.0,20.0,7jonfg2l,vmu7c279,FULL STUDY,195.0,s2,1,85,120.0,-1,,1,sell,0,sell,0.4957421237757241,14,0,0,block 2 (G first),20.0,11.0,Male,1.0,1.0,1.0,"[4, 'block 2 (G first)']",0,1,0,0.0,6.0,-0.31666666666666665,0.2,0.36363636363636365,0.5,0.0,2,1.0,0.5,Design 1,Design 1,"Have an option between Design #1 and Design #2,",2.0,,
680,284,4,Player object (1090),sell,2023-02-25 00:28:13.801488+00:00,"{""priceA"": 70, ""sharesA"": 0, ""secs_since_round_starts"": 308, ""market"": ""A""}",175.0,55.0,21.0,7jonfg2l,vmu7c279,FULL STUDY,195.0,s2,1,70,85.0,1,-15.0,1,buy,0,sell,0.4620518023886796,14,0,0,block 2 (G first),20.0,11.0,Male,1.0,1.0,1.0,"[4, 'block 2 (G first)']",0,1,0,0.0,6.0,-0.31666666666666665,0.2,0.36363636363636365,0.5,0.0,2,1.0,0.5,Design 1,Design 1,"Have an option between Design #1 and Design #2,",2.0,,
681,285,4,Player object (1090),buy,2023-02-25 00:28:28.677772+00:00,"{""priceA"": 55, ""sharesA"": 1, ""secs_since_round_starts"": 323, ""market"": ""A""}",120.0,57.0,22.0,7jonfg2l,vmu7c279,FULL STUDY,195.0,s2,1,55,70.0,-1,,1,sell,0,sell,0.4231688687101841,14,1,0,block 2 (G first),20.0,11.0,Male,1.0,1.0,1.0,"[4, 'block 2 (G first)']",0,1,0,0.0,6.0,-0.31666666666666665,0.2,0.36363636363636365,0.5,0.0,2,1.0,0.5,Design 1,Design 1,"Have an option between Design #1 and Design #2,",2.0,,
682,2523,2,Player object (913),sell,2023-03-08 07:01:02.315263+00:00,"{""priceA"": 110, ""sharesA"": 0, ""secs_since_round_starts"": 27, ""market"": ""A""}",160.0,6.0,1.0,7qzgrb99,vmu7c279,FULL STUDY,190.0,s1,1,110,,1,,1,,0,sell,0.5028735207100592,16,0,0,block 1 (G first),22.0,11.0,Male,1.0,1.0,1.0,"[2, 'block 1 (G first)']",1,0,0,0.5,7.0,-0.21666666666666667,0.4,0.03225806451612903,0.5,0.125,4,1.0,0.5,Design 1,Design 2,"Have an option between Design #1 and Design #2,",,4.0,2.0
683,2524,2,Player object (913),buy,2023-03-08 07:01:08.192059+00:00,"{""priceA"": 100, ""sharesA"": 1, ""secs_since_round_starts"": 33, ""market"": ""A""}",60.0,7.0,2.0,7qzgrb99,vmu7c279,FULL STUDY,190.0,s1,1,100,110.0,-1,,1,sell,0,sell,0.4669924949471701,16,0,0,block 1 (G first),22.0,11.0,Male,1.0,1.0,1.0,"[2, 'block 1 (G first)']",1,0,0,0.5,7.0,-0.21666666666666667,0.4,0.03225806451612903,0.5,0.125,4,1.0,0.5,Design 1,Design 2,"Have an option between Design #1 and Design #2,",,4.0,2.0
684,2525,2,Player object (913),sell,2023-03-08 07:02:09.440839+00:00,"{""priceA"": 125, ""sharesA"": 0, ""secs_since_round_starts"": 94, ""market"": ""A""}",185.0,18.0,3.0,7qzgrb99,vmu7c279,FULL STUDY,190.0,s1,1,125,100.0,1,25.0,1,buy,0,sell,0.5678304910935957,16,0,0,block 1 (G first),22.0,11.0,Male,1.0,1.0,1.0,"[2, 'block 1 (G first)']",1,0,0,0.5,7.0,-0.21666666666666667,0.4,0.03225806451612903,0.5,0.125,4,1.0,0.5,Design 1,Design 2,"Have an option between Design #1 and Design #2,",,4.0,2.0
685,2526,2,Player object (913),buy,2023-03-08 07:02:48.766911+00:00,"{""priceA"": 145, ""sharesA"": 1, ""secs_since_round_starts"": 133, ""market"": ""A""}",40.0,25.0,4.0,7qzgrb99,vmu7c279,FULL STUDY,190.0,s1,1,145,125.0,-1,,1,sell,0,sell,0.5294358264188312,16,0,0,block 1 (G first),22.0,11.0,Male,1.0,1.0,1.0,"[2, 'block 1 (G first)']",1,0,0,0.5,7.0,-0.21666666666666667,0.4,0.03225806451612903,0.5,0.125,4,1.0,0.5,Design 1,Design 2,"Have an option between Design #1 and Design #2,",,4.0,2.0
686,2528,2,Player object (913),sell,2023-03-08 07:04:46.238971+00:00,"{""priceA"": 155, ""sharesA"": 0, ""secs_since_round_starts"": 251, ""market"": ""A""}",195.0,46.0,5.0,7qzgrb99,vmu7c279,FULL STUDY,190.0,s1,1,155,145.0,1,10.0,1,buy,0,sell,0.5495494947508355,16,0,1,block 1 (G first),22.0,11.0,Male,1.0,1.0,1.0,"[2, 'block 1 (G first)']",1,0,0,0.5,7.0,-0.21666666666666667,0.4,0.03225806451612903,0.5,0.125,4,1.0,0.5,Design 1,Design 2,"Have an option between Design #1 and Design #2,",,4.0,2.0
687,2529,2,Player object (913),buy,2023-03-08 07:05:14.380959+00:00,"{""priceA"": 140, ""sharesA"": 1, ""secs_since_round_starts"": 279, ""market"": ""A""}",55.0,51.0,6.0,7qzgrb99,vmu7c279,FULL STUDY,190.0,s1,1,140,155.0,-1,,1,sell,0,sell,0.4693918893964308,16,0,0,block 1 (G first),22.0,11.0,Male,1.0,1.0,1.0,"[2, 'block 1 (G first)']",1,0,0,0.5,7.0,-0.21666666666666667,0.4,0.03225806451612903,0.5,0.125,4,1.0,0.5,Design 1,Design 2,"Have an option between Design #1 and Design #2,",,4.0,2.0
688,2530,2,Player object (913),sell,2023-03-08 07:05:31.108793+00:00,"{""priceA"": 145, ""sharesA"": 0, ""secs_since_round_starts"": 296, ""market"": ""A""}",200.0,54.0,7.0,7qzgrb99,vmu7c279,FULL STUDY,190.0,s1,1,145,140.0,1,5.0,1,buy,0,sell,0.5320134037503595,16,0,0,block 1 (G first),22.0,11.0,Male,1.0,1.0,1.0,"[2, 'block 1 (G first)']",1,0,0,0.5,7.0,-0.21666666666666667,0.4,0.03225806451612903,0.5,0.125,4,1.0,0.5,Design 1,Design 2,"Have an option between Design #1 and Design #2,",,4.0,2.0
689,2531,2,Player object (913),buy,2023-03-08 07:05:36.007747+00:00,"{""priceA"": 135, ""sharesA"": 1, ""secs_since_round_starts"": 300, ""market"": ""A""}",65.0,55.0,8.0,7qzgrb99,vmu7c279,FULL STUDY,190.0,s1,1,135,145.0,-1,,1,sell,0,sell,0.4873282494519479,16,0,0,block 1 (G first),22.0,11.0,Male,1.0,1.0,1.0,"[2, 'block 1 (G first)']",1,0,0,0.5,7.0,-0.21666666666666667,0.4,0.03225806451612903,0.5,0.125,4,1.0,0.5,Design 1,Design 2,"Have an option between Design #1 and Design #2,",,4.0,2.0
690,2532,2,Player object (913),sell,2023-03-08 07:06:05.259325+00:00,"{""priceA"": 125, ""sharesA"": 0, ""secs_since_round_starts"": 330, ""market"": ""A""}",190.0,60.0,9.0,7qzgrb99,vmu7c279,FULL STUDY,190.0,s1,1,125,135.0,1,-10.0,1,buy,0,sell,0.5540089061739091,16,0,1,block 1 (G first),22.0,11.0,Male,1.0,1.0,1.0,"[2, 'block 1 (G first)']",1,0,0,0.5,7.0,-0.21666666666666667,0.4,0.03225806451612903,0.5,0.125,4,1.0,0.5,Design 1,Design 2,"Have an option between Design #1 and Design #2,",,4.0,2.0
691,2536,3,Player object (1033),sell,2023-03-08 07:06:46.540736+00:00,"{""priceA"": 100, ""sharesA"": 0, ""secs_since_round_starts"": 36, ""market"": ""A""}",150.0,8.0,1.0,7qzgrb99,vmu7c279,FULL STUDY,230.0,s1,1,100,,1,,1,,0,sell,0.5057155770500936,19,0,0,block 1 (G first),22.0,11.0,Male,1.0,1.0,1.0,"[3, 'block 1 (G first)']",1,1,0,0.5,7.0,-0.21666666666666667,0.8181818181818182,0.2222222222222222,1.0,0.0,2,0.5,0.75,Design 1,Design 2,"Have an option between Design #1 and Design #2,",,4.0,2.0
692,2537,3,Player object (1033),buy,2023-03-08 07:07:25.919571+00:00,"{""priceA"": 110, ""sharesA"": 1, ""secs_since_round_starts"": 75, ""market"": ""A""}",40.0,15.0,2.0,7qzgrb99,vmu7c279,FULL STUDY,230.0,s1,1,110,100.0,-1,,1,sell,0,sell,0.4763410641166328,19,0,0,block 1 (G first),22.0,11.0,Male,1.0,1.0,1.0,"[3, 'block 1 (G first)']",1,1,0,0.5,7.0,-0.21666666666666667,0.8181818181818182,0.2222222222222222,1.0,0.0,2,0.5,0.75,Design 1,Design 2,"Have an option between Design #1 and Design #2,",,4.0,2.0
693,2538,3,Player object (1033),sell,2023-03-08 07:07:47.817775+00:00,"{""priceA"": 120, ""sharesA"": 0, ""secs_since_round_starts"": 97, ""market"": ""A""}",160.0,19.0,3.0,7qzgrb99,vmu7c279,FULL STUDY,230.0,s1,1,120,110.0,1,10.0,1,buy,0,sell,0.5586446427659006,19,0,1,block 1 (G first),22.0,11.0,Male,1.0,1.0,1.0,"[3, 'block 1 (G first)']",1,1,0,0.5,7.0,-0.21666666666666667,0.8181818181818182,0.2222222222222222,1.0,0.0,2,0.5,0.75,Design 1,Design 2,"Have an option between Design #1 and Design #2,",,4.0,2.0
694,2539,3,Player object (1033),buy,2023-03-08 07:07:57.616179+00:00,"{""priceA"": 100, ""sharesA"": 1, ""secs_since_round_starts"": 107, ""market"": ""A""}",60.0,21.0,4.0,7qzgrb99,vmu7c279,FULL STUDY,230.0,s1,1,100,120.0,-1,,1,sell,0,sell,0.4692484881524699,19,0,0,block 1 (G first),22.0,11.0,Male,1.0,1.0,1.0,"[3, 'block 1 (G first)']",1,1,0,0.5,7.0,-0.21666666666666667,0.8181818181818182,0.2222222222222222,1.0,0.0,2,0.5,0.75,Design 1,Design 2,"Have an option between Design #1 and Design #2,",,4.0,2.0
695,2540,3,Player object (1033),sell,2023-03-08 07:08:14.821834+00:00,"{""priceA"": 115, ""sharesA"": 0, ""secs_since_round_starts"": 124, ""market"": ""A""}",175.0,24.0,5.0,7qzgrb99,vmu7c279,FULL STUDY,230.0,s1,1,115,100.0,1,15.0,1,buy,0,sell,0.5319650978870379,19,0,0,block 1 (G first),22.0,11.0,Male,1.0,1.0,1.0,"[3, 'block 1 (G first)']",1,1,0,0.5,7.0,-0.21666666666666667,0.8181818181818182,0.2222222222222222,1.0,0.0,2,0.5,0.75,Design 1,Design 2,"Have an option between Design #1 and Design #2,",,4.0,2.0
696,2541,3,Player object (1033),buy,2023-03-08 07:08:20.990724+00:00,"{""priceA"": 110, ""sharesA"": 1, ""secs_since_round_starts"": 130, ""market"": ""A""}",65.0,25.0,6.0,7qzgrb99,vmu7c279,FULL STUDY,230.0,s1,1,110,115.0,-1,,1,sell,0,sell,0.4872943409941583,19,0,0,block 1 (G first),22.0,11.0,Male,1.0,1.0,1.0,"[3, 'block 1 (G first)']",1,1,0,0.5,7.0,-0.21666666666666667,0.8181818181818182,0.2222222222222222,1.0,0.0,2,0.5,0.75,Design 1,Design 2,"Have an option between Design #1 and Design #2,",,4.0,2.0
697,2542,3,Player object (1033),sell,2023-03-08 07:08:25.455637+00:00,"{""priceA"": 115, ""sharesA"": 0, ""secs_since_round_starts"": 135, ""market"": ""A""}",180.0,26.0,7.0,7qzgrb99,vmu7c279,FULL STUDY,230.0,s1,1,115,110.0,1,5.0,1,buy,0,sell,0.526172546586359,19,0,0,block 1 (G first),22.0,11.0,Male,1.0,1.0,1.0,"[3, 'block 1 (G first)']",1,1,0,0.5,7.0,-0.21666666666666667,0.8181818181818182,0.2222222222222222,1.0,0.0,2,0.5,0.75,Design 1,Design 2,"Have an option between Design #1 and Design #2,",,4.0,2.0
698,2543,3,Player object (1033),buy,2023-03-08 07:08:30.604469+00:00,"{""priceA"": 105, ""sharesA"": 1, ""secs_since_round_starts"": 140, ""market"": ""A""}",75.0,27.0,8.0,7qzgrb99,vmu7c279,FULL STUDY,230.0,s1,1,105,115.0,-1,,1,sell,0,sell,0.4832330156747784,19,0,0,block 1 (G first),22.0,11.0,Male,1.0,1.0,1.0,"[3, 'block 1 (G first)']",1,1,0,0.5,7.0,-0.21666666666666667,0.8181818181818182,0.2222222222222222,1.0,0.0,2,0.5,0.75,Design 1,Design 2,"Have an option between Design #1 and Design #2,",,4.0,2.0
699,2544,3,Player object (1033),sell,2023-03-08 07:08:36.584165+00:00,"{""priceA"": 110, ""sharesA"": 0, ""secs_since_round_starts"": 146, ""market"": ""A""}",185.0,28.0,9.0,7qzgrb99,vmu7c279,FULL STUDY,230.0,s1,1,110,105.0,1,5.0,1,buy,0,sell,0.5233413838959273,19,0,0,block 1 (G first),22.0,11.0,Male,1.0,1.0,1.0,"[3, 'block 1 (G first)']",1,1,0,0.5,7.0,-0.21666666666666667,0.8181818181818182,0.2222222222222222,1.0,0.0,2,0.5,0.75,Design 1,Design 2,"Have an option between Design #1 and Design #2,",,4.0,2.0
700,2545,3,Player object (1033),buy,2023-03-08 07:08:42.378830+00:00,"{""priceA"": 115, ""sharesA"": 1, ""secs_since_round_starts"": 152, ""market"": ""A""}",70.0,29.0,10.0,7qzgrb99,vmu7c279,FULL STUDY,230.0,s1,1,115,110.0,-1,,1,sell,0,sell,0.5511004178331719,19,0,0,block 1 (G first),22.0,11.0,Male,1.0,1.0,1.0,"[3, 'block 1 (G first)']",1,1,0,0.5,7.0,-0.21666666666666667,0.8181818181818182,0.2222222222222222,1.0,0.0,2,0.5,0.75,Design 1,Design 2,"Have an option between Design #1 and Design #2,",,4.0,2.0
701,2547,3,Player object (1033),sell,2023-03-08 07:08:53.246076+00:00,"{""priceA"": 120, ""sharesA"": 0, ""secs_since_round_starts"": 162, ""market"": ""A""}",190.0,30.0,11.0,7qzgrb99,vmu7c279,FULL STUDY,230.0,s1,1,120,115.0,1,5.0,1,buy,0,sell,0.570054331362491,19,0,1,block 1 (G first),22.0,11.0,Male,1.0,1.0,1.0,"[3, 'block 1 (G first)']",1,1,0,0.5,7.0,-0.21666666666666667,0.8181818181818182,0.2222222222222222,1.0,0.0,2,0.5,0.75,Design 1,Design 2,"Have an option between Design #1 and Design #2,",,4.0,2.0
702,2549,3,Player object (1033),buy,2023-03-08 07:09:11.830937+00:00,"{""priceA"": 100, ""sharesA"": 1, ""secs_since_round_starts"": 181, ""market"": ""A""}",90.0,33.0,12.0,7qzgrb99,vmu7c279,FULL STUDY,230.0,s1,1,100,120.0,-1,,1,sell,0,sell,0.4476889957041811,19,1,0,block 1 (G first),22.0,11.0,Male,1.0,1.0,1.0,"[3, 'block 1 (G first)']",1,1,0,0.5,7.0,-0.21666666666666667,0.8181818181818182,0.2222222222222222,1.0,0.0,2,0.5,0.75,Design 1,Design 2,"Have an option between Design #1 and Design #2,",,4.0,2.0
703,2550,3,Player object (1033),sell,2023-03-08 07:09:16.591535+00:00,"{""priceA"": 110, ""sharesA"": 0, ""secs_since_round_starts"": 186, ""market"": ""A""}",200.0,34.0,13.0,7qzgrb99,vmu7c279,FULL STUDY,230.0,s1,1,110,100.0,1,10.0,1,buy,0,sell,0.4983651933170437,19,0,0,block 1 (G first),22.0,11.0,Male,1.0,1.0,1.0,"[3, 'block 1 (G first)']",1,1,0,0.5,7.0,-0.21666666666666667,0.8181818181818182,0.2222222222222222,1.0,0.0,2,0.5,0.75,Design 1,Design 2,"Have an option between Design #1 and Design #2,",,4.0,2.0
704,2551,3,Player object (1033),buy,2023-03-08 07:09:21.594072+00:00,"{""priceA"": 105, ""sharesA"": 1, ""secs_since_round_starts"": 191, ""market"": ""A""}",95.0,35.0,14.0,7qzgrb99,vmu7c279,FULL STUDY,230.0,s1,1,105,110.0,-1,,1,sell,0,sell,0.463867449269012,19,0,0,block 1 (G first),22.0,11.0,Male,1.0,1.0,1.0,"[3, 'block 1 (G first)']",1,1,0,0.5,7.0,-0.21666666666666667,0.8181818181818182,0.2222222222222222,1.0,0.0,2,0.5,0.75,Design 1,Design 2,"Have an option between Design #1 and Design #2,",,4.0,2.0
705,2552,3,Player object (1033),sell,2023-03-08 07:09:27.845327+00:00,"{""priceA"": 100, ""sharesA"": 0, ""secs_since_round_starts"": 197, ""market"": ""A""}",195.0,36.0,15.0,7qzgrb99,vmu7c279,FULL STUDY,230.0,s1,1,100,105.0,1,-5.0,1,buy,0,sell,0.440139794868048,19,0,0,block 1 (G first),22.0,11.0,Male,1.0,1.0,1.0,"[3, 'block 1 (G first)']",1,1,0,0.5,7.0,-0.21666666666666667,0.8181818181818182,0.2222222222222222,1.0,0.0,2,0.5,0.75,Design 1,Design 2,"Have an option between Design #1 and Design #2,",,4.0,2.0
706,2554,3,Player object (1033),buy,2023-03-08 07:09:37.429693+00:00,"{""priceA"": 95, ""sharesA"": 1, ""secs_since_round_starts"": 207, ""market"": ""A""}",100.0,37.0,16.0,7qzgrb99,vmu7c279,FULL STUDY,230.0,s1,1,95,100.0,-1,,1,sell,0,sell,0.4240076400585448,19,1,0,block 1 (G first),22.0,11.0,Male,1.0,1.0,1.0,"[3, 'block 1 (G first)']",1,1,0,0.5,7.0,-0.21666666666666667,0.8181818181818182,0.2222222222222222,1.0,0.0,2,0.5,0.75,Design 1,Design 2,"Have an option between Design #1 and Design #2,",,4.0,2.0
707,2555,3,Player object (1033),sell,2023-03-08 07:09:49.760308+00:00,"{""priceA"": 115, ""sharesA"": 0, ""secs_since_round_starts"": 219, ""market"": ""A""}",215.0,39.0,17.0,7qzgrb99,vmu7c279,FULL STUDY,230.0,s1,1,115,95.0,1,20.0,1,buy,0,sell,0.5221490272476892,19,0,0,block 1 (G first),22.0,11.0,Male,1.0,1.0,1.0,"[3, 'block 1 (G first)']",1,1,0,0.5,7.0,-0.21666666666666667,0.8181818181818182,0.2222222222222222,1.0,0.0,2,0.5,0.75,Design 1,Design 2,"Have an option between Design #1 and Design #2,",,4.0,2.0
708,2556,3,Player object (1033),buy,2023-03-08 07:09:53.961448+00:00,"{""priceA"": 100, ""sharesA"": 1, ""secs_since_round_starts"": 223, ""market"": ""A""}",115.0,40.0,18.0,7qzgrb99,vmu7c279,FULL STUDY,230.0,s1,1,100,115.0,-1,,1,sell,0,sell,0.4804175727303482,19,0,0,block 1 (G first),22.0,11.0,Male,1.0,1.0,1.0,"[3, 'block 1 (G first)']",1,1,0,0.5,7.0,-0.21666666666666667,0.8181818181818182,0.2222222222222222,1.0,0.0,2,0.5,0.75,Design 1,Design 2,"Have an option between Design #1 and Design #2,",,4.0,2.0
709,2557,3,Player object (1033),sell,2023-03-08 07:10:05.461726+00:00,"{""priceA"": 105, ""sharesA"": 0, ""secs_since_round_starts"": 235, ""market"": ""A""}",220.0,42.0,19.0,7qzgrb99,vmu7c279,FULL STUDY,230.0,s1,1,105,100.0,1,5.0,1,buy,0,sell,0.5010477910686952,19,0,0,block 1 (G first),22.0,11.0,Male,1.0,1.0,1.0,"[3, 'block 1 (G first)']",1,1,0,0.5,7.0,-0.21666666666666667,0.8181818181818182,0.2222222222222222,1.0,0.0,2,0.5,0.75,Design 1,Design 2,"Have an option between Design #1 and Design #2,",,4.0,2.0
710,2558,3,Player object (1033),buy,2023-03-08 07:10:43.440398+00:00,"{""priceA"": 110, ""sharesA"": 1, ""secs_since_round_starts"": 273, ""market"": ""A""}",110.0,49.0,20.0,7qzgrb99,vmu7c279,FULL STUDY,230.0,s1,1,110,105.0,-1,,1,sell,0,sell,0.4374794566672981,19,1,0,block 1 (G first),22.0,11.0,Male,1.0,1.0,1.0,"[3, 'block 1 (G first)']",1,1,0,0.5,7.0,-0.21666666666666667,0.8181818181818182,0.2222222222222222,1.0,0.0,2,0.5,0.75,Design 1,Design 2,"Have an option between Design #1 and Design #2,",,4.0,2.0
711,2560,3,Player object (1033),sell,2023-03-08 07:10:53.816937+00:00,"{""priceA"": 125, ""sharesA"": 0, ""secs_since_round_starts"": 283, ""market"": ""A""}",235.0,50.0,21.0,7qzgrb99,vmu7c279,FULL STUDY,230.0,s1,1,125,110.0,1,15.0,1,buy,0,sell,0.4911246412164243,19,0,0,block 1 (G first),22.0,11.0,Male,1.0,1.0,1.0,"[3, 'block 1 (G first)']",1,1,0,0.5,7.0,-0.21666666666666667,0.8181818181818182,0.2222222222222222,1.0,0.0,2,0.5,0.75,Design 1,Design 2,"Have an option between Design #1 and Design #2,",,4.0,2.0
712,2561,3,Player object (1033),buy,2023-03-08 07:10:59.163051+00:00,"{""priceA"": 120, ""sharesA"": 1, ""secs_since_round_starts"": 288, ""market"": ""A""}",115.0,51.0,22.0,7qzgrb99,vmu7c279,FULL STUDY,230.0,s1,1,120,125.0,-1,,1,sell,0,sell,0.4588602748157505,19,0,0,block 1 (G first),22.0,11.0,Male,1.0,1.0,1.0,"[3, 'block 1 (G first)']",1,1,0,0.5,7.0,-0.21666666666666667,0.8181818181818182,0.2222222222222222,1.0,0.0,2,0.5,0.75,Design 1,Design 2,"Have an option between Design #1 and Design #2,",,4.0,2.0
713,2562,3,Player object (1033),sell,2023-03-08 07:11:05.305302+00:00,"{""priceA"": 115, ""sharesA"": 0, ""secs_since_round_starts"": 295, ""market"": ""A""}",230.0,52.0,23.0,7qzgrb99,vmu7c279,FULL STUDY,230.0,s1,1,115,120.0,1,-5.0,1,buy,0,sell,0.4367228334197354,19,0,0,block 1 (G first),22.0,11.0,Male,1.0,1.0,1.0,"[3, 'block 1 (G first)']",1,1,0,0.5,7.0,-0.21666666666666667,0.8181818181818182,0.2222222222222222,1.0,0.0,2,0.5,0.75,Design 1,Design 2,"Have an option between Design #1 and Design #2,",,4.0,2.0
714,2563,3,Player object (1033),buy,2023-03-08 07:11:37.394443+00:00,"{""priceA"": 115, ""sharesA"": 1, ""secs_since_round_starts"": 327, ""market"": ""A""}",115.0,58.0,24.0,7qzgrb99,vmu7c279,FULL STUDY,230.0,s1,1,115,115.0,-1,,1,sell,0,sell,0.442461876115205,19,1,0,block 1 (G first),22.0,11.0,Male,1.0,1.0,1.0,"[3, 'block 1 (G first)']",1,1,0,0.5,7.0,-0.21666666666666667,0.8181818181818182,0.2222222222222222,1.0,0.0,2,0.5,0.75,Design 1,Design 2,"Have an option between Design #1 and Design #2,",,4.0,2.0
715,2567,4,Player object (1153),sell,2023-03-08 07:12:40.770124+00:00,"{""priceA"": 80, ""sharesA"": 0, ""secs_since_round_starts"": 46, ""market"": ""A""}",130.0,10.0,1.0,7qzgrb99,vmu7c279,FULL STUDY,120.0,s1,1,80,,1,,1,,0,sell,0.5652817482669988,14,0,0,block 1 (G first),22.0,11.0,Male,1.0,1.0,1.0,"[4, 'block 1 (G first)']",0,0,0,0.5,7.0,-0.21666666666666667,0.0,0.045454545454545456,,0.0,2,1.0,0.25,Design 1,Design 2,"Have an option between Design #1 and Design #2,",,4.0,2.0
716,2568,4,Player object (1153),buy,2023-03-08 07:13:19.257511+00:00,"{""priceA"": 85, ""sharesA"": 1, ""secs_since_round_starts"": 85, ""market"": ""A""}",45.0,17.0,2.0,7qzgrb99,vmu7c279,FULL STUDY,120.0,s1,1,85,80.0,-1,,1,sell,0,sell,0.4647046911342559,14,0,0,block 1 (G first),22.0,11.0,Male,1.0,1.0,1.0,"[4, 'block 1 (G first)']",0,0,0,0.5,7.0,-0.21666666666666667,0.0,0.045454545454545456,,0.0,2,1.0,0.25,Design 1,Design 2,"Have an option between Design #1 and Design #2,",,4.0,2.0
717,2569,4,Player object (1153),sell,2023-03-08 07:14:30.619078+00:00,"{""priceA"": 85, ""sharesA"": 0, ""secs_since_round_starts"": 156, ""market"": ""A""}",130.0,30.0,3.0,7qzgrb99,vmu7c279,FULL STUDY,120.0,s1,1,85,85.0,1,0.0,1,buy,0,sell,0.5151109892827086,14,0,0,block 1 (G first),22.0,11.0,Male,1.0,1.0,1.0,"[4, 'block 1 (G first)']",0,0,0,0.5,7.0,-0.21666666666666667,0.0,0.045454545454545456,,0.0,2,1.0,0.25,Design 1,Design 2,"Have an option between Design #1 and Design #2,",,4.0,2.0
718,2571,4,Player object (1153),buy,2023-03-08 07:16:41.446709+00:00,"{""priceA"": 85, ""sharesA"": 1, ""secs_since_round_starts"": 287, ""market"": ""A""}",45.0,54.0,4.0,7qzgrb99,vmu7c279,FULL STUDY,120.0,s1,1,85,85.0,-1,,1,sell,0,sell,0.4957421237757241,14,0,0,block 1 (G first),22.0,11.0,Male,1.0,1.0,1.0,"[4, 'block 1 (G first)']",0,0,0,0.5,7.0,-0.21666666666666667,0.0,0.045454545454545456,,0.0,2,1.0,0.25,Design 1,Design 2,"Have an option between Design #1 and Design #2,",,4.0,2.0
719,2575,5,Player object (1273),sell,2023-03-08 07:19:31.380030+00:00,"{""priceA"": 105, ""sharesA"": 0, ""secs_since_round_starts"": 124, ""market"": ""A""}",155.0,24.0,1.0,7qzgrb99,vmu7c279,FULL STUDY,250.0,s1,1,105,,1,,1,,0,sell,0.5594334008058068,17,0,0,block 1 (G first),22.0,11.0,Male,1.0,1.0,1.0,"[5, 'block 1 (G first)']",0,1,0,0.5,7.0,-0.21666666666666667,0.25,0.0,0.0,0.0,2,1.0,0.25,Design 1,Design 2,"Have an option between Design #1 and Design #2,",,4.0,2.0
720,2576,5,Player object (1273),buy,2023-03-08 07:19:58.502956+00:00,"{""priceA"": 80, ""sharesA"": 1, ""secs_since_round_starts"": 151, ""market"": ""A""}",75.0,29.0,2.0,7qzgrb99,vmu7c279,FULL STUDY,250.0,s1,1,80,105.0,-1,,1,sell,0,sell,0.4304345659865384,17,0,0,block 1 (G first),22.0,11.0,Male,1.0,1.0,1.0,"[5, 'block 1 (G first)']",0,1,0,0.5,7.0,-0.21666666666666667,0.25,0.0,0.0,0.0,2,1.0,0.25,Design 1,Design 2,"Have an option between Design #1 and Design #2,",,4.0,2.0
721,2578,5,Player object (1273),sell,2023-03-08 07:20:23.856976+00:00,"{""priceA"": 120, ""sharesA"": 0, ""secs_since_round_starts"": 176, ""market"": ""A""}",195.0,34.0,3.0,7qzgrb99,vmu7c279,FULL STUDY,250.0,s1,1,120,80.0,1,40.0,1,buy,0,sell,0.5679672812132522,17,0,0,block 1 (G first),22.0,11.0,Male,1.0,1.0,1.0,"[5, 'block 1 (G first)']",0,1,0,0.5,7.0,-0.21666666666666667,0.25,0.0,0.0,0.0,2,1.0,0.25,Design 1,Design 2,"Have an option between Design #1 and Design #2,",,4.0,2.0
722,2579,5,Player object (1273),buy,2023-03-08 07:20:51.059843+00:00,"{""priceA"": 70, ""sharesA"": 1, ""secs_since_round_starts"": 204, ""market"": ""A""}",125.0,39.0,4.0,7qzgrb99,vmu7c279,FULL STUDY,250.0,s1,1,70,120.0,-1,,1,sell,0,sell,0.4317803147869401,17,0,0,block 1 (G first),22.0,11.0,Male,1.0,1.0,1.0,"[5, 'block 1 (G first)']",0,1,0,0.5,7.0,-0.21666666666666667,0.25,0.0,0.0,0.0,2,1.0,0.25,Design 1,Design 2,"Have an option between Design #1 and Design #2,",,4.0,2.0
723,2580,5,Player object (1273),sell,2023-03-08 07:21:13.674869+00:00,"{""priceA"": 110, ""sharesA"": 0, ""secs_since_round_starts"": 226, ""market"": ""A""}",235.0,43.0,5.0,7qzgrb99,vmu7c279,FULL STUDY,250.0,s1,1,110,70.0,1,40.0,1,buy,0,sell,0.571300234525265,17,0,0,block 1 (G first),22.0,11.0,Male,1.0,1.0,1.0,"[5, 'block 1 (G first)']",0,1,0,0.5,7.0,-0.21666666666666667,0.25,0.0,0.0,0.0,2,1.0,0.25,Design 1,Design 2,"Have an option between Design #1 and Design #2,",,4.0,2.0
724,2581,5,Player object (1273),buy,2023-03-08 07:21:52.735230+00:00,"{""priceA"": 70, ""sharesA"": 1, ""secs_since_round_starts"": 265, ""market"": ""A""}",165.0,50.0,6.0,7qzgrb99,vmu7c279,FULL STUDY,250.0,s1,1,70,110.0,-1,,1,sell,0,sell,0.4597993338202879,17,0,0,block 1 (G first),22.0,11.0,Male,1.0,1.0,1.0,"[5, 'block 1 (G first)']",0,1,0,0.5,7.0,-0.21666666666666667,0.25,0.0,0.0,0.0,2,1.0,0.25,Design 1,Design 2,"Have an option between Design #1 and Design #2,",,4.0,2.0
725,2582,5,Player object (1273),sell,2023-03-08 07:22:26.209334+00:00,"{""priceA"": 95, ""sharesA"": 0, ""secs_since_round_starts"": 299, ""market"": ""A""}",260.0,56.0,7.0,7qzgrb99,vmu7c279,FULL STUDY,250.0,s1,1,95,70.0,1,25.0,1,buy,0,sell,0.5252108989343294,17,0,0,block 1 (G first),22.0,11.0,Male,1.0,1.0,1.0,"[5, 'block 1 (G first)']",0,1,0,0.5,7.0,-0.21666666666666667,0.25,0.0,0.0,0.0,2,1.0,0.25,Design 1,Design 2,"Have an option between Design #1 and Design #2,",,4.0,2.0
726,2583,5,Player object (1273),buy,2023-03-08 07:22:39.393441+00:00,"{""priceA"": 75, ""sharesA"": 1, ""secs_since_round_starts"": 312, ""market"": ""A""}",185.0,58.0,8.0,7qzgrb99,vmu7c279,FULL STUDY,250.0,s1,1,75,95.0,-1,,1,sell,0,sell,0.4529558772574278,17,0,0,block 1 (G first),22.0,11.0,Male,1.0,1.0,1.0,"[5, 'block 1 (G first)']",0,1,0,0.5,7.0,-0.21666666666666667,0.25,0.0,0.0,0.0,2,1.0,0.25,Design 1,Design 2,"Have an option between Design #1 and Design #2,",,4.0,2.0
727,5029,2,Player object (1507),sell,2023-03-10 12:31:10.333604+00:00,"{""priceA"": 85, ""sharesA"": 0, ""secs_since_round_starts"": 62, ""market"": ""A""}",135.0,8.0,1.0,8vfnqphr,t7od4xlw,FULL STUDY,225.0,s1,1,85,,1,,1,,0,sell,0.4422758127435268,16,1,0,block 2 (G first),23.0,12.0,Male,1.0,1.0,1.0,"[2, 'block 2 (G first)']",1,1,0,0.0,5.0,-0.5,0.2222222222222222,0.2,0.0,0.5,4,1.0,0.75,Design 1,Design 1,"Have an option between Design #1 and Design #2,",,1.0,3.0
728,5030,2,Player object (1507),buy,2023-03-10 12:31:15.270926+00:00,"{""priceA"": 70, ""sharesA"": 1, ""secs_since_round_starts"": 67, ""market"": ""A""}",65.0,9.0,2.0,8vfnqphr,t7od4xlw,FULL STUDY,225.0,s1,1,70,85.0,-1,,1,sell,0,sell,0.4254536939069079,16,0,0,block 2 (G first),23.0,12.0,Male,1.0,1.0,1.0,"[2, 'block 2 (G first)']",1,1,0,0.0,5.0,-0.5,0.2222222222222222,0.2,0.0,0.5,4,1.0,0.75,Design 1,Design 1,"Have an option between Design #1 and Design #2,",,1.0,3.0
729,5031,2,Player object (1507),sell,2023-03-10 12:31:51.976516+00:00,"{""priceA"": 105, ""sharesA"": 0, ""secs_since_round_starts"": 104, ""market"": ""A""}",170.0,16.0,3.0,8vfnqphr,t7od4xlw,FULL STUDY,225.0,s1,1,105,70.0,1,35.0,1,buy,0,sell,0.5185790363913291,16,0,0,block 2 (G first),23.0,12.0,Male,1.0,1.0,1.0,"[2, 'block 2 (G first)']",1,1,0,0.0,5.0,-0.5,0.2222222222222222,0.2,0.0,0.5,4,1.0,0.75,Design 1,Design 1,"Have an option between Design #1 and Design #2,",,1.0,3.0
730,5032,2,Player object (1507),buy,2023-03-10 12:33:06.627890+00:00,"{""priceA"": 125, ""sharesA"": 1, ""secs_since_round_starts"": 178, ""market"": ""A""}",45.0,30.0,4.0,8vfnqphr,t7od4xlw,FULL STUDY,225.0,s1,1,125,105.0,-1,,1,sell,0,sell,0.4785999259850118,16,0,0,block 2 (G first),23.0,12.0,Male,1.0,1.0,1.0,"[2, 'block 2 (G first)']",1,1,0,0.0,5.0,-0.5,0.2222222222222222,0.2,0.0,0.5,4,1.0,0.75,Design 1,Design 1,"Have an option between Design #1 and Design #2,",,1.0,3.0
731,5034,2,Player object (1507),sell,2023-03-10 12:33:54.461070+00:00,"{""priceA"": 145, ""sharesA"": 0, ""secs_since_round_starts"": 226, ""market"": ""A""}",190.0,37.0,5.0,8vfnqphr,t7od4xlw,FULL STUDY,225.0,s1,1,145,125.0,1,20.0,1,buy,0,sell,0.494384744736363,16,0,0,block 2 (G first),23.0,12.0,Male,1.0,1.0,1.0,"[2, 'block 2 (G first)']",1,1,0,0.0,5.0,-0.5,0.2222222222222222,0.2,0.0,0.5,4,1.0,0.75,Design 1,Design 1,"Have an option between Design #1 and Design #2,",,1.0,3.0
732,5035,2,Player object (1507),buy,2023-03-10 12:34:29.096362+00:00,"{""priceA"": 125, ""sharesA"": 1, ""secs_since_round_starts"": 261, ""market"": ""A""}",65.0,43.0,6.0,8vfnqphr,t7od4xlw,FULL STUDY,225.0,s1,1,125,145.0,-1,,1,sell,0,sell,0.4218732662739463,16,1,0,block 2 (G first),23.0,12.0,Male,1.0,1.0,1.0,"[2, 'block 2 (G first)']",1,1,0,0.0,5.0,-0.5,0.2222222222222222,0.2,0.0,0.5,4,1.0,0.75,Design 1,Design 1,"Have an option between Design #1 and Design #2,",,1.0,3.0
733,5037,2,Player object (1507),sell,2023-03-10 12:34:39.328401+00:00,"{""priceA"": 140, ""sharesA"": 0, ""secs_since_round_starts"": 271, ""market"": ""A""}",205.0,45.0,7.0,8vfnqphr,t7od4xlw,FULL STUDY,225.0,s1,1,140,125.0,1,15.0,1,buy,0,sell,0.5210834711709403,16,0,0,block 2 (G first),23.0,12.0,Male,1.0,1.0,1.0,"[2, 'block 2 (G first)']",1,1,0,0.0,5.0,-0.5,0.2222222222222222,0.2,0.0,0.5,4,1.0,0.75,Design 1,Design 1,"Have an option between Design #1 and Design #2,",,1.0,3.0
734,5041,2,Player object (1507),buy,2023-03-10 12:35:16.916708+00:00,"{""priceA"": 125, ""sharesA"": 1, ""secs_since_round_starts"": 309, ""market"": ""A""}",80.0,52.0,8.0,8vfnqphr,t7od4xlw,FULL STUDY,225.0,s1,1,125,140.0,-1,,1,sell,0,sell,0.4439176376077041,16,1,0,block 2 (G first),23.0,12.0,Male,1.0,1.0,1.0,"[2, 'block 2 (G first)']",1,1,0,0.0,5.0,-0.5,0.2222222222222222,0.2,0.0,0.5,4,1.0,0.75,Design 1,Design 1,"Have an option between Design #1 and Design #2,",,1.0,3.0
735,5043,2,Player object (1507),sell,2023-03-10 12:35:30.825496+00:00,"{""priceA"": 145, ""sharesA"": 0, ""secs_since_round_starts"": 322, ""market"": ""A""}",225.0,54.0,9.0,8vfnqphr,t7od4xlw,FULL STUDY,225.0,s1,1,145,125.0,1,20.0,1,buy,0,sell,0.5320134037503595,16,0,0,block 2 (G first),23.0,12.0,Male,1.0,1.0,1.0,"[2, 'block 2 (G first)']",1,1,0,0.0,5.0,-0.5,0.2222222222222222,0.2,0.0,0.5,4,1.0,0.75,Design 1,Design 1,"Have an option between Design #1 and Design #2,",,1.0,3.0
736,5045,2,Player object (1507),buy,2023-03-10 12:35:40.641175+00:00,"{""priceA"": 125, ""sharesA"": 1, ""secs_since_round_starts"": 332, ""market"": ""A""}",100.0,56.0,10.0,8vfnqphr,t7od4xlw,FULL STUDY,225.0,s1,1,125,145.0,-1,,1,sell,0,sell,0.4562406760637778,16,0,0,block 2 (G first),23.0,12.0,Male,1.0,1.0,1.0,"[2, 'block 2 (G first)']",1,1,0,0.0,5.0,-0.5,0.2222222222222222,0.2,0.0,0.5,4,1.0,0.75,Design 1,Design 1,"Have an option between Design #1 and Design #2,",,1.0,3.0
737,5052,3,Player object (1687),sell,2023-03-10 12:37:11.918519+00:00,"{""priceA"": 110, ""sharesA"": 0, ""secs_since_round_starts"": 57, ""market"": ""A""}",160.0,11.0,1.0,8vfnqphr,t7od4xlw,FULL STUDY,170.0,s1,1,110,,1,,1,,0,sell,0.5295922419004607,19,0,0,block 2 (G first),23.0,12.0,Male,1.0,1.0,1.0,"[3, 'block 2 (G first)']",1,0,0,0.5,5.0,-0.5,0.25,0.0,0.0,0.0,2,0.5,0.75,Design 1,Design 1,"Have an option between Design #1 and Design #2,",,1.0,3.0
738,5054,3,Player object (1687),buy,2023-03-10 12:37:42.444376+00:00,"{""priceA"": 105, ""sharesA"": 1, ""secs_since_round_starts"": 88, ""market"": ""A""}",55.0,17.0,2.0,8vfnqphr,t7od4xlw,FULL STUDY,170.0,s1,1,105,110.0,-1,,1,sell,0,sell,0.4990675303551922,19,0,0,block 2 (G first),23.0,12.0,Male,1.0,1.0,1.0,"[3, 'block 2 (G first)']",1,0,0,0.5,5.0,-0.5,0.25,0.0,0.0,0.0,2,0.5,0.75,Design 1,Design 1,"Have an option between Design #1 and Design #2,",,1.0,3.0
739,5065,3,Player object (1687),sell,2023-03-10 12:38:29.656827+00:00,"{""priceA"": 110, ""sharesA"": 0, ""secs_since_round_starts"": 135, ""market"": ""A""}",165.0,25.0,3.0,8vfnqphr,t7od4xlw,FULL STUDY,170.0,s1,1,110,105.0,1,5.0,1,buy,0,sell,0.4872943409941583,19,0,0,block 2 (G first),23.0,12.0,Male,1.0,1.0,1.0,"[3, 'block 2 (G first)']",1,0,0,0.5,5.0,-0.5,0.25,0.0,0.0,0.0,2,0.5,0.75,Design 1,Design 1,"Have an option between Design #1 and Design #2,",,1.0,3.0
740,5071,3,Player object (1687),buy,2023-03-10 12:39:20.636830+00:00,"{""priceA"": 100, ""sharesA"": 1, ""secs_since_round_starts"": 186, ""market"": ""A""}",65.0,33.0,4.0,8vfnqphr,t7od4xlw,FULL STUDY,170.0,s1,1,100,110.0,-1,,1,sell,0,sell,0.4476889957041811,19,1,0,block 2 (G first),23.0,12.0,Male,1.0,1.0,1.0,"[3, 'block 2 (G first)']",1,0,0,0.5,5.0,-0.5,0.25,0.0,0.0,0.0,2,0.5,0.75,Design 1,Design 1,"Have an option between Design #1 and Design #2,",,1.0,3.0
741,5072,3,Player object (1687),sell,2023-03-10 12:40:15.072088+00:00,"{""priceA"": 120, ""sharesA"": 0, ""secs_since_round_starts"": 240, ""market"": ""A""}",185.0,43.0,5.0,8vfnqphr,t7od4xlw,FULL STUDY,170.0,s1,1,120,100.0,1,20.0,1,buy,0,sell,0.5357259670782416,19,0,0,block 2 (G first),23.0,12.0,Male,1.0,1.0,1.0,"[3, 'block 2 (G first)']",1,0,0,0.5,5.0,-0.5,0.25,0.0,0.0,0.0,2,0.5,0.75,Design 1,Design 1,"Have an option between Design #1 and Design #2,",,1.0,3.0
742,5077,3,Player object (1687),buy,2023-03-10 12:41:33.280360+00:00,"{""priceA"": 130, ""sharesA"": 1, ""secs_since_round_starts"": 318, ""market"": ""A""}",55.0,57.0,6.0,8vfnqphr,t7od4xlw,FULL STUDY,170.0,s1,1,130,120.0,-1,,1,sell,0,sell,0.46726452652799,19,0,0,block 2 (G first),23.0,12.0,Male,1.0,1.0,1.0,"[3, 'block 2 (G first)']",1,0,0,0.5,5.0,-0.5,0.25,0.0,0.0,0.0,2,0.5,0.75,Design 1,Design 1,"Have an option between Design #1 and Design #2,",,1.0,3.0
743,5106,4,Player object (1867),sell,2023-03-10 12:44:34.077100+00:00,"{""priceA"": 85, ""sharesA"": 0, ""secs_since_round_starts"": 159, ""market"": ""A""}",135.0,30.0,1.0,8vfnqphr,t7od4xlw,FULL STUDY,165.0,s1,1,85,,1,,1,,0,sell,0.5151109892827086,14,0,0,block 2 (G first),23.0,12.0,Male,1.0,1.0,1.0,"[4, 'block 2 (G first)']",0,1,0,0.5,5.0,-0.5,0.6666666666666666,0.02631578947368421,,0.0,2,1.0,0.75,Design 1,Design 1,"Have an option between Design #1 and Design #2,",,1.0,3.0
744,5112,4,Player object (1867),buy,2023-03-10 12:45:07.173102+00:00,"{""priceA"": 100, ""sharesA"": 1, ""secs_since_round_starts"": 192, ""market"": ""A""}",35.0,35.0,2.0,8vfnqphr,t7od4xlw,FULL STUDY,165.0,s1,1,100,85.0,-1,,1,sell,0,sell,0.5337204628349665,14,0,0,block 2 (G first),23.0,12.0,Male,1.0,1.0,1.0,"[4, 'block 2 (G first)']",0,1,0,0.5,5.0,-0.5,0.6666666666666666,0.02631578947368421,,0.0,2,1.0,0.75,Design 1,Design 1,"Have an option between Design #1 and Design #2,",,1.0,3.0
745,5121,4,Player object (1867),sell,2023-03-10 12:45:55.365998+00:00,"{""priceA"": 115, ""sharesA"": 0, ""secs_since_round_starts"": 240, ""market"": ""A""}",150.0,44.0,3.0,8vfnqphr,t7od4xlw,FULL STUDY,165.0,s1,1,115,100.0,1,15.0,1,buy,0,sell,0.5772497941838325,14,0,0,block 2 (G first),23.0,12.0,Male,1.0,1.0,1.0,"[4, 'block 2 (G first)']",0,1,0,0.5,5.0,-0.5,0.6666666666666666,0.02631578947368421,,0.0,2,1.0,0.75,Design 1,Design 1,"Have an option between Design #1 and Design #2,",,1.0,3.0
746,5124,4,Player object (1867),buy,2023-03-10 12:46:12.861671+00:00,"{""priceA"": 85, ""sharesA"": 1, ""secs_since_round_starts"": 258, ""market"": ""A""}",65.0,47.0,4.0,8vfnqphr,t7od4xlw,FULL STUDY,165.0,s1,1,85,115.0,-1,,1,sell,0,sell,0.4501495476988393,14,1,0,block 2 (G first),23.0,12.0,Male,1.0,1.0,1.0,"[4, 'block 2 (G first)']",0,1,0,0.5,5.0,-0.5,0.6666666666666666,0.02631578947368421,,0.0,2,1.0,0.75,Design 1,Design 1,"Have an option between Design #1 and Design #2,",,1.0,3.0
747,5127,4,Player object (1867),sell,2023-03-10 12:46:17.258896+00:00,"{""priceA"": 100, ""sharesA"": 0, ""secs_since_round_starts"": 262, ""market"": ""A""}",165.0,48.0,5.0,8vfnqphr,t7od4xlw,FULL STUDY,165.0,s1,1,100,85.0,1,15.0,1,buy,0,sell,0.500105737602651,14,0,0,block 2 (G first),23.0,12.0,Male,1.0,1.0,1.0,"[4, 'block 2 (G first)']",0,1,0,0.5,5.0,-0.5,0.6666666666666666,0.02631578947368421,,0.0,2,1.0,0.75,Design 1,Design 1,"Have an option between Design #1 and Design #2,",,1.0,3.0
748,5131,4,Player object (1867),buy,2023-03-10 12:46:42.274230+00:00,"{""priceA"": 75, ""sharesA"": 1, ""secs_since_round_starts"": 287, ""market"": ""A""}",90.0,53.0,6.0,8vfnqphr,t7od4xlw,FULL STUDY,165.0,s1,1,75,100.0,-1,,1,sell,0,sell,0.4439854633835125,14,1,0,block 2 (G first),23.0,12.0,Male,1.0,1.0,1.0,"[4, 'block 2 (G first)']",0,1,0,0.5,5.0,-0.5,0.6666666666666666,0.02631578947368421,,0.0,2,1.0,0.75,Design 1,Design 1,"Have an option between Design #1 and Design #2,",,1.0,3.0
749,5148,5,Player object (2047),sell,2023-03-10 12:48:29.608259+00:00,"{""priceA"": 100, ""sharesA"": 0, ""secs_since_round_starts"": 62, ""market"": ""A""}",150.0,12.0,1.0,8vfnqphr,t7od4xlw,FULL STUDY,200.0,s1,1,100,,1,,1,,0,sell,0.5344269279803172,17,0,0,block 2 (G first),23.0,12.0,Male,1.0,1.0,1.0,"[5, 'block 2 (G first)']",0,0,0,0.0,5.0,-0.5,0.2,0.0,1.0,0.0,3,0.75,0.0,Design 1,Design 1,"Have an option between Design #1 and Design #2,",,1.0,3.0
750,5149,5,Player object (2047),buy,2023-03-10 12:48:41.616898+00:00,"{""priceA"": 80, ""sharesA"": 1, ""secs_since_round_starts"": 74, ""market"": ""A""}",70.0,14.0,2.0,8vfnqphr,t7od4xlw,FULL STUDY,200.0,s1,1,80,100.0,-1,,1,sell,0,sell,0.457409789643144,17,0,0,block 2 (G first),23.0,12.0,Male,1.0,1.0,1.0,"[5, 'block 2 (G first)']",0,0,0,0.0,5.0,-0.5,0.2,0.0,1.0,0.0,3,0.75,0.0,Design 1,Design 1,"Have an option between Design #1 and Design #2,",,1.0,3.0
751,5153,5,Player object (2047),sell,2023-03-10 12:49:14.988540+00:00,"{""priceA"": 95, ""sharesA"": 0, ""secs_since_round_starts"": 107, ""market"": ""A""}",165.0,20.0,3.0,8vfnqphr,t7od4xlw,FULL STUDY,200.0,s1,1,95,80.0,1,15.0,1,buy,0,sell,0.5232479875730728,17,0,0,block 2 (G first),23.0,12.0,Male,1.0,1.0,1.0,"[5, 'block 2 (G first)']",0,0,0,0.0,5.0,-0.5,0.2,0.0,1.0,0.0,3,0.75,0.0,Design 1,Design 1,"Have an option between Design #1 and Design #2,",,1.0,3.0
752,5157,5,Player object (2047),buy,2023-03-10 12:50:00.196086+00:00,"{""priceA"": 85, ""sharesA"": 1, ""secs_since_round_starts"": 152, ""market"": ""A""}",80.0,28.0,4.0,8vfnqphr,t7od4xlw,FULL STUDY,200.0,s1,1,85,95.0,-1,,1,sell,0,sell,0.4496194529460131,17,1,0,block 2 (G first),23.0,12.0,Male,1.0,1.0,1.0,"[5, 'block 2 (G first)']",0,0,0,0.0,5.0,-0.5,0.2,0.0,1.0,0.0,3,0.75,0.0,Design 1,Design 1,"Have an option between Design #1 and Design #2,",,1.0,3.0
753,5160,5,Player object (2047),sell,2023-03-10 12:50:26.135615+00:00,"{""priceA"": 110, ""sharesA"": 0, ""secs_since_round_starts"": 178, ""market"": ""A""}",190.0,33.0,5.0,8vfnqphr,t7od4xlw,FULL STUDY,200.0,s1,1,110,85.0,1,25.0,1,buy,0,sell,0.5480287979668599,17,0,1,block 2 (G first),23.0,12.0,Male,1.0,1.0,1.0,"[5, 'block 2 (G first)']",0,0,0,0.0,5.0,-0.5,0.2,0.0,1.0,0.0,3,0.75,0.0,Design 1,Design 1,"Have an option between Design #1 and Design #2,",,1.0,3.0
754,5164,5,Player object (2047),buy,2023-03-10 12:50:54.169844+00:00,"{""priceA"": 80, ""sharesA"": 1, ""secs_since_round_starts"": 206, ""market"": ""A""}",110.0,38.0,6.0,8vfnqphr,t7od4xlw,FULL STUDY,200.0,s1,1,80,110.0,-1,,1,sell,0,sell,0.4515999245786187,17,1,0,block 2 (G first),23.0,12.0,Male,1.0,1.0,1.0,"[5, 'block 2 (G first)']",0,0,0,0.0,5.0,-0.5,0.2,0.0,1.0,0.0,3,0.75,0.0,Design 1,Design 1,"Have an option between Design #1 and Design #2,",,1.0,3.0
755,5167,5,Player object (2047),sell,2023-03-10 12:51:16.914436+00:00,"{""priceA"": 100, ""sharesA"": 0, ""secs_since_round_starts"": 229, ""market"": ""A""}",210.0,42.0,7.0,8vfnqphr,t7od4xlw,FULL STUDY,200.0,s1,1,100,80.0,1,20.0,1,buy,0,sell,0.5529358605422235,17,0,1,block 2 (G first),23.0,12.0,Male,1.0,1.0,1.0,"[5, 'block 2 (G first)']",0,0,0,0.0,5.0,-0.5,0.2,0.0,1.0,0.0,3,0.75,0.0,Design 1,Design 1,"Have an option between Design #1 and Design #2,",,1.0,3.0
756,5169,5,Player object (2047),buy,2023-03-10 12:51:49.304568+00:00,"{""priceA"": 75, ""sharesA"": 1, ""secs_since_round_starts"": 262, ""market"": ""A""}",135.0,48.0,8.0,8vfnqphr,t7od4xlw,FULL STUDY,200.0,s1,1,75,100.0,-1,,1,sell,0,sell,0.4393932183506925,17,1,0,block 2 (G first),23.0,12.0,Male,1.0,1.0,1.0,"[5, 'block 2 (G first)']",0,0,0,0.0,5.0,-0.5,0.2,0.0,1.0,0.0,3,0.75,0.0,Design 1,Design 1,"Have an option between Design #1 and Design #2,",,1.0,3.0
757,1254,2,Player object (876),sell,2023-03-05 22:06:03.506050+00:00,"{""priceA"": 110, ""sharesA"": 0, ""secs_since_round_starts"": 52, ""market"": ""A""}",160.0,6.0,1.0,8vrmmtmo,vmu7c279,FULL STUDY,110.0,s4,1,110,,1,,1,,0,sell,0.5,0,0,0,block 2 (G first),21.0,12.0,Female,1.0,1.0,1.0,"[2, 'block 2 (G first)']",1,1,0,0.5,7.0,-0.30000000000000004,0.75,0.06451612903225806,0.0,0.0,2,0.75,0.5,Design 2,Design 1,"Have an option between Design #1 and Design #2,",4.0,,
758,1255,2,Player object (876),buy,2023-03-05 22:06:10.763105+00:00,"{""priceA"": 100, ""sharesA"": 1, ""secs_since_round_starts"": 59, ""market"": ""A""}",60.0,7.0,2.0,8vrmmtmo,vmu7c279,FULL STUDY,110.0,s4,1,100,110.0,-1,,1,sell,0,sell,0.5,0,0,0,block 2 (G first),21.0,12.0,Female,1.0,1.0,1.0,"[2, 'block 2 (G first)']",1,1,0,0.5,7.0,-0.30000000000000004,0.75,0.06451612903225806,0.0,0.0,2,0.75,0.5,Design 2,Design 1,"Have an option between Design #1 and Design #2,",4.0,,
759,1258,2,Player object (876),sell,2023-03-05 22:07:10.253232+00:00,"{""priceA"": 65, ""sharesA"": 0, ""secs_since_round_starts"": 118, ""market"": ""A""}",125.0,18.0,4.0,8vrmmtmo,vmu7c279,FULL STUDY,110.0,s4,1,65,60.0,1,5.0,1,buy,0,sell,0.5,0,0,0,block 2 (G first),21.0,12.0,Female,1.0,1.0,1.0,"[2, 'block 2 (G first)']",1,1,0,0.5,7.0,-0.30000000000000004,0.75,0.06451612903225806,0.0,0.0,2,0.75,0.5,Design 2,Design 1,"Have an option between Design #1 and Design #2,",4.0,,
760,1259,2,Player object (876),buy,2023-03-05 22:07:15.996537+00:00,"{""priceA"": 75, ""sharesA"": 1, ""secs_since_round_starts"": 124, ""market"": ""A""}",50.0,19.0,5.0,8vrmmtmo,vmu7c279,FULL STUDY,110.0,s4,1,75,65.0,-1,,1,sell,0,sell,0.5,0,0,1,block 2 (G first),21.0,12.0,Female,1.0,1.0,1.0,"[2, 'block 2 (G first)']",1,1,0,0.5,7.0,-0.30000000000000004,0.75,0.06451612903225806,0.0,0.0,2,0.75,0.5,Design 2,Design 1,"Have an option between Design #1 and Design #2,",4.0,,
761,1260,2,Player object (876),sell,2023-03-05 22:07:19.685167+00:00,"{""priceA"": 85, ""sharesA"": 0, ""secs_since_round_starts"": 128, ""market"": ""A""}",135.0,20.0,6.0,8vrmmtmo,vmu7c279,FULL STUDY,110.0,s4,1,85,75.0,1,10.0,1,buy,0,sell,0.5,0,0,0,block 2 (G first),21.0,12.0,Female,1.0,1.0,1.0,"[2, 'block 2 (G first)']",1,1,0,0.5,7.0,-0.30000000000000004,0.75,0.06451612903225806,0.0,0.0,2,0.75,0.5,Design 2,Design 1,"Have an option between Design #1 and Design #2,",4.0,,
762,1261,2,Player object (876),buy,2023-03-05 22:07:26.048840+00:00,"{""priceA"": 70, ""sharesA"": 1, ""secs_since_round_starts"": 134, ""market"": ""A""}",65.0,21.0,7.0,8vrmmtmo,vmu7c279,FULL STUDY,110.0,s4,1,70,85.0,-1,,1,sell,0,sell,0.5,0,0,0,block 2 (G first),21.0,12.0,Female,1.0,1.0,1.0,"[2, 'block 2 (G first)']",1,1,0,0.5,7.0,-0.30000000000000004,0.75,0.06451612903225806,0.0,0.0,2,0.75,0.5,Design 2,Design 1,"Have an option between Design #1 and Design #2,",4.0,,
763,1262,2,Player object (876),sell,2023-03-05 22:07:31.173887+00:00,"{""priceA"": 75, ""sharesA"": 0, ""secs_since_round_starts"": 139, ""market"": ""A""}",140.0,22.0,8.0,8vrmmtmo,vmu7c279,FULL STUDY,110.0,s4,1,75,70.0,1,5.0,1,buy,0,sell,0.5,0,0,0,block 2 (G first),21.0,12.0,Female,1.0,1.0,1.0,"[2, 'block 2 (G first)']",1,1,0,0.5,7.0,-0.30000000000000004,0.75,0.06451612903225806,0.0,0.0,2,0.75,0.5,Design 2,Design 1,"Have an option between Design #1 and Design #2,",4.0,,
764,1263,2,Player object (876),buy,2023-03-05 22:07:46.878263+00:00,"{""priceA"": 70, ""sharesA"": 1, ""secs_since_round_starts"": 155, ""market"": ""A""}",70.0,25.0,9.0,8vrmmtmo,vmu7c279,FULL STUDY,110.0,s4,1,70,75.0,-1,,1,sell,0,sell,0.5,0,0,0,block 2 (G first),21.0,12.0,Female,1.0,1.0,1.0,"[2, 'block 2 (G first)']",1,1,0,0.5,7.0,-0.30000000000000004,0.75,0.06451612903225806,0.0,0.0,2,0.75,0.5,Design 2,Design 1,"Have an option between Design #1 and Design #2,",4.0,,
765,1264,2,Player object (876),sell,2023-03-05 22:07:53.448352+00:00,"{""priceA"": 80, ""sharesA"": 0, ""secs_since_round_starts"": 162, ""market"": ""A""}",150.0,26.0,10.0,8vrmmtmo,vmu7c279,FULL STUDY,110.0,s4,1,80,70.0,1,10.0,1,buy,0,sell,0.5,0,0,0,block 2 (G first),21.0,12.0,Female,1.0,1.0,1.0,"[2, 'block 2 (G first)']",1,1,0,0.5,7.0,-0.30000000000000004,0.75,0.06451612903225806,0.0,0.0,2,0.75,0.5,Design 2,Design 1,"Have an option between Design #1 and Design #2,",4.0,,
766,1265,2,Player object (876),buy,2023-03-05 22:07:58.565318+00:00,"{""priceA"": 75, ""sharesA"": 1, ""secs_since_round_starts"": 167, ""market"": ""A""}",75.0,27.0,11.0,8vrmmtmo,vmu7c279,FULL STUDY,110.0,s4,1,75,80.0,-1,,1,sell,0,sell,0.5,0,0,0,block 2 (G first),21.0,12.0,Female,1.0,1.0,1.0,"[2, 'block 2 (G first)']",1,1,0,0.5,7.0,-0.30000000000000004,0.75,0.06451612903225806,0.0,0.0,2,0.75,0.5,Design 2,Design 1,"Have an option between Design #1 and Design #2,",4.0,,
767,1266,2,Player object (876),sell,2023-03-05 22:08:03.755390+00:00,"{""priceA"": 80, ""sharesA"": 0, ""secs_since_round_starts"": 172, ""market"": ""A""}",155.0,28.0,12.0,8vrmmtmo,vmu7c279,FULL STUDY,110.0,s4,1,80,75.0,1,5.0,1,buy,0,sell,0.5,0,0,0,block 2 (G first),21.0,12.0,Female,1.0,1.0,1.0,"[2, 'block 2 (G first)']",1,1,0,0.5,7.0,-0.30000000000000004,0.75,0.06451612903225806,0.0,0.0,2,0.75,0.5,Design 2,Design 1,"Have an option between Design #1 and Design #2,",4.0,,
768,1268,2,Player object (876),buy,2023-03-05 22:08:33.612686+00:00,"{""priceA"": 95, ""sharesA"": 1, ""secs_since_round_starts"": 202, ""market"": ""A""}",60.0,32.0,13.0,8vrmmtmo,vmu7c279,FULL STUDY,110.0,s4,1,95,80.0,-1,,1,sell,0,sell,0.5,0,0,0,block 2 (G first),21.0,12.0,Female,1.0,1.0,1.0,"[2, 'block 2 (G first)']",1,1,0,0.5,7.0,-0.30000000000000004,0.75,0.06451612903225806,0.0,0.0,2,0.75,0.5,Design 2,Design 1,"Have an option between Design #1 and Design #2,",4.0,,
769,1271,2,Player object (876),sell,2023-03-05 22:09:23.689967+00:00,"{""priceA"": 55, ""sharesA"": 0, ""secs_since_round_starts"": 252, ""market"": ""A""}",115.0,41.0,15.0,8vrmmtmo,vmu7c279,FULL STUDY,110.0,s4,1,55,35.0,1,20.0,1,buy,0,sell,0.5,0,0,0,block 2 (G first),21.0,12.0,Female,1.0,1.0,1.0,"[2, 'block 2 (G first)']",1,1,0,0.5,7.0,-0.30000000000000004,0.75,0.06451612903225806,0.0,0.0,2,0.75,0.5,Design 2,Design 1,"Have an option between Design #1 and Design #2,",4.0,,
770,1272,2,Player object (876),buy,2023-03-05 22:09:28.534050+00:00,"{""priceA"": 70, ""sharesA"": 1, ""secs_since_round_starts"": 257, ""market"": ""A""}",45.0,42.0,16.0,8vrmmtmo,vmu7c279,FULL STUDY,110.0,s4,1,70,55.0,-1,,1,sell,0,sell,0.5,0,0,1,block 2 (G first),21.0,12.0,Female,1.0,1.0,1.0,"[2, 'block 2 (G first)']",1,1,0,0.5,7.0,-0.30000000000000004,0.75,0.06451612903225806,0.0,0.0,2,0.75,0.5,Design 2,Design 1,"Have an option between Design #1 and Design #2,",4.0,,
771,1275,2,Player object (876),sell,2023-03-05 22:10:17.056789+00:00,"{""priceA"": 75, ""sharesA"": 0, ""secs_since_round_starts"": 305, ""market"": ""A""}",120.0,51.0,18.0,8vrmmtmo,vmu7c279,FULL STUDY,110.0,s4,1,75,65.0,1,10.0,1,buy,0,sell,0.5,0,0,0,block 2 (G first),21.0,12.0,Female,1.0,1.0,1.0,"[2, 'block 2 (G first)']",1,1,0,0.5,7.0,-0.30000000000000004,0.75,0.06451612903225806,0.0,0.0,2,0.75,0.5,Design 2,Design 1,"Have an option between Design #1 and Design #2,",4.0,,
772,1276,2,Player object (876),buy,2023-03-05 22:10:29.968850+00:00,"{""priceA"": 105, ""sharesA"": 1, ""secs_since_round_starts"": 318, ""market"": ""A""}",15.0,53.0,19.0,8vrmmtmo,vmu7c279,FULL STUDY,110.0,s4,1,105,75.0,-1,,1,sell,0,sell,0.5,0,0,1,block 2 (G first),21.0,12.0,Female,1.0,1.0,1.0,"[2, 'block 2 (G first)']",1,1,0,0.5,7.0,-0.30000000000000004,0.75,0.06451612903225806,0.0,0.0,2,0.75,0.5,Design 2,Design 1,"Have an option between Design #1 and Design #2,",4.0,,
773,1280,3,Player object (996),sell,2023-03-05 22:11:53.232939+00:00,"{""priceA"": 120, ""sharesA"": 0, ""secs_since_round_starts"": 39, ""market"": ""A""}",170.0,8.0,1.0,8vrmmtmo,vmu7c279,FULL STUDY,155.0,s4,1,120,,1,,1,,0,sell,0.5,0,0,0,block 2 (G first),21.0,12.0,Female,1.0,1.0,1.0,"[3, 'block 2 (G first)']",1,0,0,0.5,7.0,-0.30000000000000004,0.3333333333333333,0.23809523809523808,0.0,0.25,2,0.75,0.75,Design 2,Design 1,"Have an option between Design #1 and Design #2,",4.0,,
774,1281,3,Player object (996),buy,2023-03-05 22:12:05.548898+00:00,"{""priceA"": 130, ""sharesA"": 1, ""secs_since_round_starts"": 51, ""market"": ""A""}",40.0,10.0,2.0,8vrmmtmo,vmu7c279,FULL STUDY,155.0,s4,1,130,120.0,-1,,1,sell,0,sell,0.5,0,0,1,block 2 (G first),21.0,12.0,Female,1.0,1.0,1.0,"[3, 'block 2 (G first)']",1,0,0,0.5,7.0,-0.30000000000000004,0.3333333333333333,0.23809523809523808,0.0,0.25,2,0.75,0.75,Design 2,Design 1,"Have an option between Design #1 and Design #2,",4.0,,
775,1282,3,Player object (996),sell,2023-03-05 22:12:21.444834+00:00,"{""priceA"": 125, ""sharesA"": 0, ""secs_since_round_starts"": 67, ""market"": ""A""}",165.0,13.0,3.0,8vrmmtmo,vmu7c279,FULL STUDY,155.0,s4,1,125,130.0,1,-5.0,1,buy,0,sell,0.5,0,0,0,block 2 (G first),21.0,12.0,Female,1.0,1.0,1.0,"[3, 'block 2 (G first)']",1,0,0,0.5,7.0,-0.30000000000000004,0.3333333333333333,0.23809523809523808,0.0,0.25,2,0.75,0.75,Design 2,Design 1,"Have an option between Design #1 and Design #2,",4.0,,
776,1283,3,Player object (996),buy,2023-03-05 22:12:37.592219+00:00,"{""priceA"": 160, ""sharesA"": 1, ""secs_since_round_starts"": 83, ""market"": ""A""}",5.0,16.0,4.0,8vrmmtmo,vmu7c279,FULL STUDY,155.0,s4,1,160,125.0,-1,,1,sell,0,sell,0.5,0,0,1,block 2 (G first),21.0,12.0,Female,1.0,1.0,1.0,"[3, 'block 2 (G first)']",1,0,0,0.5,7.0,-0.30000000000000004,0.3333333333333333,0.23809523809523808,0.0,0.25,2,0.75,0.75,Design 2,Design 1,"Have an option between Design #1 and Design #2,",4.0,,
777,1284,3,Player object (996),sell,2023-03-05 22:13:05.639670+00:00,"{""priceA"": 130, ""sharesA"": 0, ""secs_since_round_starts"": 111, ""market"": ""A""}",135.0,21.0,5.0,8vrmmtmo,vmu7c279,FULL STUDY,155.0,s4,1,130,160.0,1,-30.0,1,buy,0,sell,0.5,0,1,0,block 2 (G first),21.0,12.0,Female,1.0,1.0,1.0,"[3, 'block 2 (G first)']",1,0,0,0.5,7.0,-0.30000000000000004,0.3333333333333333,0.23809523809523808,0.0,0.25,2,0.75,0.75,Design 2,Design 1,"Have an option between Design #1 and Design #2,",4.0,,
778,1285,3,Player object (996),buy,2023-03-05 22:13:16.171555+00:00,"{""priceA"": 130, ""sharesA"": 1, ""secs_since_round_starts"": 122, ""market"": ""A""}",5.0,23.0,6.0,8vrmmtmo,vmu7c279,FULL STUDY,155.0,s4,1,130,130.0,-1,,1,sell,0,sell,0.5,0,0,0,block 2 (G first),21.0,12.0,Female,1.0,1.0,1.0,"[3, 'block 2 (G first)']",1,0,0,0.5,7.0,-0.30000000000000004,0.3333333333333333,0.23809523809523808,0.0,0.25,2,0.75,0.75,Design 2,Design 1,"Have an option between Design #1 and Design #2,",4.0,,
779,1286,3,Player object (996),sell,2023-03-05 22:13:21.352103+00:00,"{""priceA"": 145, ""sharesA"": 0, ""secs_since_round_starts"": 127, ""market"": ""A""}",150.0,24.0,7.0,8vrmmtmo,vmu7c279,FULL STUDY,155.0,s4,1,145,130.0,1,15.0,1,buy,0,sell,0.5,0,0,0,block 2 (G first),21.0,12.0,Female,1.0,1.0,1.0,"[3, 'block 2 (G first)']",1,0,0,0.5,7.0,-0.30000000000000004,0.3333333333333333,0.23809523809523808,0.0,0.25,2,0.75,0.75,Design 2,Design 1,"Have an option between Design #1 and Design #2,",4.0,,
780,1287,3,Player object (996),buy,2023-03-05 22:13:27.285129+00:00,"{""priceA"": 155, ""sharesA"": 1, ""secs_since_round_starts"": 133, ""market"": ""A""}",-5.0,25.0,8.0,8vrmmtmo,vmu7c279,FULL STUDY,155.0,s4,1,155,145.0,-1,,1,sell,0,sell,0.5,0,0,1,block 2 (G first),21.0,12.0,Female,1.0,1.0,1.0,"[3, 'block 2 (G first)']",1,0,0,0.5,7.0,-0.30000000000000004,0.3333333333333333,0.23809523809523808,0.0,0.25,2,0.75,0.75,Design 2,Design 1,"Have an option between Design #1 and Design #2,",4.0,,
781,1288,3,Player object (996),sell,2023-03-05 22:13:37.405557+00:00,"{""priceA"": 155, ""sharesA"": 0, ""secs_since_round_starts"": 143, ""market"": ""A""}",150.0,27.0,9.0,8vrmmtmo,vmu7c279,FULL STUDY,155.0,s4,1,155,155.0,1,0.0,1,buy,0,sell,0.5,0,0,0,block 2 (G first),21.0,12.0,Female,1.0,1.0,1.0,"[3, 'block 2 (G first)']",1,0,0,0.5,7.0,-0.30000000000000004,0.3333333333333333,0.23809523809523808,0.0,0.25,2,0.75,0.75,Design 2,Design 1,"Have an option between Design #1 and Design #2,",4.0,,
782,1290,3,Player object (996),buy,2023-03-05 22:14:09.995130+00:00,"{""priceA"": 150, ""sharesA"": 1, ""secs_since_round_starts"": 175, ""market"": ""A""}",,32.0,10.0,8vrmmtmo,vmu7c279,FULL STUDY,155.0,s4,1,150,155.0,-1,,1,sell,0,sell,0.5,0,0,0,block 2 (G first),21.0,12.0,Female,1.0,1.0,1.0,"[3, 'block 2 (G first)']",1,0,0,0.5,7.0,-0.30000000000000004,0.3333333333333333,0.23809523809523808,0.0,0.25,2,0.75,0.75,Design 2,Design 1,"Have an option between Design #1 and Design #2,",4.0,,
783,1291,3,Player object (996),sell,2023-03-05 22:14:20.245473+00:00,"{""priceA"": 145, ""sharesA"": 0, ""secs_since_round_starts"": 186, ""market"": ""A""}",145.0,34.0,11.0,8vrmmtmo,vmu7c279,FULL STUDY,155.0,s4,1,145,150.0,1,-5.0,1,buy,0,sell,0.5,0,0,0,block 2 (G first),21.0,12.0,Female,1.0,1.0,1.0,"[3, 'block 2 (G first)']",1,0,0,0.5,7.0,-0.30000000000000004,0.3333333333333333,0.23809523809523808,0.0,0.25,2,0.75,0.75,Design 2,Design 1,"Have an option between Design #1 and Design #2,",4.0,,
784,1292,3,Player object (996),buy,2023-03-05 22:14:25.538563+00:00,"{""priceA"": 150, ""sharesA"": 1, ""secs_since_round_starts"": 191, ""market"": ""A""}",-5.0,35.0,12.0,8vrmmtmo,vmu7c279,FULL STUDY,155.0,s4,1,150,145.0,-1,,1,sell,0,sell,0.5,0,0,0,block 2 (G first),21.0,12.0,Female,1.0,1.0,1.0,"[3, 'block 2 (G first)']",1,0,0,0.5,7.0,-0.30000000000000004,0.3333333333333333,0.23809523809523808,0.0,0.25,2,0.75,0.75,Design 2,Design 1,"Have an option between Design #1 and Design #2,",4.0,,
785,1293,3,Player object (996),sell,2023-03-05 22:15:05.721807+00:00,"{""priceA"": 140, ""sharesA"": 0, ""secs_since_round_starts"": 231, ""market"": ""A""}",135.0,42.0,13.0,8vrmmtmo,vmu7c279,FULL STUDY,155.0,s4,1,140,150.0,1,-10.0,1,buy,0,sell,0.5,0,0,0,block 2 (G first),21.0,12.0,Female,1.0,1.0,1.0,"[3, 'block 2 (G first)']",1,0,0,0.5,7.0,-0.30000000000000004,0.3333333333333333,0.23809523809523808,0.0,0.25,2,0.75,0.75,Design 2,Design 1,"Have an option between Design #1 and Design #2,",4.0,,
786,1294,3,Player object (996),buy,2023-03-05 22:15:09.605056+00:00,"{""priceA"": 135, ""sharesA"": 1, ""secs_since_round_starts"": 235, ""market"": ""A""}",,43.0,14.0,8vrmmtmo,vmu7c279,FULL STUDY,155.0,s4,1,135,140.0,-1,,1,sell,0,sell,0.5,0,0,0,block 2 (G first),21.0,12.0,Female,1.0,1.0,1.0,"[3, 'block 2 (G first)']",1,0,0,0.5,7.0,-0.30000000000000004,0.3333333333333333,0.23809523809523808,0.0,0.25,2,0.75,0.75,Design 2,Design 1,"Have an option between Design #1 and Design #2,",4.0,,
787,1295,3,Player object (996),sell,2023-03-05 22:15:15.710502+00:00,"{""priceA"": 140, ""sharesA"": 0, ""secs_since_round_starts"": 241, ""market"": ""A""}",140.0,44.0,15.0,8vrmmtmo,vmu7c279,FULL STUDY,155.0,s4,1,140,135.0,1,5.0,1,buy,0,sell,0.5,0,0,0,block 2 (G first),21.0,12.0,Female,1.0,1.0,1.0,"[3, 'block 2 (G first)']",1,0,0,0.5,7.0,-0.30000000000000004,0.3333333333333333,0.23809523809523808,0.0,0.25,2,0.75,0.75,Design 2,Design 1,"Have an option between Design #1 and Design #2,",4.0,,
788,1296,3,Player object (996),buy,2023-03-05 22:15:26.993439+00:00,"{""priceA"": 155, ""sharesA"": 1, ""secs_since_round_starts"": 252, ""market"": ""A""}",-15.0,46.0,16.0,8vrmmtmo,vmu7c279,FULL STUDY,155.0,s4,1,155,140.0,-1,,1,sell,0,sell,0.5,0,0,1,block 2 (G first),21.0,12.0,Female,1.0,1.0,1.0,"[3, 'block 2 (G first)']",1,0,0,0.5,7.0,-0.30000000000000004,0.3333333333333333,0.23809523809523808,0.0,0.25,2,0.75,0.75,Design 2,Design 1,"Have an option between Design #1 and Design #2,",4.0,,
789,1297,3,Player object (996),sell,2023-03-05 22:15:38.255410+00:00,"{""priceA"": 150, ""sharesA"": 0, ""secs_since_round_starts"": 264, ""market"": ""A""}",135.0,48.0,17.0,8vrmmtmo,vmu7c279,FULL STUDY,155.0,s4,1,150,155.0,1,-5.0,1,buy,0,sell,0.5,0,0,0,block 2 (G first),21.0,12.0,Female,1.0,1.0,1.0,"[3, 'block 2 (G first)']",1,0,0,0.5,7.0,-0.30000000000000004,0.3333333333333333,0.23809523809523808,0.0,0.25,2,0.75,0.75,Design 2,Design 1,"Have an option between Design #1 and Design #2,",4.0,,
790,1298,3,Player object (996),buy,2023-03-05 22:15:48.399352+00:00,"{""priceA"": 170, ""sharesA"": 1, ""secs_since_round_starts"": 274, ""market"": ""A""}",-35.0,50.0,18.0,8vrmmtmo,vmu7c279,FULL STUDY,155.0,s4,1,170,150.0,-1,,1,sell,0,sell,0.5,0,0,1,block 2 (G first),21.0,12.0,Female,1.0,1.0,1.0,"[3, 'block 2 (G first)']",1,0,0,0.5,7.0,-0.30000000000000004,0.3333333333333333,0.23809523809523808,0.0,0.25,2,0.75,0.75,Design 2,Design 1,"Have an option between Design #1 and Design #2,",4.0,,
791,1299,3,Player object (996),sell,2023-03-05 22:15:58.871007+00:00,"{""priceA"": 200, ""sharesA"": 0, ""secs_since_round_starts"": 284, ""market"": ""A""}",165.0,52.0,19.0,8vrmmtmo,vmu7c279,FULL STUDY,155.0,s4,1,200,170.0,1,30.0,1,buy,0,sell,0.5,0,0,0,block 2 (G first),21.0,12.0,Female,1.0,1.0,1.0,"[3, 'block 2 (G first)']",1,0,0,0.5,7.0,-0.30000000000000004,0.3333333333333333,0.23809523809523808,0.0,0.25,2,0.75,0.75,Design 2,Design 1,"Have an option between Design #1 and Design #2,",4.0,,
792,1300,3,Player object (996),buy,2023-03-05 22:16:16.689621+00:00,"{""priceA"": 190, ""sharesA"": 1, ""secs_since_round_starts"": 302, ""market"": ""A""}",-25.0,55.0,20.0,8vrmmtmo,vmu7c279,FULL STUDY,155.0,s4,1,190,200.0,-1,,1,sell,0,sell,0.5,0,0,0,block 2 (G first),21.0,12.0,Female,1.0,1.0,1.0,"[3, 'block 2 (G first)']",1,0,0,0.5,7.0,-0.30000000000000004,0.3333333333333333,0.23809523809523808,0.0,0.25,2,0.75,0.75,Design 2,Design 1,"Have an option between Design #1 and Design #2,",4.0,,
793,1304,4,Player object (1116),sell,2023-03-05 22:17:21.975588+00:00,"{""priceA"": 140, ""sharesA"": 0, ""secs_since_round_starts"": 31, ""market"": ""A""}",190.0,7.0,1.0,8vrmmtmo,vmu7c279,FULL STUDY,200.0,s4,1,140,,1,,1,,0,sell,0.5,0,0,0,block 2 (G first),21.0,12.0,Female,1.0,1.0,1.0,"[4, 'block 2 (G first)']",0,1,0,0.5,7.0,-0.30000000000000004,0.75,0.06451612903225806,,0.0,4,0.75,0.75,Design 2,Design 1,"Have an option between Design #1 and Design #2,",4.0,,
794,1305,4,Player object (1116),buy,2023-03-05 22:17:28.242819+00:00,"{""priceA"": 130, ""sharesA"": 1, ""secs_since_round_starts"": 37, ""market"": ""A""}",60.0,8.0,2.0,8vrmmtmo,vmu7c279,FULL STUDY,200.0,s4,1,130,140.0,-1,,1,sell,0,sell,0.5,0,0,0,block 2 (G first),21.0,12.0,Female,1.0,1.0,1.0,"[4, 'block 2 (G first)']",0,1,0,0.5,7.0,-0.30000000000000004,0.75,0.06451612903225806,,0.0,4,0.75,0.75,Design 2,Design 1,"Have an option between Design #1 and Design #2,",4.0,,
795,1306,4,Player object (1116),sell,2023-03-05 22:17:34.741472+00:00,"{""priceA"": 140, ""sharesA"": 0, ""secs_since_round_starts"": 44, ""market"": ""A""}",200.0,9.0,3.0,8vrmmtmo,vmu7c279,FULL STUDY,200.0,s4,1,140,130.0,1,10.0,1,buy,0,sell,0.5,0,0,0,block 2 (G first),21.0,12.0,Female,1.0,1.0,1.0,"[4, 'block 2 (G first)']",0,1,0,0.5,7.0,-0.30000000000000004,0.75,0.06451612903225806,,0.0,4,0.75,0.75,Design 2,Design 1,"Have an option between Design #1 and Design #2,",4.0,,
796,1307,4,Player object (1116),buy,2023-03-05 22:17:38.897542+00:00,"{""priceA"": 135, ""sharesA"": 1, ""secs_since_round_starts"": 48, ""market"": ""A""}",65.0,10.0,4.0,8vrmmtmo,vmu7c279,FULL STUDY,200.0,s4,1,135,140.0,-1,,1,sell,0,sell,0.5,0,0,0,block 2 (G first),21.0,12.0,Female,1.0,1.0,1.0,"[4, 'block 2 (G first)']",0,1,0,0.5,7.0,-0.30000000000000004,0.75,0.06451612903225806,,0.0,4,0.75,0.75,Design 2,Design 1,"Have an option between Design #1 and Design #2,",4.0,,
797,1309,4,Player object (1116),sell,2023-03-05 22:20:24.827271+00:00,"{""priceA"": 90, ""sharesA"": 0, ""secs_since_round_starts"": 214, ""market"": ""A""}",155.0,40.0,5.0,8vrmmtmo,vmu7c279,FULL STUDY,200.0,s4,1,90,135.0,1,-45.0,1,buy,0,sell,0.5,0,0,0,block 2 (G first),21.0,12.0,Female,1.0,1.0,1.0,"[4, 'block 2 (G first)']",0,1,0,0.5,7.0,-0.30000000000000004,0.75,0.06451612903225806,,0.0,4,0.75,0.75,Design 2,Design 1,"Have an option between Design #1 and Design #2,",4.0,,
798,1310,4,Player object (1116),buy,2023-03-05 22:20:30.373899+00:00,"{""priceA"": 80, ""sharesA"": 1, ""secs_since_round_starts"": 219, ""market"": ""A""}",75.0,41.0,6.0,8vrmmtmo,vmu7c279,FULL STUDY,200.0,s4,1,80,90.0,-1,,1,sell,0,sell,0.5,0,0,0,block 2 (G first),21.0,12.0,Female,1.0,1.0,1.0,"[4, 'block 2 (G first)']",0,1,0,0.5,7.0,-0.30000000000000004,0.75,0.06451612903225806,,0.0,4,0.75,0.75,Design 2,Design 1,"Have an option between Design #1 and Design #2,",4.0,,
799,1311,4,Player object (1116),sell,2023-03-05 22:20:35.627169+00:00,"{""priceA"": 90, ""sharesA"": 0, ""secs_since_round_starts"": 225, ""market"": ""A""}",165.0,42.0,7.0,8vrmmtmo,vmu7c279,FULL STUDY,200.0,s4,1,90,80.0,1,10.0,1,buy,0,sell,0.5,0,0,0,block 2 (G first),21.0,12.0,Female,1.0,1.0,1.0,"[4, 'block 2 (G first)']",0,1,0,0.5,7.0,-0.30000000000000004,0.75,0.06451612903225806,,0.0,4,0.75,0.75,Design 2,Design 1,"Have an option between Design #1 and Design #2,",4.0,,
800,1312,4,Player object (1116),buy,2023-03-05 22:20:57.725414+00:00,"{""priceA"": 100, ""sharesA"": 1, ""secs_since_round_starts"": 247, ""market"": ""A""}",65.0,46.0,8.0,8vrmmtmo,vmu7c279,FULL STUDY,200.0,s4,1,100,90.0,-1,,1,sell,0,sell,0.5,0,0,0,block 2 (G first),21.0,12.0,Female,1.0,1.0,1.0,"[4, 'block 2 (G first)']",0,1,0,0.5,7.0,-0.30000000000000004,0.75,0.06451612903225806,,0.0,4,0.75,0.75,Design 2,Design 1,"Have an option between Design #1 and Design #2,",4.0,,
801,1313,4,Player object (1116),sell,2023-03-05 22:21:03.088549+00:00,"{""priceA"": 110, ""sharesA"": 0, ""secs_since_round_starts"": 252, ""market"": ""A""}",175.0,47.0,9.0,8vrmmtmo,vmu7c279,FULL STUDY,200.0,s4,1,110,100.0,1,10.0,1,buy,0,sell,0.5,0,0,0,block 2 (G first),21.0,12.0,Female,1.0,1.0,1.0,"[4, 'block 2 (G first)']",0,1,0,0.5,7.0,-0.30000000000000004,0.75,0.06451612903225806,,0.0,4,0.75,0.75,Design 2,Design 1,"Have an option between Design #1 and Design #2,",4.0,,
802,1314,4,Player object (1116),buy,2023-03-05 22:21:26.531891+00:00,"{""priceA"": 130, ""sharesA"": 1, ""secs_since_round_starts"": 275, ""market"": ""A""}",45.0,51.0,10.0,8vrmmtmo,vmu7c279,FULL STUDY,200.0,s4,1,130,110.0,-1,,1,sell,0,sell,0.5,0,0,0,block 2 (G first),21.0,12.0,Female,1.0,1.0,1.0,"[4, 'block 2 (G first)']",0,1,0,0.5,7.0,-0.30000000000000004,0.75,0.06451612903225806,,0.0,4,0.75,0.75,Design 2,Design 1,"Have an option between Design #1 and Design #2,",4.0,,
803,1315,4,Player object (1116),sell,2023-03-05 22:21:32.089609+00:00,"{""priceA"": 125, ""sharesA"": 0, ""secs_since_round_starts"": 281, ""market"": ""A""}",170.0,52.0,11.0,8vrmmtmo,vmu7c279,FULL STUDY,200.0,s4,1,125,130.0,1,-5.0,1,buy,0,sell,0.5,0,0,0,block 2 (G first),21.0,12.0,Female,1.0,1.0,1.0,"[4, 'block 2 (G first)']",0,1,0,0.5,7.0,-0.30000000000000004,0.75,0.06451612903225806,,0.0,4,0.75,0.75,Design 2,Design 1,"Have an option between Design #1 and Design #2,",4.0,,
804,1316,4,Player object (1116),buy,2023-03-05 22:21:36.073872+00:00,"{""priceA"": 115, ""sharesA"": 1, ""secs_since_round_starts"": 285, ""market"": ""A""}",55.0,53.0,12.0,8vrmmtmo,vmu7c279,FULL STUDY,200.0,s4,1,115,125.0,-1,,1,sell,0,sell,0.5,0,1,0,block 2 (G first),21.0,12.0,Female,1.0,1.0,1.0,"[4, 'block 2 (G first)']",0,1,0,0.5,7.0,-0.30000000000000004,0.75,0.06451612903225806,,0.0,4,0.75,0.75,Design 2,Design 1,"Have an option between Design #1 and Design #2,",4.0,,
805,1317,4,Player object (1116),sell,2023-03-05 22:21:41.409911+00:00,"{""priceA"": 130, ""sharesA"": 0, ""secs_since_round_starts"": 290, ""market"": ""A""}",185.0,54.0,13.0,8vrmmtmo,vmu7c279,FULL STUDY,200.0,s4,1,130,115.0,1,15.0,1,buy,0,sell,0.5,0,0,0,block 2 (G first),21.0,12.0,Female,1.0,1.0,1.0,"[4, 'block 2 (G first)']",0,1,0,0.5,7.0,-0.30000000000000004,0.75,0.06451612903225806,,0.0,4,0.75,0.75,Design 2,Design 1,"Have an option between Design #1 and Design #2,",4.0,,
806,1318,4,Player object (1116),buy,2023-03-05 22:21:52.669526+00:00,"{""priceA"": 120, ""sharesA"": 1, ""secs_since_round_starts"": 302, ""market"": ""A""}",65.0,56.0,14.0,8vrmmtmo,vmu7c279,FULL STUDY,200.0,s4,1,120,130.0,-1,,1,sell,0,sell,0.5,0,0,0,block 2 (G first),21.0,12.0,Female,1.0,1.0,1.0,"[4, 'block 2 (G first)']",0,1,0,0.5,7.0,-0.30000000000000004,0.75,0.06451612903225806,,0.0,4,0.75,0.75,Design 2,Design 1,"Have an option between Design #1 and Design #2,",4.0,,
807,1319,4,Player object (1116),sell,2023-03-05 22:21:57.984508+00:00,"{""priceA"": 135, ""sharesA"": 0, ""secs_since_round_starts"": 307, ""market"": ""A""}",200.0,57.0,15.0,8vrmmtmo,vmu7c279,FULL STUDY,200.0,s4,1,135,120.0,1,15.0,1,buy,0,sell,0.5,0,0,0,block 2 (G first),21.0,12.0,Female,1.0,1.0,1.0,"[4, 'block 2 (G first)']",0,1,0,0.5,7.0,-0.30000000000000004,0.75,0.06451612903225806,,0.0,4,0.75,0.75,Design 2,Design 1,"Have an option between Design #1 and Design #2,",4.0,,
808,1484,2,Player object (878),sell,2023-03-06 01:48:03.353883+00:00,"{""priceA"": 105, ""sharesA"": 0, ""secs_since_round_starts"": 84, ""market"": ""A""}",155.0,14.0,1.0,93y42seh,vmu7c279,FULL STUDY,165.0,s1,1,105,,1,,1,,0,sell,0.5600744319669811,16,0,1,block 3 (G second),20.0,11.0,Male,1.0,1.0,1.0,"[2, 'block 3 (G second)']",0,0,1,0.5,9.0,-0.016666666666666607,0.125,0.25,0.25,0.0,4,1.0,0.75,Design 2,Design 2,"Have an option between Design #1 and Design #2,",,4.0,5.0
809,1485,2,Player object (878),buy,2023-03-06 01:49:31.493710+00:00,"{""priceA"": 115, ""sharesA"": 1, ""secs_since_round_starts"": 170, ""market"": ""A""}",40.0,29.0,2.0,93y42seh,vmu7c279,FULL STUDY,165.0,s1,1,115,105.0,-1,,1,sell,0,sell,0.41991811093665,16,0,0,block 3 (G second),20.0,11.0,Male,1.0,1.0,1.0,"[2, 'block 3 (G second)']",0,0,1,0.5,9.0,-0.016666666666666607,0.125,0.25,0.25,0.0,4,1.0,0.75,Design 2,Design 2,"Have an option between Design #1 and Design #2,",,4.0,5.0
810,1487,2,Player object (878),sell,2023-03-06 01:50:17.006896+00:00,"{""priceA"": 150, ""sharesA"": 0, ""secs_since_round_starts"": 218, ""market"": ""A""}",190.0,36.0,3.0,93y42seh,vmu7c279,FULL STUDY,165.0,s1,1,150,115.0,1,35.0,1,buy,0,sell,0.542045663089369,16,0,0,block 3 (G second),20.0,11.0,Male,1.0,1.0,1.0,"[2, 'block 3 (G second)']",0,0,1,0.5,9.0,-0.016666666666666607,0.125,0.25,0.25,0.0,4,1.0,0.75,Design 2,Design 2,"Have an option between Design #1 and Design #2,",,4.0,5.0
811,1488,2,Player object (878),buy,2023-03-06 01:50:41.830321+00:00,"{""priceA"": 140, ""sharesA"": 1, ""secs_since_round_starts"": 243, ""market"": ""A""}",50.0,40.0,4.0,93y42seh,vmu7c279,FULL STUDY,165.0,s1,1,140,150.0,-1,,1,sell,0,sell,0.4916787423410894,16,0,0,block 3 (G second),20.0,11.0,Male,1.0,1.0,1.0,"[2, 'block 3 (G second)']",0,0,1,0.5,9.0,-0.016666666666666607,0.125,0.25,0.25,0.0,4,1.0,0.75,Design 2,Design 2,"Have an option between Design #1 and Design #2,",,4.0,5.0
812,1489,2,Player object (878),sell,2023-03-06 01:50:49.542419+00:00,"{""priceA"": 130, ""sharesA"": 0, ""secs_since_round_starts"": 250, ""market"": ""A""}",180.0,42.0,5.0,93y42seh,vmu7c279,FULL STUDY,165.0,s1,1,130,140.0,1,-10.0,1,buy,0,sell,0.4369837361437204,16,0,0,block 3 (G second),20.0,11.0,Male,1.0,1.0,1.0,"[2, 'block 3 (G second)']",0,0,1,0.5,9.0,-0.016666666666666607,0.125,0.25,0.25,0.0,4,1.0,0.75,Design 2,Design 2,"Have an option between Design #1 and Design #2,",,4.0,5.0
813,1490,2,Player object (878),buy,2023-03-06 01:51:05.182248+00:00,"{""priceA"": 140, ""sharesA"": 1, ""secs_since_round_starts"": 266, ""market"": ""A""}",40.0,45.0,6.0,93y42seh,vmu7c279,FULL STUDY,165.0,s1,1,140,130.0,-1,,1,sell,0,sell,0.5210834711709403,16,0,0,block 3 (G second),20.0,11.0,Male,1.0,1.0,1.0,"[2, 'block 3 (G second)']",0,0,1,0.5,9.0,-0.016666666666666607,0.125,0.25,0.25,0.0,4,1.0,0.75,Design 2,Design 2,"Have an option between Design #1 and Design #2,",,4.0,5.0
814,1495,2,Player object (878),sell,2023-03-06 01:51:51.052181+00:00,"{""priceA"": 135, ""sharesA"": 0, ""secs_since_round_starts"": 312, ""market"": ""A""}",175.0,53.0,9.0,93y42seh,vmu7c279,FULL STUDY,165.0,s1,1,135,140.0,1,-5.0,1,buy,0,sell,0.4956940487416096,16,0,0,block 3 (G second),20.0,11.0,Male,1.0,1.0,1.0,"[2, 'block 3 (G second)']",0,0,1,0.5,9.0,-0.016666666666666607,0.125,0.25,0.25,0.0,4,1.0,0.75,Design 2,Design 2,"Have an option between Design #1 and Design #2,",,4.0,5.0
815,1496,2,Player object (878),buy,2023-03-06 01:51:54.954442+00:00,"{""priceA"": 145, ""sharesA"": 1, ""secs_since_round_starts"": 316, ""market"": ""A""}",30.0,54.0,10.0,93y42seh,vmu7c279,FULL STUDY,165.0,s1,1,145,135.0,-1,,1,sell,0,sell,0.5320134037503595,16,0,0,block 3 (G second),20.0,11.0,Male,1.0,1.0,1.0,"[2, 'block 3 (G second)']",0,0,1,0.5,9.0,-0.016666666666666607,0.125,0.25,0.25,0.0,4,1.0,0.75,Design 2,Design 2,"Have an option between Design #1 and Design #2,",,4.0,5.0
816,1497,2,Player object (878),sell,2023-03-06 01:52:06.359285+00:00,"{""priceA"": 125, ""sharesA"": 0, ""secs_since_round_starts"": 327, ""market"": ""A""}",155.0,56.0,11.0,93y42seh,vmu7c279,FULL STUDY,165.0,s1,1,125,145.0,1,-20.0,1,buy,0,sell,0.4562406760637778,16,0,0,block 3 (G second),20.0,11.0,Male,1.0,1.0,1.0,"[2, 'block 3 (G second)']",0,0,1,0.5,9.0,-0.016666666666666607,0.125,0.25,0.25,0.0,4,1.0,0.75,Design 2,Design 2,"Have an option between Design #1 and Design #2,",,4.0,5.0
817,1498,2,Player object (878),buy,2023-03-06 01:52:20.438423+00:00,"{""priceA"": 115, ""sharesA"": 1, ""secs_since_round_starts"": 340, ""market"": ""A""}",40.0,58.0,12.0,93y42seh,vmu7c279,FULL STUDY,165.0,s1,1,115,125.0,-1,,1,sell,0,sell,0.4893175166503174,16,0,0,block 3 (G second),20.0,11.0,Male,1.0,1.0,1.0,"[2, 'block 3 (G second)']",0,0,1,0.5,9.0,-0.016666666666666607,0.125,0.25,0.25,0.0,4,1.0,0.75,Design 2,Design 2,"Have an option between Design #1 and Design #2,",,4.0,5.0
818,1502,3,Player object (998),sell,2023-03-06 01:53:24.408828+00:00,"{""priceA"": 90, ""sharesA"": 0, ""secs_since_round_starts"": 49, ""market"": ""A""}",140.0,7.0,1.0,93y42seh,vmu7c279,FULL STUDY,195.0,s1,1,90,,1,,1,,0,sell,0.4580966810292103,19,0,0,block 3 (G second),20.0,11.0,Male,1.0,1.0,1.0,"[3, 'block 3 (G second)']",0,1,1,0.5,9.0,-0.016666666666666607,0.375,0.13333333333333333,0.5,0.0,5,0.75,0.75,Design 2,Design 2,"Have an option between Design #1 and Design #2,",,4.0,5.0
819,1503,3,Player object (998),buy,2023-03-06 01:53:30.536979+00:00,"{""priceA"": 110, ""sharesA"": 1, ""secs_since_round_starts"": 55, ""market"": ""A""}",30.0,9.0,2.0,93y42seh,vmu7c279,FULL STUDY,195.0,s1,1,110,90.0,-1,,1,sell,0,sell,0.5389563723055646,19,0,0,block 3 (G second),20.0,11.0,Male,1.0,1.0,1.0,"[3, 'block 3 (G second)']",0,1,1,0.5,9.0,-0.016666666666666607,0.375,0.13333333333333333,0.5,0.0,5,0.75,0.75,Design 2,Design 2,"Have an option between Design #1 and Design #2,",,4.0,5.0
820,1504,3,Player object (998),sell,2023-03-06 01:53:44.728054+00:00,"{""priceA"": 110, ""sharesA"": 0, ""secs_since_round_starts"": 69, ""market"": ""A""}",140.0,11.0,3.0,93y42seh,vmu7c279,FULL STUDY,195.0,s1,1,110,110.0,1,0.0,1,buy,0,sell,0.5295922419004607,19,0,0,block 3 (G second),20.0,11.0,Male,1.0,1.0,1.0,"[3, 'block 3 (G second)']",0,1,1,0.5,9.0,-0.016666666666666607,0.375,0.13333333333333333,0.5,0.0,5,0.75,0.75,Design 2,Design 2,"Have an option between Design #1 and Design #2,",,4.0,5.0
821,1505,3,Player object (998),buy,2023-03-06 01:54:07.984235+00:00,"{""priceA"": 110, ""sharesA"": 1, ""secs_since_round_starts"": 92, ""market"": ""A""}",30.0,15.0,4.0,93y42seh,vmu7c279,FULL STUDY,195.0,s1,1,110,110.0,-1,,1,sell,0,sell,0.4763410641166328,19,0,0,block 3 (G second),20.0,11.0,Male,1.0,1.0,1.0,"[3, 'block 3 (G second)']",0,1,1,0.5,9.0,-0.016666666666666607,0.375,0.13333333333333333,0.5,0.0,5,0.75,0.75,Design 2,Design 2,"Have an option between Design #1 and Design #2,",,4.0,5.0
822,1508,3,Player object (998),sell,2023-03-06 01:54:56.169787+00:00,"{""priceA"": 115, ""sharesA"": 0, ""secs_since_round_starts"": 141, ""market"": ""A""}",145.0,24.0,6.0,93y42seh,vmu7c279,FULL STUDY,195.0,s1,1,115,85.0,1,30.0,1,buy,0,sell,0.5319650978870379,19,0,0,block 3 (G second),20.0,11.0,Male,1.0,1.0,1.0,"[3, 'block 3 (G second)']",0,1,1,0.5,9.0,-0.016666666666666607,0.375,0.13333333333333333,0.5,0.0,5,0.75,0.75,Design 2,Design 2,"Have an option between Design #1 and Design #2,",,4.0,5.0
823,1509,3,Player object (998),buy,2023-03-06 01:54:58.630699+00:00,"{""priceA"": 110, ""sharesA"": 1, ""secs_since_round_starts"": 143, ""market"": ""A""}",35.0,25.0,7.0,93y42seh,vmu7c279,FULL STUDY,195.0,s1,1,110,115.0,-1,,1,sell,0,sell,0.4872943409941583,19,0,0,block 3 (G second),20.0,11.0,Male,1.0,1.0,1.0,"[3, 'block 3 (G second)']",0,1,1,0.5,9.0,-0.016666666666666607,0.375,0.13333333333333333,0.5,0.0,5,0.75,0.75,Design 2,Design 2,"Have an option between Design #1 and Design #2,",,4.0,5.0
824,1510,3,Player object (998),sell,2023-03-06 01:55:06.482234+00:00,"{""priceA"": 115, ""sharesA"": 0, ""secs_since_round_starts"": 150, ""market"": ""A""}",150.0,26.0,8.0,93y42seh,vmu7c279,FULL STUDY,195.0,s1,1,115,110.0,1,5.0,1,buy,0,sell,0.526172546586359,19,0,0,block 3 (G second),20.0,11.0,Male,1.0,1.0,1.0,"[3, 'block 3 (G second)']",0,1,1,0.5,9.0,-0.016666666666666607,0.375,0.13333333333333333,0.5,0.0,5,0.75,0.75,Design 2,Design 2,"Have an option between Design #1 and Design #2,",,4.0,5.0
825,1511,3,Player object (998),buy,2023-03-06 01:55:11.875017+00:00,"{""priceA"": 105, ""sharesA"": 1, ""secs_since_round_starts"": 156, ""market"": ""A""}",45.0,27.0,9.0,93y42seh,vmu7c279,FULL STUDY,195.0,s1,1,105,115.0,-1,,1,sell,0,sell,0.4832330156747784,19,0,0,block 3 (G second),20.0,11.0,Male,1.0,1.0,1.0,"[3, 'block 3 (G second)']",0,1,1,0.5,9.0,-0.016666666666666607,0.375,0.13333333333333333,0.5,0.0,5,0.75,0.75,Design 2,Design 2,"Have an option between Design #1 and Design #2,",,4.0,5.0
826,1512,3,Player object (998),sell,2023-03-06 01:55:15.831069+00:00,"{""priceA"": 110, ""sharesA"": 0, ""secs_since_round_starts"": 160, ""market"": ""A""}",155.0,28.0,10.0,93y42seh,vmu7c279,FULL STUDY,195.0,s1,1,110,105.0,1,5.0,1,buy,0,sell,0.5233413838959273,19,0,0,block 3 (G second),20.0,11.0,Male,1.0,1.0,1.0,"[3, 'block 3 (G second)']",0,1,1,0.5,9.0,-0.016666666666666607,0.375,0.13333333333333333,0.5,0.0,5,0.75,0.75,Design 2,Design 2,"Have an option between Design #1 and Design #2,",,4.0,5.0
827,1513,3,Player object (998),buy,2023-03-06 01:55:23.009132+00:00,"{""priceA"": 115, ""sharesA"": 1, ""secs_since_round_starts"": 168, ""market"": ""A""}",40.0,29.0,11.0,93y42seh,vmu7c279,FULL STUDY,195.0,s1,1,115,110.0,-1,,1,sell,0,sell,0.5511004178331719,19,0,0,block 3 (G second),20.0,11.0,Male,1.0,1.0,1.0,"[3, 'block 3 (G second)']",0,1,1,0.5,9.0,-0.016666666666666607,0.375,0.13333333333333333,0.5,0.0,5,0.75,0.75,Design 2,Design 2,"Have an option between Design #1 and Design #2,",,4.0,5.0
828,1514,3,Player object (998),sell,2023-03-06 01:55:28.190400+00:00,"{""priceA"": 120, ""sharesA"": 0, ""secs_since_round_starts"": 173, ""market"": ""A""}",160.0,30.0,12.0,93y42seh,vmu7c279,FULL STUDY,195.0,s1,1,120,115.0,1,5.0,1,buy,0,sell,0.570054331362491,19,0,1,block 3 (G second),20.0,11.0,Male,1.0,1.0,1.0,"[3, 'block 3 (G second)']",0,1,1,0.5,9.0,-0.016666666666666607,0.375,0.13333333333333333,0.5,0.0,5,0.75,0.75,Design 2,Design 2,"Have an option between Design #1 and Design #2,",,4.0,5.0
829,1516,3,Player object (998),buy,2023-03-06 01:55:43.063243+00:00,"{""priceA"": 110, ""sharesA"": 1, ""secs_since_round_starts"": 188, ""market"": ""A""}",50.0,32.0,13.0,93y42seh,vmu7c279,FULL STUDY,195.0,s1,1,110,120.0,-1,,1,sell,0,sell,0.4748947710808772,19,0,0,block 3 (G second),20.0,11.0,Male,1.0,1.0,1.0,"[3, 'block 3 (G second)']",0,1,1,0.5,9.0,-0.016666666666666607,0.375,0.13333333333333333,0.5,0.0,5,0.75,0.75,Design 2,Design 2,"Have an option between Design #1 and Design #2,",,4.0,5.0
830,1517,3,Player object (998),sell,2023-03-06 01:56:02.408582+00:00,"{""priceA"": 100, ""sharesA"": 0, ""secs_since_round_starts"": 207, ""market"": ""A""}",150.0,36.0,14.0,93y42seh,vmu7c279,FULL STUDY,195.0,s1,1,100,110.0,1,-10.0,1,buy,0,sell,0.440139794868048,19,0,0,block 3 (G second),20.0,11.0,Male,1.0,1.0,1.0,"[3, 'block 3 (G second)']",0,1,1,0.5,9.0,-0.016666666666666607,0.375,0.13333333333333333,0.5,0.0,5,0.75,0.75,Design 2,Design 2,"Have an option between Design #1 and Design #2,",,4.0,5.0
831,1518,3,Player object (998),buy,2023-03-06 01:56:06.956384+00:00,"{""priceA"": 95, ""sharesA"": 1, ""secs_since_round_starts"": 211, ""market"": ""A""}",55.0,37.0,15.0,93y42seh,vmu7c279,FULL STUDY,195.0,s1,1,95,100.0,-1,,1,sell,0,sell,0.4240076400585448,19,1,0,block 3 (G second),20.0,11.0,Male,1.0,1.0,1.0,"[3, 'block 3 (G second)']",0,1,1,0.5,9.0,-0.016666666666666607,0.375,0.13333333333333333,0.5,0.0,5,0.75,0.75,Design 2,Design 2,"Have an option between Design #1 and Design #2,",,4.0,5.0
832,1521,3,Player object (998),sell,2023-03-06 01:56:40.318732+00:00,"{""priceA"": 120, ""sharesA"": 0, ""secs_since_round_starts"": 244, ""market"": ""A""}",175.0,43.0,17.0,93y42seh,vmu7c279,FULL STUDY,195.0,s1,1,120,115.0,1,5.0,1,buy,0,sell,0.5357259670782416,19,0,0,block 3 (G second),20.0,11.0,Male,1.0,1.0,1.0,"[3, 'block 3 (G second)']",0,1,1,0.5,9.0,-0.016666666666666607,0.375,0.13333333333333333,0.5,0.0,5,0.75,0.75,Design 2,Design 2,"Have an option between Design #1 and Design #2,",,4.0,5.0
833,1522,3,Player object (998),buy,2023-03-06 01:57:16.328846+00:00,"{""priceA"": 110, ""sharesA"": 1, ""secs_since_round_starts"": 281, ""market"": ""A""}",65.0,49.0,18.0,93y42seh,vmu7c279,FULL STUDY,195.0,s1,1,110,120.0,-1,,1,sell,0,sell,0.4374794566672981,19,1,0,block 3 (G second),20.0,11.0,Male,1.0,1.0,1.0,"[3, 'block 3 (G second)']",0,1,1,0.5,9.0,-0.016666666666666607,0.375,0.13333333333333333,0.5,0.0,5,0.75,0.75,Design 2,Design 2,"Have an option between Design #1 and Design #2,",,4.0,5.0
834,1525,3,Player object (998),sell,2023-03-06 01:57:40.408398+00:00,"{""priceA"": 145, ""sharesA"": 0, ""secs_since_round_starts"": 305, ""market"": ""A""}",210.0,54.0,20.0,93y42seh,vmu7c279,FULL STUDY,195.0,s1,1,145,125.0,1,20.0,1,buy,0,sell,0.52846438705912,19,0,0,block 3 (G second),20.0,11.0,Male,1.0,1.0,1.0,"[3, 'block 3 (G second)']",0,1,1,0.5,9.0,-0.016666666666666607,0.375,0.13333333333333333,0.5,0.0,5,0.75,0.75,Design 2,Design 2,"Have an option between Design #1 and Design #2,",,4.0,5.0
835,1526,3,Player object (998),buy,2023-03-06 01:58:00.552852+00:00,"{""priceA"": 130, ""sharesA"": 1, ""secs_since_round_starts"": 325, ""market"": ""A""}",80.0,57.0,21.0,93y42seh,vmu7c279,FULL STUDY,195.0,s1,1,130,145.0,-1,,1,sell,0,sell,0.46726452652799,19,0,0,block 3 (G second),20.0,11.0,Male,1.0,1.0,1.0,"[3, 'block 3 (G second)']",0,1,1,0.5,9.0,-0.016666666666666607,0.375,0.13333333333333333,0.5,0.0,5,0.75,0.75,Design 2,Design 2,"Have an option between Design #1 and Design #2,",,4.0,5.0
836,1532,4,Player object (1118),sell,2023-03-06 01:59:12.407167+00:00,"{""priceA"": 45, ""sharesA"": 0, ""secs_since_round_starts"": 48, ""market"": ""A""}",95.0,7.0,2.0,93y42seh,vmu7c279,FULL STUDY,0.0,s1,1,45,40.0,1,5.0,1,,0,sell,0.4686531252667821,14,0,0,block 3 (G second),20.0,11.0,Male,1.0,1.0,1.0,"[4, 'block 3 (G second)']",1,0,1,0.5,9.0,-0.016666666666666607,0.25,0.22580645161290322,0.0,0.6666666666666666,4,0.5,0.25,Design 2,Design 2,"Have an option between Design #1 and Design #2,",,4.0,5.0
837,1533,4,Player object (1118),buy,2023-03-06 01:59:33.146050+00:00,"{""priceA"": 95, ""sharesA"": 1, ""secs_since_round_starts"": 69, ""market"": ""A""}",,11.0,3.0,93y42seh,vmu7c279,FULL STUDY,0.0,s1,1,95,45.0,-1,,1,sell,0,sell,0.5796571916404338,14,0,0,block 3 (G second),20.0,11.0,Male,1.0,1.0,1.0,"[4, 'block 3 (G second)']",1,0,1,0.5,9.0,-0.016666666666666607,0.25,0.22580645161290322,0.0,0.6666666666666666,4,0.5,0.25,Design 2,Design 2,"Have an option between Design #1 and Design #2,",,4.0,5.0
838,1534,4,Player object (1118),sell,2023-03-06 01:59:49.762401+00:00,"{""priceA"": 90, ""sharesA"": 0, ""secs_since_round_starts"": 86, ""market"": ""A""}",90.0,14.0,4.0,93y42seh,vmu7c279,FULL STUDY,0.0,s1,1,90,95.0,1,-5.0,1,buy,0,sell,0.5208618681016636,14,0,0,block 3 (G second),20.0,11.0,Male,1.0,1.0,1.0,"[4, 'block 3 (G second)']",1,0,1,0.5,9.0,-0.016666666666666607,0.25,0.22580645161290322,0.0,0.6666666666666666,4,0.5,0.25,Design 2,Design 2,"Have an option between Design #1 and Design #2,",,4.0,5.0
839,1535,4,Player object (1118),buy,2023-03-06 01:59:55.165709+00:00,"{""priceA"": 95, ""sharesA"": 1, ""secs_since_round_starts"": 91, ""market"": ""A""}",-5.0,15.0,5.0,93y42seh,vmu7c279,FULL STUDY,0.0,s1,1,95,90.0,-1,,1,sell,0,sell,0.5493972040799432,14,0,0,block 3 (G second),20.0,11.0,Male,1.0,1.0,1.0,"[4, 'block 3 (G second)']",1,0,1,0.5,9.0,-0.016666666666666607,0.25,0.22580645161290322,0.0,0.6666666666666666,4,0.5,0.25,Design 2,Design 2,"Have an option between Design #1 and Design #2,",,4.0,5.0
840,1538,4,Player object (1118),sell,2023-03-06 02:00:12.369008+00:00,"{""priceA"": 70, ""sharesA"": 0, ""secs_since_round_starts"": 108, ""market"": ""A""}",65.0,18.0,7.0,93y42seh,vmu7c279,FULL STUDY,0.0,s1,1,70,85.0,1,-15.0,1,buy,0,sell,0.4407118028401492,14,1,0,block 3 (G second),20.0,11.0,Male,1.0,1.0,1.0,"[4, 'block 3 (G second)']",1,0,1,0.5,9.0,-0.016666666666666607,0.25,0.22580645161290322,0.0,0.6666666666666666,4,0.5,0.25,Design 2,Design 2,"Have an option between Design #1 and Design #2,",,4.0,5.0
841,1539,4,Player object (1118),buy,2023-03-06 02:00:20.168383+00:00,"{""priceA"": 85, ""sharesA"": 1, ""secs_since_round_starts"": 116, ""market"": ""A""}",-20.0,19.0,8.0,93y42seh,vmu7c279,FULL STUDY,0.0,s1,1,85,70.0,-1,,1,sell,0,sell,0.4934202415852731,14,0,0,block 3 (G second),20.0,11.0,Male,1.0,1.0,1.0,"[4, 'block 3 (G second)']",1,0,1,0.5,9.0,-0.016666666666666607,0.25,0.22580645161290322,0.0,0.6666666666666666,4,0.5,0.25,Design 2,Design 2,"Have an option between Design #1 and Design #2,",,4.0,5.0
842,1545,4,Player object (1118),sell,2023-03-06 02:01:11.255352+00:00,"{""priceA"": 80, ""sharesA"": 0, ""secs_since_round_starts"": 167, ""market"": ""A""}",60.0,28.0,11.0,93y42seh,vmu7c279,FULL STUDY,0.0,s1,1,80,55.0,1,25.0,1,buy,0,sell,0.5529051331090981,14,0,1,block 3 (G second),20.0,11.0,Male,1.0,1.0,1.0,"[4, 'block 3 (G second)']",1,0,1,0.5,9.0,-0.016666666666666607,0.25,0.22580645161290322,0.0,0.6666666666666666,4,0.5,0.25,Design 2,Design 2,"Have an option between Design #1 and Design #2,",,4.0,5.0
843,1546,4,Player object (1118),buy,2023-03-06 02:01:16.187418+00:00,"{""priceA"": 90, ""sharesA"": 1, ""secs_since_round_starts"": 172, ""market"": ""A""}",-30.0,29.0,12.0,93y42seh,vmu7c279,FULL STUDY,0.0,s1,1,90,80.0,-1,,1,sell,0,sell,0.5712793841154561,14,0,0,block 3 (G second),20.0,11.0,Male,1.0,1.0,1.0,"[4, 'block 3 (G second)']",1,0,1,0.5,9.0,-0.016666666666666607,0.25,0.22580645161290322,0.0,0.6666666666666666,4,0.5,0.25,Design 2,Design 2,"Have an option between Design #1 and Design #2,",,4.0,5.0
844,1548,4,Player object (1118),sell,2023-03-06 02:01:50.418342+00:00,"{""priceA"": 100, ""sharesA"": 0, ""secs_since_round_starts"": 206, ""market"": ""A""}",70.0,33.0,13.0,93y42seh,vmu7c279,FULL STUDY,0.0,s1,1,100,90.0,1,10.0,1,buy,0,sell,0.5473882863317556,14,0,0,block 3 (G second),20.0,11.0,Male,1.0,1.0,1.0,"[4, 'block 3 (G second)']",1,0,1,0.5,9.0,-0.016666666666666607,0.25,0.22580645161290322,0.0,0.6666666666666666,4,0.5,0.25,Design 2,Design 2,"Have an option between Design #1 and Design #2,",,4.0,5.0
845,1549,4,Player object (1118),buy,2023-03-06 02:02:01.611784+00:00,"{""priceA"": 100, ""sharesA"": 1, ""secs_since_round_starts"": 218, ""market"": ""A""}",-30.0,35.0,14.0,93y42seh,vmu7c279,FULL STUDY,0.0,s1,1,100,100.0,-1,,1,sell,0,sell,0.5337204628349665,14,0,0,block 3 (G second),20.0,11.0,Male,1.0,1.0,1.0,"[4, 'block 3 (G second)']",1,0,1,0.5,9.0,-0.016666666666666607,0.25,0.22580645161290322,0.0,0.6666666666666666,4,0.5,0.25,Design 2,Design 2,"Have an option between Design #1 and Design #2,",,4.0,5.0
846,1550,4,Player object (1118),sell,2023-03-06 02:02:18.499684+00:00,"{""priceA"": 65, ""sharesA"": 0, ""secs_since_round_starts"": 234, ""market"": ""A""}",35.0,38.0,15.0,93y42seh,vmu7c279,FULL STUDY,0.0,s1,1,65,100.0,1,-35.0,1,buy,0,sell,0.4355009867455686,14,1,0,block 3 (G second),20.0,11.0,Male,1.0,1.0,1.0,"[4, 'block 3 (G second)']",1,0,1,0.5,9.0,-0.016666666666666607,0.25,0.22580645161290322,0.0,0.6666666666666666,4,0.5,0.25,Design 2,Design 2,"Have an option between Design #1 and Design #2,",,4.0,5.0
847,1552,4,Player object (1118),buy,2023-03-06 02:02:30.167864+00:00,"{""priceA"": 80, ""sharesA"": 1, ""secs_since_round_starts"": 246, ""market"": ""A""}",-45.0,39.0,16.0,93y42seh,vmu7c279,FULL STUDY,0.0,s1,1,80,65.0,-1,,1,sell,0,sell,0.4897180556691627,14,0,0,block 3 (G second),20.0,11.0,Male,1.0,1.0,1.0,"[4, 'block 3 (G second)']",1,0,1,0.5,9.0,-0.016666666666666607,0.25,0.22580645161290322,0.0,0.6666666666666666,4,0.5,0.25,Design 2,Design 2,"Have an option between Design #1 and Design #2,",,4.0,5.0
848,1553,4,Player object (1118),sell,2023-03-06 02:02:39.334949+00:00,"{""priceA"": 80, ""sharesA"": 0, ""secs_since_round_starts"": 255, ""market"": ""A""}",35.0,41.0,17.0,93y42seh,vmu7c279,FULL STUDY,0.0,s1,1,80,80.0,1,0.0,1,buy,0,sell,0.5055693706451859,14,0,0,block 3 (G second),20.0,11.0,Male,1.0,1.0,1.0,"[4, 'block 3 (G second)']",1,0,1,0.5,9.0,-0.016666666666666607,0.25,0.22580645161290322,0.0,0.6666666666666666,4,0.5,0.25,Design 2,Design 2,"Have an option between Design #1 and Design #2,",,4.0,5.0
849,1555,4,Player object (1118),buy,2023-03-06 02:02:51.092579+00:00,"{""priceA"": 100, ""sharesA"": 1, ""secs_since_round_starts"": 267, ""market"": ""A""}",-65.0,43.0,18.0,93y42seh,vmu7c279,FULL STUDY,0.0,s1,1,100,80.0,-1,,1,sell,0,sell,0.5617190733230237,14,0,1,block 3 (G second),20.0,11.0,Male,1.0,1.0,1.0,"[4, 'block 3 (G second)']",1,0,1,0.5,9.0,-0.016666666666666607,0.25,0.22580645161290322,0.0,0.6666666666666666,4,0.5,0.25,Design 2,Design 2,"Have an option between Design #1 and Design #2,",,4.0,5.0
850,1558,4,Player object (1118),sell,2023-03-06 02:03:12.006926+00:00,"{""priceA"": 85, ""sharesA"": 0, ""secs_since_round_starts"": 288, ""market"": ""A""}",20.0,47.0,20.0,93y42seh,vmu7c279,FULL STUDY,0.0,s1,1,85,115.0,1,-30.0,1,buy,0,sell,0.4501495476988393,14,1,0,block 3 (G second),20.0,11.0,Male,1.0,1.0,1.0,"[4, 'block 3 (G second)']",1,0,1,0.5,9.0,-0.016666666666666607,0.25,0.22580645161290322,0.0,0.6666666666666666,4,0.5,0.25,Design 2,Design 2,"Have an option between Design #1 and Design #2,",,4.0,5.0
851,1560,4,Player object (1118),buy,2023-03-06 02:03:20.871600+00:00,"{""priceA"": 100, ""sharesA"": 1, ""secs_since_round_starts"": 297, ""market"": ""A""}",-80.0,48.0,21.0,93y42seh,vmu7c279,FULL STUDY,0.0,s1,1,100,85.0,-1,,1,sell,0,sell,0.500105737602651,14,0,0,block 3 (G second),20.0,11.0,Male,1.0,1.0,1.0,"[4, 'block 3 (G second)']",1,0,1,0.5,9.0,-0.016666666666666607,0.25,0.22580645161290322,0.0,0.6666666666666666,4,0.5,0.25,Design 2,Design 2,"Have an option between Design #1 and Design #2,",,4.0,5.0
852,1567,4,Player object (1118),sell,2023-03-06 02:04:05.511358+00:00,"{""priceA"": 65, ""sharesA"": 0, ""secs_since_round_starts"": 342, ""market"": ""A""}",-15.0,56.0,23.0,93y42seh,vmu7c279,FULL STUDY,0.0,s1,1,65,120.0,1,-55.0,1,buy,0,sell,0.4388999887324031,14,0,0,block 3 (G second),20.0,11.0,Male,1.0,1.0,1.0,"[4, 'block 3 (G second)']",1,0,1,0.5,9.0,-0.016666666666666607,0.25,0.22580645161290322,0.0,0.6666666666666666,4,0.5,0.25,Design 2,Design 2,"Have an option between Design #1 and Design #2,",,4.0,5.0
853,1568,4,Player object (1118),buy,2023-03-06 02:04:12.858896+00:00,"{""priceA"": 55, ""sharesA"": 1, ""secs_since_round_starts"": 349, ""market"": ""A""}",-70.0,57.0,24.0,93y42seh,vmu7c279,FULL STUDY,0.0,s1,1,55,65.0,-1,,1,sell,0,sell,0.4231688687101841,14,1,0,block 3 (G second),20.0,11.0,Male,1.0,1.0,1.0,"[4, 'block 3 (G second)']",1,0,1,0.5,9.0,-0.016666666666666607,0.25,0.22580645161290322,0.0,0.6666666666666666,4,0.5,0.25,Design 2,Design 2,"Have an option between Design #1 and Design #2,",,4.0,5.0
854,1569,4,Player object (1118),sell,2023-03-06 02:04:22.039343+00:00,"{""priceA"": 70, ""sharesA"": 0, ""secs_since_round_starts"": 358, ""market"": ""A""}",,59.0,25.0,93y42seh,vmu7c279,FULL STUDY,0.0,s1,1,70,55.0,1,15.0,1,buy,0,sell,0.5217304705105344,14,0,0,block 3 (G second),20.0,11.0,Male,1.0,1.0,1.0,"[4, 'block 3 (G second)']",1,0,1,0.5,9.0,-0.016666666666666607,0.25,0.22580645161290322,0.0,0.6666666666666666,4,0.5,0.25,Design 2,Design 2,"Have an option between Design #1 and Design #2,",,4.0,5.0
855,1572,4,Player object (1118),buy,2023-03-06 02:04:32.397777+00:00,"{""priceA"": 75, ""sharesA"": 1, ""secs_since_round_starts"": 368, ""market"": ""A""}",-75.0,60.0,26.0,93y42seh,vmu7c279,FULL STUDY,0.0,s1,1,75,70.0,-1,,1,sell,0,sell,0.5499940505093152,14,0,1,block 3 (G second),20.0,11.0,Male,1.0,1.0,1.0,"[4, 'block 3 (G second)']",1,0,1,0.5,9.0,-0.016666666666666607,0.25,0.22580645161290322,0.0,0.6666666666666666,4,0.5,0.25,Design 2,Design 2,"Have an option between Design #1 and Design #2,",,4.0,5.0
856,1576,5,Player object (1238),sell,2023-03-06 02:05:46.306916+00:00,"{""priceA"": 85, ""sharesA"": 0, ""secs_since_round_starts"": 67, ""market"": ""A""}",135.0,13.0,1.0,93y42seh,vmu7c279,FULL STUDY,195.0,s1,1,85,,1,,1,,0,sell,0.4890232705715233,17,0,0,block 3 (G second),20.0,11.0,Male,1.0,1.0,1.0,"[5, 'block 3 (G second)']",1,1,1,1.0,9.0,-0.016666666666666607,0.2222222222222222,0.125,0.75,0.0,4,0.5,0.75,Design 2,Design 2,"Have an option between Design #1 and Design #2,",,4.0,5.0
857,1577,5,Player object (1238),buy,2023-03-06 02:05:53.301823+00:00,"{""priceA"": 80, ""sharesA"": 1, ""secs_since_round_starts"": 74, ""market"": ""A""}",55.0,14.0,2.0,93y42seh,vmu7c279,FULL STUDY,195.0,s1,1,80,85.0,-1,,1,sell,0,sell,0.457409789643144,17,0,0,block 3 (G second),20.0,11.0,Male,1.0,1.0,1.0,"[5, 'block 3 (G second)']",1,1,1,1.0,9.0,-0.016666666666666607,0.2222222222222222,0.125,0.75,0.0,4,0.5,0.75,Design 2,Design 2,"Have an option between Design #1 and Design #2,",,4.0,5.0
858,1578,5,Player object (1238),sell,2023-03-06 02:06:30.696987+00:00,"{""priceA"": 105, ""sharesA"": 0, ""secs_since_round_starts"": 111, ""market"": ""A""}",160.0,21.0,3.0,93y42seh,vmu7c279,FULL STUDY,195.0,s1,1,105,80.0,1,25.0,1,buy,0,sell,0.5510362930796925,17,0,1,block 3 (G second),20.0,11.0,Male,1.0,1.0,1.0,"[5, 'block 3 (G second)']",1,1,1,1.0,9.0,-0.016666666666666607,0.2222222222222222,0.125,0.75,0.0,4,0.5,0.75,Design 2,Design 2,"Have an option between Design #1 and Design #2,",,4.0,5.0
859,1579,5,Player object (1238),buy,2023-03-06 02:06:50.453520+00:00,"{""priceA"": 105, ""sharesA"": 1, ""secs_since_round_starts"": 131, ""market"": ""A""}",55.0,24.0,4.0,93y42seh,vmu7c279,FULL STUDY,195.0,s1,1,105,105.0,-1,,1,sell,0,sell,0.5594334008058068,17,0,0,block 3 (G second),20.0,11.0,Male,1.0,1.0,1.0,"[5, 'block 3 (G second)']",1,1,1,1.0,9.0,-0.016666666666666607,0.2222222222222222,0.125,0.75,0.0,4,0.5,0.75,Design 2,Design 2,"Have an option between Design #1 and Design #2,",,4.0,5.0
860,1580,5,Player object (1238),sell,2023-03-06 02:06:52.906804+00:00,"{""priceA"": 115, ""sharesA"": 0, ""secs_since_round_starts"": 133, ""market"": ""A""}",170.0,25.0,5.0,93y42seh,vmu7c279,FULL STUDY,195.0,s1,1,115,105.0,1,10.0,1,buy,0,sell,0.5757035170695836,17,0,1,block 3 (G second),20.0,11.0,Male,1.0,1.0,1.0,"[5, 'block 3 (G second)']",1,1,1,1.0,9.0,-0.016666666666666607,0.2222222222222222,0.125,0.75,0.0,4,0.5,0.75,Design 2,Design 2,"Have an option between Design #1 and Design #2,",,4.0,5.0
861,1581,5,Player object (1238),buy,2023-03-06 02:07:09.820111+00:00,"{""priceA"": 85, ""sharesA"": 1, ""secs_since_round_starts"": 150, ""market"": ""A""}",85.0,28.0,6.0,93y42seh,vmu7c279,FULL STUDY,195.0,s1,1,85,115.0,-1,,1,sell,0,sell,0.4496194529460131,17,1,0,block 3 (G second),20.0,11.0,Male,1.0,1.0,1.0,"[5, 'block 3 (G second)']",1,1,1,1.0,9.0,-0.016666666666666607,0.2222222222222222,0.125,0.75,0.0,4,0.5,0.75,Design 2,Design 2,"Have an option between Design #1 and Design #2,",,4.0,5.0
862,1583,5,Player object (1238),sell,2023-03-06 02:07:37.063794+00:00,"{""priceA"": 110, ""sharesA"": 0, ""secs_since_round_starts"": 178, ""market"": ""A""}",195.0,33.0,7.0,93y42seh,vmu7c279,FULL STUDY,195.0,s1,1,110,85.0,1,25.0,1,buy,0,sell,0.5480287979668599,17,0,1,block 3 (G second),20.0,11.0,Male,1.0,1.0,1.0,"[5, 'block 3 (G second)']",1,1,1,1.0,9.0,-0.016666666666666607,0.2222222222222222,0.125,0.75,0.0,4,0.5,0.75,Design 2,Design 2,"Have an option between Design #1 and Design #2,",,4.0,5.0
863,1584,5,Player object (1238),buy,2023-03-06 02:08:04.813813+00:00,"{""priceA"": 80, ""sharesA"": 1, ""secs_since_round_starts"": 205, ""market"": ""A""}",115.0,38.0,8.0,93y42seh,vmu7c279,FULL STUDY,195.0,s1,1,80,110.0,-1,,1,sell,0,sell,0.4515999245786187,17,1,0,block 3 (G second),20.0,11.0,Male,1.0,1.0,1.0,"[5, 'block 3 (G second)']",1,1,1,1.0,9.0,-0.016666666666666607,0.2222222222222222,0.125,0.75,0.0,4,0.5,0.75,Design 2,Design 2,"Have an option between Design #1 and Design #2,",,4.0,5.0
864,1590,5,Player object (1238),sell,2023-03-06 02:08:36.408540+00:00,"{""priceA"": 110, ""sharesA"": 0, ""secs_since_round_starts"": 237, ""market"": ""A""}",225.0,43.0,11.0,93y42seh,vmu7c279,FULL STUDY,195.0,s1,1,110,100.0,1,10.0,1,buy,0,sell,0.571300234525265,17,0,0,block 3 (G second),20.0,11.0,Male,1.0,1.0,1.0,"[5, 'block 3 (G second)']",1,1,1,1.0,9.0,-0.016666666666666607,0.2222222222222222,0.125,0.75,0.0,4,0.5,0.75,Design 2,Design 2,"Have an option between Design #1 and Design #2,",,4.0,5.0
865,1592,5,Player object (1238),buy,2023-03-06 02:08:50.237138+00:00,"{""priceA"": 110, ""sharesA"": 1, ""secs_since_round_starts"": 251, ""market"": ""A""}",115.0,45.0,12.0,93y42seh,vmu7c279,FULL STUDY,195.0,s1,1,110,110.0,-1,,1,sell,0,sell,0.5454506058480159,17,0,0,block 3 (G second),20.0,11.0,Male,1.0,1.0,1.0,"[5, 'block 3 (G second)']",1,1,1,1.0,9.0,-0.016666666666666607,0.2222222222222222,0.125,0.75,0.0,4,0.5,0.75,Design 2,Design 2,"Have an option between Design #1 and Design #2,",,4.0,5.0
866,1593,5,Player object (1238),sell,2023-03-06 02:09:00.411177+00:00,"{""priceA"": 90, ""sharesA"": 0, ""secs_since_round_starts"": 259, ""market"": ""A""}",205.0,47.0,13.0,93y42seh,vmu7c279,FULL STUDY,195.0,s1,1,90,110.0,1,-20.0,1,buy,0,sell,0.4627742743797309,17,0,0,block 3 (G second),20.0,11.0,Male,1.0,1.0,1.0,"[5, 'block 3 (G second)']",1,1,1,1.0,9.0,-0.016666666666666607,0.2222222222222222,0.125,0.75,0.0,4,0.5,0.75,Design 2,Design 2,"Have an option between Design #1 and Design #2,",,4.0,5.0
867,1594,5,Player object (1238),buy,2023-03-06 02:09:04.031522+00:00,"{""priceA"": 75, ""sharesA"": 1, ""secs_since_round_starts"": 265, ""market"": ""A""}",130.0,48.0,14.0,93y42seh,vmu7c279,FULL STUDY,195.0,s1,1,75,90.0,-1,,1,sell,0,sell,0.4393932183506925,17,1,0,block 3 (G second),20.0,11.0,Male,1.0,1.0,1.0,"[5, 'block 3 (G second)']",1,1,1,1.0,9.0,-0.016666666666666607,0.2222222222222222,0.125,0.75,0.0,4,0.5,0.75,Design 2,Design 2,"Have an option between Design #1 and Design #2,",,4.0,5.0
868,2004,2,Player object (900),sell,2023-03-08 02:38:54.029258+00:00,"{""priceA"": 100, ""sharesA"": 0, ""secs_since_round_starts"": 62, ""market"": ""A""}",150.0,12.0,1.0,9xz1zuoz,vmu7c279,FULL STUDY,170.0,s4,1,100,,1,,1,,0,sell,0.5,0,0,0,block 2 (G first),20.0,12.0,Female,1.0,1.0,1.0,"[2, 'block 2 (G first)']",1,1,0,1.0,10.0,0.0,0.2,0.041666666666666664,1.0,0.2,5,0.5,1.0,Design 2,Design 2,"Have an option between Design #1 and Design #2,",5.0,,
869,2005,2,Player object (900),buy,2023-03-08 02:38:58.400024+00:00,"{""priceA"": 85, ""sharesA"": 1, ""secs_since_round_starts"": 66, ""market"": ""A""}",65.0,13.0,2.0,9xz1zuoz,vmu7c279,FULL STUDY,170.0,s4,1,85,100.0,-1,,1,sell,0,sell,0.5,0,0,0,block 2 (G first),20.0,12.0,Female,1.0,1.0,1.0,"[2, 'block 2 (G first)']",1,1,0,1.0,10.0,0.0,0.2,0.041666666666666664,1.0,0.2,5,0.5,1.0,Design 2,Design 2,"Have an option between Design #1 and Design #2,",5.0,,
870,2008,2,Player object (900),sell,2023-03-08 02:39:31.925734+00:00,"{""priceA"": 75, ""sharesA"": 0, ""secs_since_round_starts"": 99, ""market"": ""A""}",140.0,19.0,4.0,9xz1zuoz,vmu7c279,FULL STUDY,170.0,s4,1,75,60.0,1,15.0,1,buy,0,sell,0.5,0,0,1,block 2 (G first),20.0,12.0,Female,1.0,1.0,1.0,"[2, 'block 2 (G first)']",1,1,0,1.0,10.0,0.0,0.2,0.041666666666666664,1.0,0.2,5,0.5,1.0,Design 2,Design 2,"Have an option between Design #1 and Design #2,",5.0,,
871,2010,2,Player object (900),buy,2023-03-08 02:40:51.490976+00:00,"{""priceA"": 75, ""sharesA"": 1, ""secs_since_round_starts"": 179, ""market"": ""A""}",65.0,34.0,5.0,9xz1zuoz,vmu7c279,FULL STUDY,170.0,s4,1,75,75.0,-1,,1,sell,0,sell,0.5,0,1,0,block 2 (G first),20.0,12.0,Female,1.0,1.0,1.0,"[2, 'block 2 (G first)']",1,1,0,1.0,10.0,0.0,0.2,0.041666666666666664,1.0,0.2,5,0.5,1.0,Design 2,Design 2,"Have an option between Design #1 and Design #2,",5.0,,
872,2011,2,Player object (900),sell,2023-03-08 02:42:36.963587+00:00,"{""priceA"": 105, ""sharesA"": 0, ""secs_since_round_starts"": 284, ""market"": ""A""}",170.0,53.0,6.0,9xz1zuoz,vmu7c279,FULL STUDY,170.0,s4,1,105,75.0,1,30.0,1,buy,0,sell,0.5,0,0,1,block 2 (G first),20.0,12.0,Female,1.0,1.0,1.0,"[2, 'block 2 (G first)']",1,1,0,1.0,10.0,0.0,0.2,0.041666666666666664,1.0,0.2,5,0.5,1.0,Design 2,Design 2,"Have an option between Design #1 and Design #2,",5.0,,
873,2012,2,Player object (900),buy,2023-03-08 02:43:15.408631+00:00,"{""priceA"": 95, ""sharesA"": 1, ""secs_since_round_starts"": 323, ""market"": ""A""}",75.0,60.0,7.0,9xz1zuoz,vmu7c279,FULL STUDY,170.0,s4,1,95,105.0,-1,,1,sell,0,sell,0.5,0,0,0,block 2 (G first),20.0,12.0,Female,1.0,1.0,1.0,"[2, 'block 2 (G first)']",1,1,0,1.0,10.0,0.0,0.2,0.041666666666666664,1.0,0.2,5,0.5,1.0,Design 2,Design 2,"Have an option between Design #1 and Design #2,",5.0,,
874,2037,4,Player object (1140),sell,2023-03-08 02:59:09.772434+00:00,"{""priceA"": 135, ""sharesA"": 0, ""secs_since_round_starts"": 312, ""market"": ""A""}",185.0,55.0,1.0,9xz1zuoz,vmu7c279,FULL STUDY,185.0,s4,1,135,,1,,1,,0,sell,0.5,0,0,0,block 2 (G first),20.0,12.0,Female,1.0,1.0,1.0,"[4, 'block 2 (G first)']",0,1,0,1.0,10.0,0.0,0.047619047619047616,0.0,0.0,0.0,4,0.75,1.0,Design 2,Design 2,"Have an option between Design #1 and Design #2,",5.0,,
875,2041,5,Player object (1260),sell,2023-03-08 03:00:58.717799+00:00,"{""priceA"": 140, ""sharesA"": 0, ""secs_since_round_starts"": 75, ""market"": ""A""}",190.0,14.0,1.0,9xz1zuoz,vmu7c279,FULL STUDY,205.0,s4,1,140,,1,,1,,0,sell,0.5,0,0,0,block 2 (G first),20.0,12.0,Female,1.0,1.0,1.0,"[5, 'block 2 (G first)']",0,0,0,1.0,10.0,0.0,0.125,0.0,0.0,0.0,5,0.5,1.0,Design 2,Design 2,"Have an option between Design #1 and Design #2,",5.0,,
876,2042,5,Player object (1260),buy,2023-03-08 03:01:22.296610+00:00,"{""priceA"": 115, ""sharesA"": 1, ""secs_since_round_starts"": 98, ""market"": ""A""}",75.0,18.0,2.0,9xz1zuoz,vmu7c279,FULL STUDY,205.0,s4,1,115,140.0,-1,,1,sell,0,sell,0.5,0,1,0,block 2 (G first),20.0,12.0,Female,1.0,1.0,1.0,"[5, 'block 2 (G first)']",0,0,0,1.0,10.0,0.0,0.125,0.0,0.0,0.0,5,0.5,1.0,Design 2,Design 2,"Have an option between Design #1 and Design #2,",5.0,,
877,2043,5,Player object (1260),sell,2023-03-08 03:01:47.714664+00:00,"{""priceA"": 150, ""sharesA"": 0, ""secs_since_round_starts"": 124, ""market"": ""A""}",225.0,23.0,3.0,9xz1zuoz,vmu7c279,FULL STUDY,205.0,s4,1,150,115.0,1,35.0,1,buy,0,sell,0.5,0,0,0,block 2 (G first),20.0,12.0,Female,1.0,1.0,1.0,"[5, 'block 2 (G first)']",0,0,0,1.0,10.0,0.0,0.125,0.0,0.0,0.0,5,0.5,1.0,Design 2,Design 2,"Have an option between Design #1 and Design #2,",5.0,,
878,2045,5,Player object (1260),buy,2023-03-08 03:03:36.814842+00:00,"{""priceA"": 115, ""sharesA"": 1, ""secs_since_round_starts"": 233, ""market"": ""A""}",110.0,43.0,4.0,9xz1zuoz,vmu7c279,FULL STUDY,205.0,s4,1,115,150.0,-1,,1,sell,0,sell,0.5,0,0,0,block 2 (G first),20.0,12.0,Female,1.0,1.0,1.0,"[5, 'block 2 (G first)']",0,0,0,1.0,10.0,0.0,0.125,0.0,0.0,0.0,5,0.5,1.0,Design 2,Design 2,"Have an option between Design #1 and Design #2,",5.0,,
879,4299,2,Player object (947),sell,2023-03-09 22:44:10.589488+00:00,"{""priceA"": 100, ""sharesA"": 0, ""secs_since_round_starts"": 95, ""market"": ""A""}",150.0,7.0,1.0,aqvtf4p9,vmu7c279,FULL STUDY,195.0,s3,1,100,,1,,1,,0,sell,0.4669924949471701,16,0,0,block 2 (G first),21.0,12.0,Male,1.0,0.0,0.0,"[2, 'block 2 (G first)']",1,1,0,0.5,1.0,-0.9,0.1875,0.3076923076923077,0.0,0.0,4,1.0,0.75,Design 1,Design 1,"Have an option between Design #1 and Design #2,",5.0,5.0,5.0
880,4301,2,Player object (947),buy,2023-03-09 22:44:25.910143+00:00,"{""priceA"": 75, ""sharesA"": 1, ""secs_since_round_starts"": 110, ""market"": ""A""}",75.0,10.0,2.0,aqvtf4p9,vmu7c279,FULL STUDY,195.0,s3,1,75,100.0,-1,,1,sell,0,sell,0.4825575314143953,16,0,0,block 2 (G first),21.0,12.0,Male,1.0,0.0,0.0,"[2, 'block 2 (G first)']",1,1,0,0.5,1.0,-0.9,0.1875,0.3076923076923077,0.0,0.0,4,1.0,0.75,Design 1,Design 1,"Have an option between Design #1 and Design #2,",5.0,5.0,5.0
881,4303,2,Player object (947),sell,2023-03-09 22:44:58.596682+00:00,"{""priceA"": 105, ""sharesA"": 0, ""secs_since_round_starts"": 143, ""market"": ""A""}",180.0,16.0,3.0,aqvtf4p9,vmu7c279,FULL STUDY,195.0,s3,1,105,75.0,1,30.0,1,buy,0,sell,0.5185790363913291,16,0,0,block 2 (G first),21.0,12.0,Male,1.0,0.0,0.0,"[2, 'block 2 (G first)']",1,1,0,0.5,1.0,-0.9,0.1875,0.3076923076923077,0.0,0.0,4,1.0,0.75,Design 1,Design 1,"Have an option between Design #1 and Design #2,",5.0,5.0,5.0
882,4305,2,Player object (947),buy,2023-03-09 22:45:12.122723+00:00,"{""priceA"": 125, ""sharesA"": 1, ""secs_since_round_starts"": 156, ""market"": ""A""}",55.0,18.0,4.0,aqvtf4p9,vmu7c279,FULL STUDY,195.0,s3,1,125,105.0,-1,,1,sell,0,sell,0.5678304910935957,16,0,0,block 2 (G first),21.0,12.0,Male,1.0,0.0,0.0,"[2, 'block 2 (G first)']",1,1,0,0.5,1.0,-0.9,0.1875,0.3076923076923077,0.0,0.0,4,1.0,0.75,Design 1,Design 1,"Have an option between Design #1 and Design #2,",5.0,5.0,5.0
883,4306,2,Player object (947),sell,2023-03-09 22:45:23.172211+00:00,"{""priceA"": 125, ""sharesA"": 0, ""secs_since_round_starts"": 167, ""market"": ""A""}",180.0,20.0,5.0,aqvtf4p9,vmu7c279,FULL STUDY,195.0,s3,1,125,125.0,1,0.0,1,buy,0,sell,0.5223275507294591,16,0,0,block 2 (G first),21.0,12.0,Male,1.0,0.0,0.0,"[2, 'block 2 (G first)']",1,1,0,0.5,1.0,-0.9,0.1875,0.3076923076923077,0.0,0.0,4,1.0,0.75,Design 1,Design 1,"Have an option between Design #1 and Design #2,",5.0,5.0,5.0
884,4308,2,Player object (947),buy,2023-03-09 22:45:50.502732+00:00,"{""priceA"": 145, ""sharesA"": 1, ""secs_since_round_starts"": 195, ""market"": ""A""}",35.0,25.0,6.0,aqvtf4p9,vmu7c279,FULL STUDY,195.0,s3,1,145,125.0,-1,,1,sell,0,sell,0.5294358264188312,16,0,0,block 2 (G first),21.0,12.0,Male,1.0,0.0,0.0,"[2, 'block 2 (G first)']",1,1,0,0.5,1.0,-0.9,0.1875,0.3076923076923077,0.0,0.0,4,1.0,0.75,Design 1,Design 1,"Have an option between Design #1 and Design #2,",5.0,5.0,5.0
885,4310,2,Player object (947),sell,2023-03-09 22:46:15.773231+00:00,"{""priceA"": 125, ""sharesA"": 0, ""secs_since_round_starts"": 220, ""market"": ""A""}",160.0,30.0,7.0,aqvtf4p9,vmu7c279,FULL STUDY,195.0,s3,1,125,145.0,1,-20.0,1,buy,0,sell,0.4785999259850118,16,0,0,block 2 (G first),21.0,12.0,Male,1.0,0.0,0.0,"[2, 'block 2 (G first)']",1,1,0,0.5,1.0,-0.9,0.1875,0.3076923076923077,0.0,0.0,4,1.0,0.75,Design 1,Design 1,"Have an option between Design #1 and Design #2,",5.0,5.0,5.0
886,4314,2,Player object (947),buy,2023-03-09 22:46:44.468400+00:00,"{""priceA"": 125, ""sharesA"": 1, ""secs_since_round_starts"": 249, ""market"": ""A""}",35.0,34.0,8.0,aqvtf4p9,vmu7c279,FULL STUDY,195.0,s3,1,125,125.0,-1,,1,sell,0,sell,0.4644502626891607,16,0,0,block 2 (G first),21.0,12.0,Male,1.0,0.0,0.0,"[2, 'block 2 (G first)']",1,1,0,0.5,1.0,-0.9,0.1875,0.3076923076923077,0.0,0.0,4,1.0,0.75,Design 1,Design 1,"Have an option between Design #1 and Design #2,",5.0,5.0,5.0
887,4316,2,Player object (947),sell,2023-03-09 22:46:55.804362+00:00,"{""priceA"": 150, ""sharesA"": 0, ""secs_since_round_starts"": 260, ""market"": ""A""}",185.0,36.0,9.0,aqvtf4p9,vmu7c279,FULL STUDY,195.0,s3,1,150,125.0,1,25.0,1,buy,0,sell,0.542045663089369,16,0,0,block 2 (G first),21.0,12.0,Male,1.0,0.0,0.0,"[2, 'block 2 (G first)']",1,1,0,0.5,1.0,-0.9,0.1875,0.3076923076923077,0.0,0.0,4,1.0,0.75,Design 1,Design 1,"Have an option between Design #1 and Design #2,",5.0,5.0,5.0
888,4317,2,Player object (947),buy,2023-03-09 22:47:00.812302+00:00,"{""priceA"": 145, ""sharesA"": 1, ""secs_since_round_starts"": 265, ""market"": ""A""}",40.0,37.0,10.0,aqvtf4p9,vmu7c279,FULL STUDY,195.0,s3,1,145,150.0,-1,,1,sell,0,sell,0.494384744736363,16,0,0,block 2 (G first),21.0,12.0,Male,1.0,0.0,0.0,"[2, 'block 2 (G first)']",1,1,0,0.5,1.0,-0.9,0.1875,0.3076923076923077,0.0,0.0,4,1.0,0.75,Design 1,Design 1,"Have an option between Design #1 and Design #2,",5.0,5.0,5.0
889,4320,2,Player object (947),sell,2023-03-09 22:47:11.744342+00:00,"{""priceA"": 140, ""sharesA"": 0, ""secs_since_round_starts"": 276, ""market"": ""A""}",180.0,38.0,11.0,aqvtf4p9,vmu7c279,FULL STUDY,195.0,s3,1,140,145.0,1,-5.0,1,buy,0,sell,0.4611129934091434,16,0,0,block 2 (G first),21.0,12.0,Male,1.0,0.0,0.0,"[2, 'block 2 (G first)']",1,1,0,0.5,1.0,-0.9,0.1875,0.3076923076923077,0.0,0.0,4,1.0,0.75,Design 1,Design 1,"Have an option between Design #1 and Design #2,",5.0,5.0,5.0
890,4322,2,Player object (947),buy,2023-03-09 22:47:21.469654+00:00,"{""priceA"": 140, ""sharesA"": 1, ""secs_since_round_starts"": 286, ""market"": ""A""}",40.0,40.0,12.0,aqvtf4p9,vmu7c279,FULL STUDY,195.0,s3,1,140,140.0,-1,,1,sell,0,sell,0.4916787423410894,16,0,0,block 2 (G first),21.0,12.0,Male,1.0,0.0,0.0,"[2, 'block 2 (G first)']",1,1,0,0.5,1.0,-0.9,0.1875,0.3076923076923077,0.0,0.0,4,1.0,0.75,Design 1,Design 1,"Have an option between Design #1 and Design #2,",5.0,5.0,5.0
891,4325,2,Player object (947),sell,2023-03-09 22:47:47.302543+00:00,"{""priceA"": 130, ""sharesA"": 0, ""secs_since_round_starts"": 312, ""market"": ""A""}",170.0,44.0,13.0,aqvtf4p9,vmu7c279,FULL STUDY,195.0,s3,1,130,140.0,1,-10.0,1,buy,0,sell,0.4799987600827208,16,0,0,block 2 (G first),21.0,12.0,Male,1.0,0.0,0.0,"[2, 'block 2 (G first)']",1,1,0,0.5,1.0,-0.9,0.1875,0.3076923076923077,0.0,0.0,4,1.0,0.75,Design 1,Design 1,"Have an option between Design #1 and Design #2,",5.0,5.0,5.0
892,4327,2,Player object (947),buy,2023-03-09 22:47:59.900365+00:00,"{""priceA"": 140, ""sharesA"": 1, ""secs_since_round_starts"": 324, ""market"": ""A""}",30.0,47.0,14.0,aqvtf4p9,vmu7c279,FULL STUDY,195.0,s3,1,140,130.0,-1,,1,sell,0,sell,0.4996814899229063,16,0,0,block 2 (G first),21.0,12.0,Male,1.0,0.0,0.0,"[2, 'block 2 (G first)']",1,1,0,0.5,1.0,-0.9,0.1875,0.3076923076923077,0.0,0.0,4,1.0,0.75,Design 1,Design 1,"Have an option between Design #1 and Design #2,",5.0,5.0,5.0
893,4330,2,Player object (947),sell,2023-03-09 22:48:16.083744+00:00,"{""priceA"": 155, ""sharesA"": 0, ""secs_since_round_starts"": 340, ""market"": ""A""}",185.0,50.0,15.0,aqvtf4p9,vmu7c279,FULL STUDY,195.0,s3,1,155,140.0,1,15.0,1,buy,0,sell,0.5063294801170398,16,0,0,block 2 (G first),21.0,12.0,Male,1.0,0.0,0.0,"[2, 'block 2 (G first)']",1,1,0,0.5,1.0,-0.9,0.1875,0.3076923076923077,0.0,0.0,4,1.0,0.75,Design 1,Design 1,"Have an option between Design #1 and Design #2,",5.0,5.0,5.0
894,4332,2,Player object (947),buy,2023-03-09 22:48:26.705676+00:00,"{""priceA"": 140, ""sharesA"": 1, ""secs_since_round_starts"": 351, ""market"": ""A""}",45.0,51.0,16.0,aqvtf4p9,vmu7c279,FULL STUDY,195.0,s3,1,140,155.0,-1,,1,sell,0,sell,0.4693918893964308,16,0,0,block 2 (G first),21.0,12.0,Male,1.0,0.0,0.0,"[2, 'block 2 (G first)']",1,1,0,0.5,1.0,-0.9,0.1875,0.3076923076923077,0.0,0.0,4,1.0,0.75,Design 1,Design 1,"Have an option between Design #1 and Design #2,",5.0,5.0,5.0
895,4334,2,Player object (947),sell,2023-03-09 22:48:36.531101+00:00,"{""priceA"": 135, ""sharesA"": 0, ""secs_since_round_starts"": 361, ""market"": ""A""}",180.0,53.0,17.0,aqvtf4p9,vmu7c279,FULL STUDY,195.0,s3,1,135,140.0,1,-5.0,1,buy,0,sell,0.4956940487416096,16,0,0,block 2 (G first),21.0,12.0,Male,1.0,0.0,0.0,"[2, 'block 2 (G first)']",1,1,0,0.5,1.0,-0.9,0.1875,0.3076923076923077,0.0,0.0,4,1.0,0.75,Design 1,Design 1,"Have an option between Design #1 and Design #2,",5.0,5.0,5.0
896,4335,2,Player object (947),buy,2023-03-09 22:49:01.012863+00:00,"{""priceA"": 110, ""sharesA"": 1, ""secs_since_round_starts"": 385, ""market"": ""A""}",70.0,57.0,18.0,aqvtf4p9,vmu7c279,FULL STUDY,195.0,s3,1,110,135.0,-1,,1,sell,0,sell,0.4349378880511929,16,1,0,block 2 (G first),21.0,12.0,Male,1.0,0.0,0.0,"[2, 'block 2 (G first)']",1,1,0,0.5,1.0,-0.9,0.1875,0.3076923076923077,0.0,0.0,4,1.0,0.75,Design 1,Design 1,"Have an option between Design #1 and Design #2,",5.0,5.0,5.0
897,4340,3,Player object (1067),sell,2023-03-09 22:49:58.137412+00:00,"{""priceA"": 95, ""sharesA"": 0, ""secs_since_round_starts"": 34, ""market"": ""A""}",145.0,6.0,1.0,aqvtf4p9,vmu7c279,FULL STUDY,180.0,s3,1,95,,1,,1,,0,sell,0.4900186148515444,19,0,0,block 2 (G first),21.0,12.0,Male,1.0,0.0,0.0,"[3, 'block 2 (G first)']",1,0,0,0.5,1.0,-0.9,0.6666666666666666,0.21052631578947367,,0.0,4,1.0,0.5,Design 1,Design 1,"Have an option between Design #1 and Design #2,",5.0,5.0,5.0
898,4341,3,Player object (1067),buy,2023-03-09 22:50:17.166774+00:00,"{""priceA"": 95, ""sharesA"": 1, ""secs_since_round_starts"": 53, ""market"": ""A""}",50.0,10.0,2.0,aqvtf4p9,vmu7c279,FULL STUDY,180.0,s3,1,95,95.0,-1,,1,sell,0,sell,0.4922087569005138,19,0,0,block 2 (G first),21.0,12.0,Male,1.0,0.0,0.0,"[3, 'block 2 (G first)']",1,0,0,0.5,1.0,-0.9,0.6666666666666666,0.21052631578947367,,0.0,4,1.0,0.5,Design 1,Design 1,"Have an option between Design #1 and Design #2,",5.0,5.0,5.0
899,4342,3,Player object (1067),sell,2023-03-09 22:50:30.162611+00:00,"{""priceA"": 120, ""sharesA"": 0, ""secs_since_round_starts"": 66, ""market"": ""A""}",170.0,12.0,3.0,aqvtf4p9,vmu7c279,FULL STUDY,180.0,s3,1,120,95.0,1,25.0,1,buy,0,sell,0.5553867656170776,19,0,0,block 2 (G first),21.0,12.0,Male,1.0,0.0,0.0,"[3, 'block 2 (G first)']",1,0,0,0.5,1.0,-0.9,0.6666666666666666,0.21052631578947367,,0.0,4,1.0,0.5,Design 1,Design 1,"Have an option between Design #1 and Design #2,",5.0,5.0,5.0
900,4343,3,Player object (1067),buy,2023-03-09 22:50:44.289845+00:00,"{""priceA"": 110, ""sharesA"": 1, ""secs_since_round_starts"": 81, ""market"": ""A""}",60.0,15.0,4.0,aqvtf4p9,vmu7c279,FULL STUDY,180.0,s3,1,110,120.0,-1,,1,sell,0,sell,0.4763410641166328,19,0,0,block 2 (G first),21.0,12.0,Male,1.0,0.0,0.0,"[3, 'block 2 (G first)']",1,0,0,0.5,1.0,-0.9,0.6666666666666666,0.21052631578947367,,0.0,4,1.0,0.5,Design 1,Design 1,"Have an option between Design #1 and Design #2,",5.0,5.0,5.0
901,4344,3,Player object (1067),sell,2023-03-09 22:50:55.250467+00:00,"{""priceA"": 105, ""sharesA"": 0, ""secs_since_round_starts"": 91, ""market"": ""A""}",165.0,17.0,5.0,aqvtf4p9,vmu7c279,FULL STUDY,180.0,s3,1,105,110.0,1,-5.0,1,buy,0,sell,0.4990675303551922,19,0,0,block 2 (G first),21.0,12.0,Male,1.0,0.0,0.0,"[3, 'block 2 (G first)']",1,0,0,0.5,1.0,-0.9,0.6666666666666666,0.21052631578947367,,0.0,4,1.0,0.5,Design 1,Design 1,"Have an option between Design #1 and Design #2,",5.0,5.0,5.0
902,4345,3,Player object (1067),buy,2023-03-09 22:51:12.800367+00:00,"{""priceA"": 115, ""sharesA"": 1, ""secs_since_round_starts"": 109, ""market"": ""A""}",50.0,20.0,6.0,aqvtf4p9,vmu7c279,FULL STUDY,180.0,s3,1,115,105.0,-1,,1,sell,0,sell,0.5061230669509241,19,0,0,block 2 (G first),21.0,12.0,Male,1.0,0.0,0.0,"[3, 'block 2 (G first)']",1,0,0,0.5,1.0,-0.9,0.6666666666666666,0.21052631578947367,,0.0,4,1.0,0.5,Design 1,Design 1,"Have an option between Design #1 and Design #2,",5.0,5.0,5.0
903,4347,3,Player object (1067),sell,2023-03-09 22:51:40.152831+00:00,"{""priceA"": 110, ""sharesA"": 0, ""secs_since_round_starts"": 136, ""market"": ""A""}",160.0,25.0,7.0,aqvtf4p9,vmu7c279,FULL STUDY,180.0,s3,1,110,115.0,1,-5.0,1,buy,0,sell,0.4872943409941583,19,0,0,block 2 (G first),21.0,12.0,Male,1.0,0.0,0.0,"[3, 'block 2 (G first)']",1,0,0,0.5,1.0,-0.9,0.6666666666666666,0.21052631578947367,,0.0,4,1.0,0.5,Design 1,Design 1,"Have an option between Design #1 and Design #2,",5.0,5.0,5.0
904,4352,3,Player object (1067),buy,2023-03-09 22:52:25.356225+00:00,"{""priceA"": 110, ""sharesA"": 1, ""secs_since_round_starts"": 182, ""market"": ""A""}",50.0,32.0,8.0,aqvtf4p9,vmu7c279,FULL STUDY,180.0,s3,1,110,110.0,-1,,1,sell,0,sell,0.4748947710808772,19,0,0,block 2 (G first),21.0,12.0,Male,1.0,0.0,0.0,"[3, 'block 2 (G first)']",1,0,0,0.5,1.0,-0.9,0.6666666666666666,0.21052631578947367,,0.0,4,1.0,0.5,Design 1,Design 1,"Have an option between Design #1 and Design #2,",5.0,5.0,5.0
905,4355,3,Player object (1067),sell,2023-03-09 22:53:03.146691+00:00,"{""priceA"": 115, ""sharesA"": 0, ""secs_since_round_starts"": 219, ""market"": ""A""}",165.0,39.0,9.0,aqvtf4p9,vmu7c279,FULL STUDY,180.0,s3,1,115,110.0,1,5.0,1,buy,0,sell,0.5221490272476892,19,0,0,block 2 (G first),21.0,12.0,Male,1.0,0.0,0.0,"[3, 'block 2 (G first)']",1,0,0,0.5,1.0,-0.9,0.6666666666666666,0.21052631578947367,,0.0,4,1.0,0.5,Design 1,Design 1,"Have an option between Design #1 and Design #2,",5.0,5.0,5.0
906,4356,3,Player object (1067),buy,2023-03-09 22:53:13.628507+00:00,"{""priceA"": 95, ""sharesA"": 1, ""secs_since_round_starts"": 230, ""market"": ""A""}",70.0,41.0,10.0,aqvtf4p9,vmu7c279,FULL STUDY,180.0,s3,1,95,115.0,-1,,1,sell,0,sell,0.4514823197003955,19,0,0,block 2 (G first),21.0,12.0,Male,1.0,0.0,0.0,"[3, 'block 2 (G first)']",1,0,0,0.5,1.0,-0.9,0.6666666666666666,0.21052631578947367,,0.0,4,1.0,0.5,Design 1,Design 1,"Have an option between Design #1 and Design #2,",5.0,5.0,5.0
907,4359,3,Player object (1067),sell,2023-03-09 22:53:26.732761+00:00,"{""priceA"": 105, ""sharesA"": 0, ""secs_since_round_starts"": 243, ""market"": ""A""}",175.0,42.0,11.0,aqvtf4p9,vmu7c279,FULL STUDY,180.0,s3,1,105,95.0,1,10.0,1,buy,0,sell,0.5010477910686952,19,0,0,block 2 (G first),21.0,12.0,Male,1.0,0.0,0.0,"[3, 'block 2 (G first)']",1,0,0,0.5,1.0,-0.9,0.6666666666666666,0.21052631578947367,,0.0,4,1.0,0.5,Design 1,Design 1,"Have an option between Design #1 and Design #2,",5.0,5.0,5.0
908,4362,3,Player object (1067),buy,2023-03-09 22:53:55.798179+00:00,"{""priceA"": 125, ""sharesA"": 1, ""secs_since_round_starts"": 272, ""market"": ""A""}",50.0,48.0,12.0,aqvtf4p9,vmu7c279,FULL STUDY,180.0,s3,1,125,105.0,-1,,1,sell,0,sell,0.4599698795591006,19,0,0,block 2 (G first),21.0,12.0,Male,1.0,0.0,0.0,"[3, 'block 2 (G first)']",1,0,0,0.5,1.0,-0.9,0.6666666666666666,0.21052631578947367,,0.0,4,1.0,0.5,Design 1,Design 1,"Have an option between Design #1 and Design #2,",5.0,5.0,5.0
909,4366,3,Player object (1067),sell,2023-03-09 22:54:29.991644+00:00,"{""priceA"": 145, ""sharesA"": 0, ""secs_since_round_starts"": 306, ""market"": ""A""}",195.0,54.0,13.0,aqvtf4p9,vmu7c279,FULL STUDY,180.0,s3,1,145,125.0,1,20.0,1,buy,0,sell,0.52846438705912,19,0,0,block 2 (G first),21.0,12.0,Male,1.0,0.0,0.0,"[3, 'block 2 (G first)']",1,0,0,0.5,1.0,-0.9,0.6666666666666666,0.21052631578947367,,0.0,4,1.0,0.5,Design 1,Design 1,"Have an option between Design #1 and Design #2,",5.0,5.0,5.0
910,4369,3,Player object (1067),buy,2023-03-09 22:54:47.083528+00:00,"{""priceA"": 130, ""sharesA"": 1, ""secs_since_round_starts"": 323, ""market"": ""A""}",65.0,57.0,14.0,aqvtf4p9,vmu7c279,FULL STUDY,180.0,s3,1,130,145.0,-1,,1,sell,0,sell,0.46726452652799,19,0,0,block 2 (G first),21.0,12.0,Male,1.0,0.0,0.0,"[3, 'block 2 (G first)']",1,0,0,0.5,1.0,-0.9,0.6666666666666666,0.21052631578947367,,0.0,4,1.0,0.5,Design 1,Design 1,"Have an option between Design #1 and Design #2,",5.0,5.0,5.0
911,4371,3,Player object (1067),sell,2023-03-09 22:55:01.971689+00:00,"{""priceA"": 115, ""sharesA"": 0, ""secs_since_round_starts"": 338, ""market"": ""A""}",180.0,60.0,15.0,aqvtf4p9,vmu7c279,FULL STUDY,180.0,s3,1,115,130.0,1,-15.0,1,buy,0,sell,0.4613046310449969,19,0,0,block 2 (G first),21.0,12.0,Male,1.0,0.0,0.0,"[3, 'block 2 (G first)']",1,0,0,0.5,1.0,-0.9,0.6666666666666666,0.21052631578947367,,0.0,4,1.0,0.5,Design 1,Design 1,"Have an option between Design #1 and Design #2,",5.0,5.0,5.0
912,4389,4,Player object (1187),sell,2023-03-09 22:57:52.096355+00:00,"{""priceA"": 90, ""sharesA"": 0, ""secs_since_round_starts"": 157, ""market"": ""A""}",140.0,29.0,1.0,aqvtf4p9,vmu7c279,FULL STUDY,105.0,s3,1,90,,1,,1,,0,sell,0.5712793841154561,14,0,0,block 2 (G first),21.0,12.0,Male,1.0,0.0,0.0,"[4, 'block 2 (G first)']",0,1,0,0.5,1.0,-0.9,0.0,0.045454545454545456,0.0,0.0,2,1.0,0.25,Design 1,Design 1,"Have an option between Design #1 and Design #2,",5.0,5.0,5.0
913,4392,4,Player object (1187),buy,2023-03-09 22:58:14.046339+00:00,"{""priceA"": 100, ""sharesA"": 1, ""secs_since_round_starts"": 179, ""market"": ""A""}",40.0,33.0,2.0,aqvtf4p9,vmu7c279,FULL STUDY,105.0,s3,1,100,90.0,-1,,1,sell,0,sell,0.5473882863317556,14,0,0,block 2 (G first),21.0,12.0,Male,1.0,0.0,0.0,"[4, 'block 2 (G first)']",0,1,0,0.5,1.0,-0.9,0.0,0.045454545454545456,0.0,0.0,2,1.0,0.25,Design 1,Design 1,"Have an option between Design #1 and Design #2,",5.0,5.0,5.0
914,4398,4,Player object (1187),sell,2023-03-09 22:59:04.663239+00:00,"{""priceA"": 95, ""sharesA"": 0, ""secs_since_round_starts"": 230, ""market"": ""A""}",135.0,42.0,3.0,aqvtf4p9,vmu7c279,FULL STUDY,105.0,s3,1,95,100.0,1,-5.0,1,buy,0,sell,0.5388552795609507,14,0,0,block 2 (G first),21.0,12.0,Male,1.0,0.0,0.0,"[4, 'block 2 (G first)']",0,1,0,0.5,1.0,-0.9,0.0,0.045454545454545456,0.0,0.0,2,1.0,0.25,Design 1,Design 1,"Have an option between Design #1 and Design #2,",5.0,5.0,5.0
915,4399,4,Player object (1187),buy,2023-03-09 22:59:11.290699+00:00,"{""priceA"": 100, ""sharesA"": 1, ""secs_since_round_starts"": 237, ""market"": ""A""}",35.0,43.0,4.0,aqvtf4p9,vmu7c279,FULL STUDY,105.0,s3,1,100,95.0,-1,,1,sell,0,sell,0.5617190733230237,14,0,1,block 2 (G first),21.0,12.0,Male,1.0,0.0,0.0,"[4, 'block 2 (G first)']",0,1,0,0.5,1.0,-0.9,0.0,0.045454545454545456,0.0,0.0,2,1.0,0.25,Design 1,Design 1,"Have an option between Design #1 and Design #2,",5.0,5.0,5.0
916,4400,4,Player object (1187),sell,2023-03-09 22:59:38.609530+00:00,"{""priceA"": 100, ""sharesA"": 0, ""secs_since_round_starts"": 264, ""market"": ""A""}",135.0,48.0,5.0,aqvtf4p9,vmu7c279,FULL STUDY,105.0,s3,1,100,100.0,1,0.0,1,buy,0,sell,0.500105737602651,14,0,0,block 2 (G first),21.0,12.0,Male,1.0,0.0,0.0,"[4, 'block 2 (G first)']",0,1,0,0.5,1.0,-0.9,0.0,0.045454545454545456,0.0,0.0,2,1.0,0.25,Design 1,Design 1,"Have an option between Design #1 and Design #2,",5.0,5.0,5.0
917,4401,4,Player object (1187),buy,2023-03-09 22:59:45.872060+00:00,"{""priceA"": 105, ""sharesA"": 1, ""secs_since_round_starts"": 271, ""market"": ""A""}",30.0,49.0,6.0,aqvtf4p9,vmu7c279,FULL STUDY,105.0,s3,1,105,100.0,-1,,1,sell,0,sell,0.5350732746090608,14,0,0,block 2 (G first),21.0,12.0,Male,1.0,0.0,0.0,"[4, 'block 2 (G first)']",0,1,0,0.5,1.0,-0.9,0.0,0.045454545454545456,0.0,0.0,2,1.0,0.25,Design 1,Design 1,"Have an option between Design #1 and Design #2,",5.0,5.0,5.0
918,4415,5,Player object (1307),sell,2023-03-09 23:01:23.947531+00:00,"{""priceA"": 100, ""sharesA"": 0, ""secs_since_round_starts"": 30, ""market"": ""A""}",150.0,7.0,1.0,aqvtf4p9,vmu7c279,FULL STUDY,155.0,s3,1,100,,1,,1,,0,sell,0.5733994727268583,17,0,0,block 2 (G first),21.0,12.0,Male,1.0,0.0,0.0,"[5, 'block 2 (G first)']",0,0,0,0.5,1.0,-0.9,0.8333333333333334,0.1111111111111111,1.0,0.0,1,0.75,0.25,Design 1,Design 1,"Have an option between Design #1 and Design #2,",5.0,5.0,5.0
919,4416,5,Player object (1307),buy,2023-03-09 23:01:29.812695+00:00,"{""priceA"": 90, ""sharesA"": 1, ""secs_since_round_starts"": 36, ""market"": ""A""}",60.0,8.0,2.0,aqvtf4p9,vmu7c279,FULL STUDY,155.0,s3,1,90,100.0,-1,,1,sell,0,sell,0.5166236645513725,17,0,0,block 2 (G first),21.0,12.0,Male,1.0,0.0,0.0,"[5, 'block 2 (G first)']",0,0,0,0.5,1.0,-0.9,0.8333333333333334,0.1111111111111111,1.0,0.0,1,0.75,0.25,Design 1,Design 1,"Have an option between Design #1 and Design #2,",5.0,5.0,5.0
920,4419,5,Player object (1307),sell,2023-03-09 23:01:50.099187+00:00,"{""priceA"": 100, ""sharesA"": 0, ""secs_since_round_starts"": 56, ""market"": ""A""}",160.0,12.0,3.0,aqvtf4p9,vmu7c279,FULL STUDY,155.0,s3,1,100,90.0,1,10.0,1,buy,0,sell,0.5344269279803172,17,0,0,block 2 (G first),21.0,12.0,Male,1.0,0.0,0.0,"[5, 'block 2 (G first)']",0,0,0,0.5,1.0,-0.9,0.8333333333333334,0.1111111111111111,1.0,0.0,1,0.75,0.25,Design 1,Design 1,"Have an option between Design #1 and Design #2,",5.0,5.0,5.0
921,4421,5,Player object (1307),buy,2023-03-09 23:02:07.438457+00:00,"{""priceA"": 90, ""sharesA"": 1, ""secs_since_round_starts"": 74, ""market"": ""A""}",70.0,15.0,4.0,aqvtf4p9,vmu7c279,FULL STUDY,155.0,s3,1,90,100.0,-1,,1,sell,0,sell,0.505231414156075,17,0,0,block 2 (G first),21.0,12.0,Male,1.0,0.0,0.0,"[5, 'block 2 (G first)']",0,0,0,0.5,1.0,-0.9,0.8333333333333334,0.1111111111111111,1.0,0.0,1,0.75,0.25,Design 1,Design 1,"Have an option between Design #1 and Design #2,",5.0,5.0,5.0
922,4424,5,Player object (1307),sell,2023-03-09 23:02:30.706380+00:00,"{""priceA"": 80, ""sharesA"": 0, ""secs_since_round_starts"": 97, ""market"": ""A""}",150.0,19.0,5.0,aqvtf4p9,vmu7c279,FULL STUDY,155.0,s3,1,80,90.0,1,-10.0,1,buy,0,sell,0.4830991506082083,17,0,0,block 2 (G first),21.0,12.0,Male,1.0,0.0,0.0,"[5, 'block 2 (G first)']",0,0,0,0.5,1.0,-0.9,0.8333333333333334,0.1111111111111111,1.0,0.0,1,0.75,0.25,Design 1,Design 1,"Have an option between Design #1 and Design #2,",5.0,5.0,5.0
923,4427,5,Player object (1307),buy,2023-03-09 23:02:46.734473+00:00,"{""priceA"": 90, ""sharesA"": 1, ""secs_since_round_starts"": 113, ""market"": ""A""}",60.0,22.0,6.0,aqvtf4p9,vmu7c279,FULL STUDY,155.0,s3,1,90,80.0,-1,,1,sell,0,sell,0.5007328859118227,17,0,0,block 2 (G first),21.0,12.0,Male,1.0,0.0,0.0,"[5, 'block 2 (G first)']",0,0,0,0.5,1.0,-0.9,0.8333333333333334,0.1111111111111111,1.0,0.0,1,0.75,0.25,Design 1,Design 1,"Have an option between Design #1 and Design #2,",5.0,5.0,5.0
924,4429,5,Player object (1307),sell,2023-03-09 23:02:59.848037+00:00,"{""priceA"": 105, ""sharesA"": 0, ""secs_since_round_starts"": 126, ""market"": ""A""}",165.0,24.0,7.0,aqvtf4p9,vmu7c279,FULL STUDY,155.0,s3,1,105,90.0,1,15.0,1,buy,0,sell,0.5594334008058068,17,0,0,block 2 (G first),21.0,12.0,Male,1.0,0.0,0.0,"[5, 'block 2 (G first)']",0,0,0,0.5,1.0,-0.9,0.8333333333333334,0.1111111111111111,1.0,0.0,1,0.75,0.25,Design 1,Design 1,"Have an option between Design #1 and Design #2,",5.0,5.0,5.0
925,4430,5,Player object (1307),buy,2023-03-09 23:03:12.545561+00:00,"{""priceA"": 100, ""sharesA"": 1, ""secs_since_round_starts"": 139, ""market"": ""A""}",65.0,27.0,8.0,aqvtf4p9,vmu7c279,FULL STUDY,155.0,s3,1,100,105.0,-1,,1,sell,0,sell,0.4777068930880888,17,0,0,block 2 (G first),21.0,12.0,Male,1.0,0.0,0.0,"[5, 'block 2 (G first)']",0,0,0,0.5,1.0,-0.9,0.8333333333333334,0.1111111111111111,1.0,0.0,1,0.75,0.25,Design 1,Design 1,"Have an option between Design #1 and Design #2,",5.0,5.0,5.0
926,4435,5,Player object (1307),sell,2023-03-09 23:03:54.640028+00:00,"{""priceA"": 110, ""sharesA"": 0, ""secs_since_round_starts"": 181, ""market"": ""A""}",175.0,33.0,9.0,aqvtf4p9,vmu7c279,FULL STUDY,155.0,s3,1,110,100.0,1,10.0,1,buy,0,sell,0.5480287979668599,17,0,1,block 2 (G first),21.0,12.0,Male,1.0,0.0,0.0,"[5, 'block 2 (G first)']",0,0,0,0.5,1.0,-0.9,0.8333333333333334,0.1111111111111111,1.0,0.0,1,0.75,0.25,Design 1,Design 1,"Have an option between Design #1 and Design #2,",5.0,5.0,5.0
927,4438,5,Player object (1307),buy,2023-03-09 23:04:10.647772+00:00,"{""priceA"": 110, ""sharesA"": 1, ""secs_since_round_starts"": 197, ""market"": ""A""}",65.0,36.0,10.0,aqvtf4p9,vmu7c279,FULL STUDY,155.0,s3,1,110,110.0,-1,,1,sell,0,sell,0.5223936301876935,17,0,0,block 2 (G first),21.0,12.0,Male,1.0,0.0,0.0,"[5, 'block 2 (G first)']",0,0,0,0.5,1.0,-0.9,0.8333333333333334,0.1111111111111111,1.0,0.0,1,0.75,0.25,Design 1,Design 1,"Have an option between Design #1 and Design #2,",5.0,5.0,5.0
928,4441,5,Player object (1307),sell,2023-03-09 23:04:37.902942+00:00,"{""priceA"": 95, ""sharesA"": 0, ""secs_since_round_starts"": 224, ""market"": ""A""}",160.0,41.0,11.0,aqvtf4p9,vmu7c279,FULL STUDY,155.0,s3,1,95,110.0,1,-15.0,1,buy,0,sell,0.5260161398462472,17,0,0,block 2 (G first),21.0,12.0,Male,1.0,0.0,0.0,"[5, 'block 2 (G first)']",0,0,0,0.5,1.0,-0.9,0.8333333333333334,0.1111111111111111,1.0,0.0,1,0.75,0.25,Design 1,Design 1,"Have an option between Design #1 and Design #2,",5.0,5.0,5.0
929,4442,5,Player object (1307),buy,2023-03-09 23:05:04.516074+00:00,"{""priceA"": 95, ""sharesA"": 1, ""secs_since_round_starts"": 251, ""market"": ""A""}",65.0,46.0,12.0,aqvtf4p9,vmu7c279,FULL STUDY,155.0,s3,1,95,95.0,-1,,1,sell,0,sell,0.4967862103563366,17,0,0,block 2 (G first),21.0,12.0,Male,1.0,0.0,0.0,"[5, 'block 2 (G first)']",0,0,0,0.5,1.0,-0.9,0.8333333333333334,0.1111111111111111,1.0,0.0,1,0.75,0.25,Design 1,Design 1,"Have an option between Design #1 and Design #2,",5.0,5.0,5.0
930,4444,5,Player object (1307),sell,2023-03-09 23:05:33.466536+00:00,"{""priceA"": 85, ""sharesA"": 0, ""secs_since_round_starts"": 280, ""market"": ""A""}",150.0,51.0,13.0,aqvtf4p9,vmu7c279,FULL STUDY,155.0,s3,1,85,95.0,1,-10.0,1,buy,0,sell,0.5069151322589074,17,0,0,block 2 (G first),21.0,12.0,Male,1.0,0.0,0.0,"[5, 'block 2 (G first)']",0,0,0,0.5,1.0,-0.9,0.8333333333333334,0.1111111111111111,1.0,0.0,1,0.75,0.25,Design 1,Design 1,"Have an option between Design #1 and Design #2,",5.0,5.0,5.0
931,4446,5,Player object (1307),buy,2023-03-09 23:05:44.717883+00:00,"{""priceA"": 85, ""sharesA"": 1, ""secs_since_round_starts"": 291, ""market"": ""A""}",65.0,53.0,14.0,aqvtf4p9,vmu7c279,FULL STUDY,155.0,s3,1,85,85.0,-1,,1,sell,0,sell,0.4927925471404216,17,0,0,block 2 (G first),21.0,12.0,Male,1.0,0.0,0.0,"[5, 'block 2 (G first)']",0,0,0,0.5,1.0,-0.9,0.8333333333333334,0.1111111111111111,1.0,0.0,1,0.75,0.25,Design 1,Design 1,"Have an option between Design #1 and Design #2,",5.0,5.0,5.0
932,4448,5,Player object (1307),sell,2023-03-09 23:05:48.850672+00:00,"{""priceA"": 95, ""sharesA"": 0, ""secs_since_round_starts"": 295, ""market"": ""A""}",160.0,54.0,15.0,aqvtf4p9,vmu7c279,FULL STUDY,155.0,s3,1,95,85.0,1,10.0,1,buy,0,sell,0.5299980248683189,17,0,0,block 2 (G first),21.0,12.0,Male,1.0,0.0,0.0,"[5, 'block 2 (G first)']",0,0,0,0.5,1.0,-0.9,0.8333333333333334,0.1111111111111111,1.0,0.0,1,0.75,0.25,Design 1,Design 1,"Have an option between Design #1 and Design #2,",5.0,5.0,5.0
933,4449,5,Player object (1307),buy,2023-03-09 23:05:54.439361+00:00,"{""priceA"": 80, ""sharesA"": 1, ""secs_since_round_starts"": 301, ""market"": ""A""}",80.0,55.0,16.0,aqvtf4p9,vmu7c279,FULL STUDY,155.0,s3,1,80,95.0,-1,,1,sell,0,sell,0.4859141076178286,17,0,0,block 2 (G first),21.0,12.0,Male,1.0,0.0,0.0,"[5, 'block 2 (G first)']",0,0,0,0.5,1.0,-0.9,0.8333333333333334,0.1111111111111111,1.0,0.0,1,0.75,0.25,Design 1,Design 1,"Have an option between Design #1 and Design #2,",5.0,5.0,5.0
934,4450,5,Player object (1307),sell,2023-03-09 23:05:59.762412+00:00,"{""priceA"": 95, ""sharesA"": 0, ""secs_since_round_starts"": 306, ""market"": ""A""}",175.0,56.0,17.0,aqvtf4p9,vmu7c279,FULL STUDY,155.0,s3,1,95,80.0,1,15.0,1,buy,0,sell,0.5252108989343294,17,0,0,block 2 (G first),21.0,12.0,Male,1.0,0.0,0.0,"[5, 'block 2 (G first)']",0,0,0,0.5,1.0,-0.9,0.8333333333333334,0.1111111111111111,1.0,0.0,1,0.75,0.25,Design 1,Design 1,"Have an option between Design #1 and Design #2,",5.0,5.0,5.0
935,4451,5,Player object (1307),buy,2023-03-09 23:06:05.521055+00:00,"{""priceA"": 85, ""sharesA"": 1, ""secs_since_round_starts"": 312, ""market"": ""A""}",90.0,57.0,18.0,aqvtf4p9,vmu7c279,FULL STUDY,155.0,s3,1,85,95.0,-1,,1,sell,0,sell,0.4825596920859898,17,0,0,block 2 (G first),21.0,12.0,Male,1.0,0.0,0.0,"[5, 'block 2 (G first)']",0,0,0,0.5,1.0,-0.9,0.8333333333333334,0.1111111111111111,1.0,0.0,1,0.75,0.25,Design 1,Design 1,"Have an option between Design #1 and Design #2,",5.0,5.0,5.0
936,4589,2,Player object (954),sell,2023-03-10 02:19:22.574743+00:00,"{""priceA"": 110, ""sharesA"": 0, ""secs_since_round_starts"": 42, ""market"": ""A""}",160.0,6.0,1.0,b8u4u74w,vmu7c279,FULL STUDY,170.0,s4,1,110,,1,,1,,0,sell,0.5,0,0,0,block 3 (G second),21.0,11.0,Male,1.0,0.0,0.0,"[2, 'block 3 (G second)']",0,0,1,0.0,7.0,-0.21666666666666667,0.5,0.0,,0.0,4,0.75,0.5,Design 1,Design 1,Only trade on Design #1,1.0,,
937,4590,2,Player object (954),buy,2023-03-10 02:19:25.232814+00:00,"{""priceA"": 100, ""sharesA"": 1, ""secs_since_round_starts"": 45, ""market"": ""A""}",60.0,7.0,2.0,b8u4u74w,vmu7c279,FULL STUDY,170.0,s4,1,100,110.0,-1,,1,sell,0,sell,0.5,0,0,0,block 3 (G second),21.0,11.0,Male,1.0,0.0,0.0,"[2, 'block 3 (G second)']",0,0,1,0.0,7.0,-0.21666666666666667,0.5,0.0,,0.0,4,0.75,0.5,Design 1,Design 1,Only trade on Design #1,1.0,,
938,4591,2,Player object (954),sell,2023-03-10 02:19:54.517749+00:00,"{""priceA"": 100, ""sharesA"": 0, ""secs_since_round_starts"": 74, ""market"": ""A""}",160.0,12.0,3.0,b8u4u74w,vmu7c279,FULL STUDY,170.0,s4,1,100,100.0,1,0.0,1,buy,0,sell,0.5,0,0,0,block 3 (G second),21.0,11.0,Male,1.0,0.0,0.0,"[2, 'block 3 (G second)']",0,0,1,0.0,7.0,-0.21666666666666667,0.5,0.0,,0.0,4,0.75,0.5,Design 1,Design 1,Only trade on Design #1,1.0,,
939,4592,2,Player object (954),buy,2023-03-10 02:20:01.503031+00:00,"{""priceA"": 85, ""sharesA"": 1, ""secs_since_round_starts"": 81, ""market"": ""A""}",75.0,13.0,4.0,b8u4u74w,vmu7c279,FULL STUDY,170.0,s4,1,85,100.0,-1,,1,sell,0,sell,0.5,0,0,0,block 3 (G second),21.0,11.0,Male,1.0,0.0,0.0,"[2, 'block 3 (G second)']",0,0,1,0.0,7.0,-0.21666666666666667,0.5,0.0,,0.0,4,0.75,0.5,Design 1,Design 1,Only trade on Design #1,1.0,,
940,4593,2,Player object (954),sell,2023-03-10 02:20:37.383175+00:00,"{""priceA"": 85, ""sharesA"": 0, ""secs_since_round_starts"": 117, ""market"": ""A""}",160.0,20.0,5.0,b8u4u74w,vmu7c279,FULL STUDY,170.0,s4,1,85,85.0,1,0.0,1,buy,0,sell,0.5,0,0,0,block 3 (G second),21.0,11.0,Male,1.0,0.0,0.0,"[2, 'block 3 (G second)']",0,0,1,0.0,7.0,-0.21666666666666667,0.5,0.0,,0.0,4,0.75,0.5,Design 1,Design 1,Only trade on Design #1,1.0,,
941,4594,2,Player object (954),buy,2023-03-10 02:21:04.679590+00:00,"{""priceA"": 70, ""sharesA"": 1, ""secs_since_round_starts"": 144, ""market"": ""A""}",90.0,25.0,6.0,b8u4u74w,vmu7c279,FULL STUDY,170.0,s4,1,70,85.0,-1,,1,sell,0,sell,0.5,0,0,0,block 3 (G second),21.0,11.0,Male,1.0,0.0,0.0,"[2, 'block 3 (G second)']",0,0,1,0.0,7.0,-0.21666666666666667,0.5,0.0,,0.0,4,0.75,0.5,Design 1,Design 1,Only trade on Design #1,1.0,,
942,4595,2,Player object (954),sell,2023-03-10 02:21:11.366314+00:00,"{""priceA"": 80, ""sharesA"": 0, ""secs_since_round_starts"": 151, ""market"": ""A""}",170.0,26.0,7.0,b8u4u74w,vmu7c279,FULL STUDY,170.0,s4,1,80,70.0,1,10.0,1,buy,0,sell,0.5,0,0,0,block 3 (G second),21.0,11.0,Male,1.0,0.0,0.0,"[2, 'block 3 (G second)']",0,0,1,0.0,7.0,-0.21666666666666667,0.5,0.0,,0.0,4,0.75,0.5,Design 1,Design 1,Only trade on Design #1,1.0,,
943,4597,2,Player object (954),buy,2023-03-10 02:22:00.451155+00:00,"{""priceA"": 75, ""sharesA"": 1, ""secs_since_round_starts"": 200, ""market"": ""A""}",95.0,34.0,8.0,b8u4u74w,vmu7c279,FULL STUDY,170.0,s4,1,75,80.0,-1,,1,sell,0,sell,0.5,0,1,0,block 3 (G second),21.0,11.0,Male,1.0,0.0,0.0,"[2, 'block 3 (G second)']",0,0,1,0.0,7.0,-0.21666666666666667,0.5,0.0,,0.0,4,0.75,0.5,Design 1,Design 1,Only trade on Design #1,1.0,,
944,4598,2,Player object (954),sell,2023-03-10 02:23:35.524094+00:00,"{""priceA"": 75, ""sharesA"": 0, ""secs_since_round_starts"": 295, ""market"": ""A""}",170.0,51.0,9.0,b8u4u74w,vmu7c279,FULL STUDY,170.0,s4,1,75,75.0,1,0.0,1,buy,0,sell,0.5,0,0,0,block 3 (G second),21.0,11.0,Male,1.0,0.0,0.0,"[2, 'block 3 (G second)']",0,0,1,0.0,7.0,-0.21666666666666667,0.5,0.0,,0.0,4,0.75,0.5,Design 1,Design 1,Only trade on Design #1,1.0,,
945,4602,3,Player object (1074),sell,2023-03-10 02:25:04.292377+00:00,"{""priceA"": 105, ""sharesA"": 0, ""secs_since_round_starts"": 34, ""market"": ""A""}",155.0,7.0,1.0,b8u4u74w,vmu7c279,FULL STUDY,205.0,s4,1,105,,1,,1,,0,sell,0.5,0,0,0,block 3 (G second),21.0,11.0,Male,1.0,0.0,0.0,"[3, 'block 3 (G second)']",0,1,1,0.0,7.0,-0.21666666666666667,0.23076923076923078,0.0,0.3333333333333333,0.0,4,0.75,0.75,Design 1,Design 1,Only trade on Design #1,1.0,,
946,4603,3,Player object (1074),buy,2023-03-10 02:26:20.464686+00:00,"{""priceA"": 130, ""sharesA"": 1, ""secs_since_round_starts"": 110, ""market"": ""A""}",25.0,21.0,2.0,b8u4u74w,vmu7c279,FULL STUDY,205.0,s4,1,130,105.0,-1,,1,sell,0,sell,0.5,0,1,0,block 3 (G second),21.0,11.0,Male,1.0,0.0,0.0,"[3, 'block 3 (G second)']",0,1,1,0.0,7.0,-0.21666666666666667,0.23076923076923078,0.0,0.3333333333333333,0.0,4,0.75,0.75,Design 1,Design 1,Only trade on Design #1,1.0,,
947,4604,3,Player object (1074),sell,2023-03-10 02:26:43.126672+00:00,"{""priceA"": 155, ""sharesA"": 0, ""secs_since_round_starts"": 132, ""market"": ""A""}",180.0,25.0,3.0,b8u4u74w,vmu7c279,FULL STUDY,205.0,s4,1,155,130.0,1,25.0,1,buy,0,sell,0.5,0,0,1,block 3 (G second),21.0,11.0,Male,1.0,0.0,0.0,"[3, 'block 3 (G second)']",0,1,1,0.0,7.0,-0.21666666666666667,0.23076923076923078,0.0,0.3333333333333333,0.0,4,0.75,0.75,Design 1,Design 1,Only trade on Design #1,1.0,,
948,4606,3,Player object (1074),buy,2023-03-10 02:27:26.977947+00:00,"{""priceA"": 140, ""sharesA"": 1, ""secs_since_round_starts"": 176, ""market"": ""A""}",40.0,33.0,4.0,b8u4u74w,vmu7c279,FULL STUDY,205.0,s4,1,140,155.0,-1,,1,sell,0,sell,0.5,0,1,0,block 3 (G second),21.0,11.0,Male,1.0,0.0,0.0,"[3, 'block 3 (G second)']",0,1,1,0.0,7.0,-0.21666666666666667,0.23076923076923078,0.0,0.3333333333333333,0.0,4,0.75,0.75,Design 1,Design 1,Only trade on Design #1,1.0,,
949,4607,3,Player object (1074),sell,2023-03-10 02:28:52.912984+00:00,"{""priceA"": 165, ""sharesA"": 0, ""secs_since_round_starts"": 262, ""market"": ""A""}",205.0,49.0,5.0,b8u4u74w,vmu7c279,FULL STUDY,205.0,s4,1,165,140.0,1,25.0,1,buy,0,sell,0.5,0,0,0,block 3 (G second),21.0,11.0,Male,1.0,0.0,0.0,"[3, 'block 3 (G second)']",0,1,1,0.0,7.0,-0.21666666666666667,0.23076923076923078,0.0,0.3333333333333333,0.0,4,0.75,0.75,Design 1,Design 1,Only trade on Design #1,1.0,,
950,4612,4,Player object (1194),sell,2023-03-10 02:33:21.480227+00:00,"{""priceA"": 85, ""sharesA"": 0, ""secs_since_round_starts"": 202, ""market"": ""A""}",135.0,37.0,1.0,b8u4u74w,vmu7c279,FULL STUDY,135.0,s4,1,85,,1,,1,,0,sell,0.5,0,0,0,block 3 (G second),21.0,11.0,Male,1.0,0.0,0.0,"[4, 'block 3 (G second)']",1,0,1,0.0,7.0,-0.21666666666666667,0.0,0.045454545454545456,0.0,0.0,2,0.75,0.75,Design 1,Design 1,Only trade on Design #1,1.0,,
951,4616,5,Player object (1314),sell,2023-03-10 02:36:25.405919+00:00,"{""priceA"": 120, ""sharesA"": 0, ""secs_since_round_starts"": 46, ""market"": ""A""}",170.0,9.0,1.0,b8u4u74w,vmu7c279,FULL STUDY,190.0,s4,1,120,,1,,1,,0,sell,0.5,0,0,0,block 3 (G second),21.0,11.0,Male,1.0,0.0,0.0,"[5, 'block 3 (G second)']",1,1,1,0.5,7.0,-0.21666666666666667,0.21428571428571427,0.0,0.0,0.0,4,0.75,0.5,Design 1,Design 1,Only trade on Design #1,1.0,,
952,4617,5,Player object (1314),buy,2023-03-10 02:37:07.571391+00:00,"{""priceA"": 125, ""sharesA"": 1, ""secs_since_round_starts"": 88, ""market"": ""A""}",45.0,17.0,2.0,b8u4u74w,vmu7c279,FULL STUDY,190.0,s4,1,125,120.0,-1,,1,sell,0,sell,0.5,0,0,0,block 3 (G second),21.0,11.0,Male,1.0,0.0,0.0,"[5, 'block 3 (G second)']",1,1,1,0.5,7.0,-0.21666666666666667,0.21428571428571427,0.0,0.0,0.0,4,0.75,0.5,Design 1,Design 1,Only trade on Design #1,1.0,,
953,4618,5,Player object (1314),sell,2023-03-10 02:37:40.740389+00:00,"{""priceA"": 150, ""sharesA"": 0, ""secs_since_round_starts"": 121, ""market"": ""A""}",195.0,23.0,3.0,b8u4u74w,vmu7c279,FULL STUDY,190.0,s4,1,150,125.0,1,25.0,1,buy,0,sell,0.5,0,0,0,block 3 (G second),21.0,11.0,Male,1.0,0.0,0.0,"[5, 'block 3 (G second)']",1,1,1,0.5,7.0,-0.21666666666666667,0.21428571428571427,0.0,0.0,0.0,4,0.75,0.5,Design 1,Design 1,Only trade on Design #1,1.0,,
954,4619,5,Player object (1314),buy,2023-03-10 02:38:17.865995+00:00,"{""priceA"": 125, ""sharesA"": 1, ""secs_since_round_starts"": 158, ""market"": ""A""}",70.0,30.0,4.0,b8u4u74w,vmu7c279,FULL STUDY,190.0,s4,1,125,150.0,-1,,1,sell,0,sell,0.5,0,1,0,block 3 (G second),21.0,11.0,Male,1.0,0.0,0.0,"[5, 'block 3 (G second)']",1,1,1,0.5,7.0,-0.21666666666666667,0.21428571428571427,0.0,0.0,0.0,4,0.75,0.5,Design 1,Design 1,Only trade on Design #1,1.0,,
955,4624,5,Player object (1314),sell,2023-03-10 02:38:50.589060+00:00,"{""priceA"": 140, ""sharesA"": 0, ""secs_since_round_starts"": 191, ""market"": ""A""}",210.0,36.0,5.0,b8u4u74w,vmu7c279,FULL STUDY,190.0,s4,1,140,125.0,1,15.0,1,buy,0,sell,0.5,0,0,0,block 3 (G second),21.0,11.0,Male,1.0,0.0,0.0,"[5, 'block 3 (G second)']",1,1,1,0.5,7.0,-0.21666666666666667,0.21428571428571427,0.0,0.0,0.0,4,0.75,0.5,Design 1,Design 1,Only trade on Design #1,1.0,,
956,4628,5,Player object (1314),buy,2023-03-10 02:39:28.074736+00:00,"{""priceA"": 115, ""sharesA"": 1, ""secs_since_round_starts"": 228, ""market"": ""A""}",95.0,43.0,6.0,b8u4u74w,vmu7c279,FULL STUDY,190.0,s4,1,115,140.0,-1,,1,sell,0,sell,0.5,0,0,0,block 3 (G second),21.0,11.0,Male,1.0,0.0,0.0,"[5, 'block 3 (G second)']",1,1,1,0.5,7.0,-0.21666666666666667,0.21428571428571427,0.0,0.0,0.0,4,0.75,0.5,Design 1,Design 1,Only trade on Design #1,1.0,,
957,3592,2,Player object (935),sell,2023-03-09 05:10:38.038672+00:00,"{""priceA"": 110, ""sharesA"": 0, ""secs_since_round_starts"": 118, ""market"": ""A""}",160.0,17.0,1.0,bgjp13q8,vmu7c279,FULL STUDY,190.0,s3,1,110,,1,,1,,0,sell,0.5478276073026133,16,0,0,block 4 (G second),20.0,11.0,Female,1.0,0.0,0.0,"[2, 'block 4 (G second)']",0,1,1,0.5,6.0,-0.31666666666666665,0.09090909090909091,0.0,0.3333333333333333,0.0,5,0.75,0.75,Design 2,Design 2,"Have an option between Design #1 and Design #2,",5.0,4.0,4.0
958,3595,2,Player object (935),buy,2023-03-09 05:11:48.517764+00:00,"{""priceA"": 125, ""sharesA"": 1, ""secs_since_round_starts"": 189, ""market"": ""A""}",35.0,30.0,2.0,bgjp13q8,vmu7c279,FULL STUDY,190.0,s3,1,125,110.0,-1,,1,sell,0,sell,0.4785999259850118,16,0,0,block 4 (G second),20.0,11.0,Female,1.0,0.0,0.0,"[2, 'block 4 (G second)']",0,1,1,0.5,6.0,-0.31666666666666665,0.09090909090909091,0.0,0.3333333333333333,0.0,5,0.75,0.75,Design 2,Design 2,"Have an option between Design #1 and Design #2,",5.0,4.0,4.0
959,3597,2,Player object (935),sell,2023-03-09 05:13:25.995284+00:00,"{""priceA"": 155, ""sharesA"": 0, ""secs_since_round_starts"": 286, ""market"": ""A""}",190.0,46.0,3.0,bgjp13q8,vmu7c279,FULL STUDY,190.0,s3,1,155,125.0,1,30.0,1,buy,0,sell,0.5495494947508355,16,0,1,block 4 (G second),20.0,11.0,Female,1.0,0.0,0.0,"[2, 'block 4 (G second)']",0,1,1,0.5,6.0,-0.31666666666666665,0.09090909090909091,0.0,0.3333333333333333,0.0,5,0.75,0.75,Design 2,Design 2,"Have an option between Design #1 and Design #2,",5.0,4.0,4.0
960,3600,2,Player object (935),buy,2023-03-09 05:13:58.862690+00:00,"{""priceA"": 125, ""sharesA"": 1, ""secs_since_round_starts"": 319, ""market"": ""A""}",65.0,52.0,4.0,bgjp13q8,vmu7c279,FULL STUDY,190.0,s3,1,125,155.0,-1,,1,sell,0,sell,0.4439176376077041,16,1,0,block 4 (G second),20.0,11.0,Female,1.0,0.0,0.0,"[2, 'block 4 (G second)']",0,1,1,0.5,6.0,-0.31666666666666665,0.09090909090909091,0.0,0.3333333333333333,0.0,5,0.75,0.75,Design 2,Design 2,"Have an option between Design #1 and Design #2,",5.0,4.0,4.0
961,3608,3,Player object (1055),sell,2023-03-09 05:16:46.160512+00:00,"{""priceA"": 110, ""sharesA"": 0, ""secs_since_round_starts"": 114, ""market"": ""A""}",160.0,11.0,1.0,bgjp13q8,vmu7c279,FULL STUDY,195.0,s3,1,110,,1,,1,,0,sell,0.5295922419004607,19,0,0,block 4 (G second),20.0,11.0,Female,1.0,0.0,0.0,"[3, 'block 4 (G second)']",0,0,1,0.5,6.0,-0.31666666666666665,0.09523809523809523,0.0,0.3333333333333333,0.0,4,1.0,0.5,Design 2,Design 2,"Have an option between Design #1 and Design #2,",5.0,4.0,4.0
962,3609,3,Player object (1055),buy,2023-03-09 05:17:13.731850+00:00,"{""priceA"": 100, ""sharesA"": 1, ""secs_since_round_starts"": 142, ""market"": ""A""}",60.0,16.0,2.0,bgjp13q8,vmu7c279,FULL STUDY,195.0,s3,1,100,110.0,-1,,1,sell,0,sell,0.4486815727575955,19,1,0,block 4 (G second),20.0,11.0,Female,1.0,0.0,0.0,"[3, 'block 4 (G second)']",0,0,1,0.5,6.0,-0.31666666666666665,0.09523809523809523,0.0,0.3333333333333333,0.0,4,1.0,0.5,Design 2,Design 2,"Have an option between Design #1 and Design #2,",5.0,4.0,4.0
963,3616,3,Player object (1055),sell,2023-03-09 05:19:50.040811+00:00,"{""priceA"": 135, ""sharesA"": 0, ""secs_since_round_starts"": 298, ""market"": ""A""}",195.0,44.0,3.0,bgjp13q8,vmu7c279,FULL STUDY,195.0,s3,1,135,100.0,1,35.0,1,buy,0,sell,0.5595824488336746,19,0,1,block 4 (G second),20.0,11.0,Female,1.0,0.0,0.0,"[3, 'block 4 (G second)']",0,0,1,0.5,6.0,-0.31666666666666665,0.09523809523809523,0.0,0.3333333333333333,0.0,4,1.0,0.5,Design 2,Design 2,"Have an option between Design #1 and Design #2,",5.0,4.0,4.0
964,3649,5,Player object (1295),sell,2023-03-09 05:32:48.085862+00:00,"{""priceA"": 100, ""sharesA"": 0, ""secs_since_round_starts"": 60, ""market"": ""A""}",150.0,12.0,1.0,bgjp13q8,vmu7c279,FULL STUDY,220.0,s3,1,100,,1,,1,,0,sell,0.5344269279803172,17,0,0,block 4 (G second),20.0,11.0,Female,1.0,0.0,0.0,"[5, 'block 4 (G second)']",1,0,1,0.5,6.0,-0.31666666666666665,0.2,0.0,0.6666666666666666,0.0,4,0.5,0.75,Design 2,Design 2,"Have an option between Design #1 and Design #2,",5.0,4.0,4.0
965,3650,5,Player object (1295),buy,2023-03-09 05:33:17.002546+00:00,"{""priceA"": 80, ""sharesA"": 1, ""secs_since_round_starts"": 89, ""market"": ""A""}",70.0,17.0,2.0,bgjp13q8,vmu7c279,FULL STUDY,220.0,s3,1,80,100.0,-1,,1,sell,0,sell,0.4433955626702647,17,0,0,block 4 (G second),20.0,11.0,Female,1.0,0.0,0.0,"[5, 'block 4 (G second)']",1,0,1,0.5,6.0,-0.31666666666666665,0.2,0.0,0.6666666666666666,0.0,4,0.5,0.75,Design 2,Design 2,"Have an option between Design #1 and Design #2,",5.0,4.0,4.0
966,3652,5,Player object (1295),sell,2023-03-09 05:33:38.938681+00:00,"{""priceA"": 105, ""sharesA"": 0, ""secs_since_round_starts"": 111, ""market"": ""A""}",175.0,21.0,3.0,bgjp13q8,vmu7c279,FULL STUDY,220.0,s3,1,105,80.0,1,25.0,1,buy,0,sell,0.5510362930796925,17,0,1,block 4 (G second),20.0,11.0,Female,1.0,0.0,0.0,"[5, 'block 4 (G second)']",1,0,1,0.5,6.0,-0.31666666666666665,0.2,0.0,0.6666666666666666,0.0,4,0.5,0.75,Design 2,Design 2,"Have an option between Design #1 and Design #2,",5.0,4.0,4.0
967,3653,5,Player object (1295),buy,2023-03-09 05:34:16.405259+00:00,"{""priceA"": 85, ""sharesA"": 1, ""secs_since_round_starts"": 149, ""market"": ""A""}",90.0,28.0,4.0,bgjp13q8,vmu7c279,FULL STUDY,220.0,s3,1,85,105.0,-1,,1,sell,0,sell,0.4496194529460131,17,1,0,block 4 (G second),20.0,11.0,Female,1.0,0.0,0.0,"[5, 'block 4 (G second)']",1,0,1,0.5,6.0,-0.31666666666666665,0.2,0.0,0.6666666666666666,0.0,4,0.5,0.75,Design 2,Design 2,"Have an option between Design #1 and Design #2,",5.0,4.0,4.0
968,3656,5,Player object (1295),sell,2023-03-09 05:34:48.441700+00:00,"{""priceA"": 110, ""sharesA"": 0, ""secs_since_round_starts"": 181, ""market"": ""A""}",200.0,33.0,5.0,bgjp13q8,vmu7c279,FULL STUDY,220.0,s3,1,110,85.0,1,25.0,1,buy,0,sell,0.5480287979668599,17,0,1,block 4 (G second),20.0,11.0,Female,1.0,0.0,0.0,"[5, 'block 4 (G second)']",1,0,1,0.5,6.0,-0.31666666666666665,0.2,0.0,0.6666666666666666,0.0,4,0.5,0.75,Design 2,Design 2,"Have an option between Design #1 and Design #2,",5.0,4.0,4.0
969,3657,5,Player object (1295),buy,2023-03-09 05:35:12.381366+00:00,"{""priceA"": 80, ""sharesA"": 1, ""secs_since_round_starts"": 205, ""market"": ""A""}",120.0,38.0,6.0,bgjp13q8,vmu7c279,FULL STUDY,220.0,s3,1,80,110.0,-1,,1,sell,0,sell,0.4515999245786187,17,1,0,block 4 (G second),20.0,11.0,Female,1.0,0.0,0.0,"[5, 'block 4 (G second)']",1,0,1,0.5,6.0,-0.31666666666666665,0.2,0.0,0.6666666666666666,0.0,4,0.5,0.75,Design 2,Design 2,"Have an option between Design #1 and Design #2,",5.0,4.0,4.0
970,3658,5,Player object (1295),sell,2023-03-09 05:35:40.173753+00:00,"{""priceA"": 110, ""sharesA"": 0, ""secs_since_round_starts"": 232, ""market"": ""A""}",230.0,43.0,7.0,bgjp13q8,vmu7c279,FULL STUDY,220.0,s3,1,110,80.0,1,30.0,1,buy,0,sell,0.571300234525265,17,0,0,block 4 (G second),20.0,11.0,Female,1.0,0.0,0.0,"[5, 'block 4 (G second)']",1,0,1,0.5,6.0,-0.31666666666666665,0.2,0.0,0.6666666666666666,0.0,4,0.5,0.75,Design 2,Design 2,"Have an option between Design #1 and Design #2,",5.0,4.0,4.0
971,3659,5,Player object (1295),buy,2023-03-09 05:36:07.062112+00:00,"{""priceA"": 75, ""sharesA"": 1, ""secs_since_round_starts"": 259, ""market"": ""A""}",155.0,48.0,8.0,bgjp13q8,vmu7c279,FULL STUDY,220.0,s3,1,75,110.0,-1,,1,sell,0,sell,0.4393932183506925,17,1,0,block 4 (G second),20.0,11.0,Female,1.0,0.0,0.0,"[5, 'block 4 (G second)']",1,0,1,0.5,6.0,-0.31666666666666665,0.2,0.0,0.6666666666666666,0.0,4,0.5,0.75,Design 2,Design 2,"Have an option between Design #1 and Design #2,",5.0,4.0,4.0
972,2053,2,Player object (904),sell,2023-03-08 03:45:12.805018+00:00,"{""priceA"": 105, ""sharesA"": 0, ""secs_since_round_starts"": 89, ""market"": ""A""}",155.0,16.0,1.0,bi2jfx42,vmu7c279,FULL STUDY,230.0,s2,1,105,,1,,1,,0,sell,0.5185790363913291,16,0,0,block 3 (G second),21.0,12.0,Male,1.0,1.0,1.0,"[2, 'block 3 (G second)']",0,0,1,0.5,5.0,-0.5,0.2777777777777778,0.0,0.4,0.0,4,1.0,0.5,Design 1,Design 1,"Have an option between Design #1 and Design #2,",4.0,,
973,2054,2,Player object (904),buy,2023-03-08 03:45:41.025791+00:00,"{""priceA"": 130, ""sharesA"": 1, ""secs_since_round_starts"": 118, ""market"": ""A""}",25.0,21.0,2.0,bi2jfx42,vmu7c279,FULL STUDY,230.0,s2,1,130,105.0,-1,,1,sell,0,sell,0.5504042050217014,16,0,0,block 3 (G second),21.0,12.0,Male,1.0,1.0,1.0,"[2, 'block 3 (G second)']",0,0,1,0.5,5.0,-0.5,0.2777777777777778,0.0,0.4,0.0,4,1.0,0.5,Design 1,Design 1,"Have an option between Design #1 and Design #2,",4.0,,
974,2055,2,Player object (904),sell,2023-03-08 03:45:54.392933+00:00,"{""priceA"": 150, ""sharesA"": 0, ""secs_since_round_starts"": 131, ""market"": ""A""}",175.0,23.0,3.0,bi2jfx42,vmu7c279,FULL STUDY,230.0,s2,1,150,130.0,1,20.0,1,buy,0,sell,0.5825581483921976,16,0,1,block 3 (G second),21.0,12.0,Male,1.0,1.0,1.0,"[2, 'block 3 (G second)']",0,0,1,0.5,5.0,-0.5,0.2777777777777778,0.0,0.4,0.0,4,1.0,0.5,Design 1,Design 1,"Have an option between Design #1 and Design #2,",4.0,,
975,2056,2,Player object (904),buy,2023-03-08 03:46:16.190246+00:00,"{""priceA"": 125, ""sharesA"": 1, ""secs_since_round_starts"": 153, ""market"": ""A""}",50.0,27.0,4.0,bi2jfx42,vmu7c279,FULL STUDY,230.0,s2,1,125,150.0,-1,,1,sell,0,sell,0.4549942201992644,16,1,0,block 3 (G second),21.0,12.0,Male,1.0,1.0,1.0,"[2, 'block 3 (G second)']",0,0,1,0.5,5.0,-0.5,0.2777777777777778,0.0,0.4,0.0,4,1.0,0.5,Design 1,Design 1,"Have an option between Design #1 and Design #2,",4.0,,
976,2058,2,Player object (904),sell,2023-03-08 03:47:07.759294+00:00,"{""priceA"": 140, ""sharesA"": 0, ""secs_since_round_starts"": 204, ""market"": ""A""}",190.0,35.0,5.0,bi2jfx42,vmu7c279,FULL STUDY,230.0,s2,1,140,125.0,1,15.0,1,buy,0,sell,0.5101876173062244,16,0,0,block 3 (G second),21.0,12.0,Male,1.0,1.0,1.0,"[2, 'block 3 (G second)']",0,0,1,0.5,5.0,-0.5,0.2777777777777778,0.0,0.4,0.0,4,1.0,0.5,Design 1,Design 1,"Have an option between Design #1 and Design #2,",4.0,,
977,2059,2,Player object (904),buy,2023-03-08 03:47:39.380088+00:00,"{""priceA"": 135, ""sharesA"": 1, ""secs_since_round_starts"": 236, ""market"": ""A""}",55.0,41.0,6.0,bi2jfx42,vmu7c279,FULL STUDY,230.0,s2,1,135,140.0,-1,,1,sell,0,sell,0.4592429496222846,16,0,0,block 3 (G second),21.0,12.0,Male,1.0,1.0,1.0,"[2, 'block 3 (G second)']",0,0,1,0.5,5.0,-0.5,0.2777777777777778,0.0,0.4,0.0,4,1.0,0.5,Design 1,Design 1,"Have an option between Design #1 and Design #2,",4.0,,
978,2060,2,Player object (904),sell,2023-03-08 03:48:07.535310+00:00,"{""priceA"": 155, ""sharesA"": 0, ""secs_since_round_starts"": 264, ""market"": ""A""}",210.0,46.0,7.0,bi2jfx42,vmu7c279,FULL STUDY,230.0,s2,1,155,135.0,1,20.0,1,buy,0,sell,0.5495494947508355,16,0,1,block 3 (G second),21.0,12.0,Male,1.0,1.0,1.0,"[2, 'block 3 (G second)']",0,0,1,0.5,5.0,-0.5,0.2777777777777778,0.0,0.4,0.0,4,1.0,0.5,Design 1,Design 1,"Have an option between Design #1 and Design #2,",4.0,,
979,2061,2,Player object (904),buy,2023-03-08 03:48:39.916800+00:00,"{""priceA"": 125, ""sharesA"": 1, ""secs_since_round_starts"": 297, ""market"": ""A""}",85.0,52.0,8.0,bi2jfx42,vmu7c279,FULL STUDY,230.0,s2,1,125,155.0,-1,,1,sell,0,sell,0.4439176376077041,16,1,0,block 3 (G second),21.0,12.0,Male,1.0,1.0,1.0,"[2, 'block 3 (G second)']",0,0,1,0.5,5.0,-0.5,0.2777777777777778,0.0,0.4,0.0,4,1.0,0.5,Design 1,Design 1,"Have an option between Design #1 and Design #2,",4.0,,
980,2062,2,Player object (904),sell,2023-03-08 03:48:58.801334+00:00,"{""priceA"": 135, ""sharesA"": 0, ""secs_since_round_starts"": 315, ""market"": ""A""}",220.0,55.0,9.0,bi2jfx42,vmu7c279,FULL STUDY,230.0,s2,1,135,125.0,1,10.0,1,buy,0,sell,0.4873282494519479,16,0,0,block 3 (G second),21.0,12.0,Male,1.0,1.0,1.0,"[2, 'block 3 (G second)']",0,0,1,0.5,5.0,-0.5,0.2777777777777778,0.0,0.4,0.0,4,1.0,0.5,Design 1,Design 1,"Have an option between Design #1 and Design #2,",4.0,,
981,2063,2,Player object (904),buy,2023-03-08 03:49:14.126003+00:00,"{""priceA"": 115, ""sharesA"": 1, ""secs_since_round_starts"": 331, ""market"": ""A""}",105.0,58.0,10.0,bi2jfx42,vmu7c279,FULL STUDY,230.0,s2,1,115,135.0,-1,,1,sell,0,sell,0.4893175166503174,16,0,0,block 3 (G second),21.0,12.0,Male,1.0,1.0,1.0,"[2, 'block 3 (G second)']",0,0,1,0.5,5.0,-0.5,0.2777777777777778,0.0,0.4,0.0,4,1.0,0.5,Design 1,Design 1,"Have an option between Design #1 and Design #2,",4.0,,
982,2067,3,Player object (1024),sell,2023-03-08 03:50:38.516457+00:00,"{""priceA"": 120, ""sharesA"": 0, ""secs_since_round_starts"": 67, ""market"": ""A""}",170.0,12.0,1.0,bi2jfx42,vmu7c279,FULL STUDY,215.0,s2,1,120,,1,,1,,0,sell,0.5553867656170776,19,0,0,block 3 (G second),21.0,12.0,Male,1.0,1.0,1.0,"[3, 'block 3 (G second)']",0,1,1,0.5,5.0,-0.5,0.4166666666666667,0.0,0.0,0.0,2,0.5,0.5,Design 1,Design 1,"Have an option between Design #1 and Design #2,",4.0,,
983,2068,3,Player object (1024),buy,2023-03-08 03:51:01.699262+00:00,"{""priceA"": 105, ""sharesA"": 1, ""secs_since_round_starts"": 90, ""market"": ""A""}",65.0,17.0,2.0,bi2jfx42,vmu7c279,FULL STUDY,215.0,s2,1,105,120.0,-1,,1,sell,0,sell,0.4990675303551922,19,0,0,block 3 (G second),21.0,12.0,Male,1.0,1.0,1.0,"[3, 'block 3 (G second)']",0,1,1,0.5,5.0,-0.5,0.4166666666666667,0.0,0.0,0.0,2,0.5,0.5,Design 1,Design 1,"Have an option between Design #1 and Design #2,",4.0,,
984,2069,3,Player object (1024),sell,2023-03-08 03:51:20.182444+00:00,"{""priceA"": 115, ""sharesA"": 0, ""secs_since_round_starts"": 109, ""market"": ""A""}",180.0,20.0,3.0,bi2jfx42,vmu7c279,FULL STUDY,215.0,s2,1,115,105.0,1,10.0,1,buy,0,sell,0.5061230669509241,19,0,0,block 3 (G second),21.0,12.0,Male,1.0,1.0,1.0,"[3, 'block 3 (G second)']",0,1,1,0.5,5.0,-0.5,0.4166666666666667,0.0,0.0,0.0,2,0.5,0.5,Design 1,Design 1,"Have an option between Design #1 and Design #2,",4.0,,
985,2070,3,Player object (1024),buy,2023-03-08 03:51:34.825058+00:00,"{""priceA"": 100, ""sharesA"": 1, ""secs_since_round_starts"": 123, ""market"": ""A""}",80.0,23.0,4.0,bi2jfx42,vmu7c279,FULL STUDY,215.0,s2,1,100,115.0,-1,,1,sell,0,sell,0.4956244642879559,19,0,0,block 3 (G second),21.0,12.0,Male,1.0,1.0,1.0,"[3, 'block 3 (G second)']",0,1,1,0.5,5.0,-0.5,0.4166666666666667,0.0,0.0,0.0,2,0.5,0.5,Design 1,Design 1,"Have an option between Design #1 and Design #2,",4.0,,
986,2071,3,Player object (1024),sell,2023-03-08 03:51:45.940618+00:00,"{""priceA"": 110, ""sharesA"": 0, ""secs_since_round_starts"": 135, ""market"": ""A""}",190.0,25.0,5.0,bi2jfx42,vmu7c279,FULL STUDY,215.0,s2,1,110,100.0,1,10.0,1,buy,0,sell,0.4872943409941583,19,0,0,block 3 (G second),21.0,12.0,Male,1.0,1.0,1.0,"[3, 'block 3 (G second)']",0,1,1,0.5,5.0,-0.5,0.4166666666666667,0.0,0.0,0.0,2,0.5,0.5,Design 1,Design 1,"Have an option between Design #1 and Design #2,",4.0,,
987,2073,3,Player object (1024),buy,2023-03-08 03:52:38.918983+00:00,"{""priceA"": 110, ""sharesA"": 1, ""secs_since_round_starts"": 188, ""market"": ""A""}",80.0,34.0,6.0,bi2jfx42,vmu7c279,FULL STUDY,215.0,s2,1,110,110.0,-1,,1,sell,0,sell,0.4983651933170437,19,0,0,block 3 (G second),21.0,12.0,Male,1.0,1.0,1.0,"[3, 'block 3 (G second)']",0,1,1,0.5,5.0,-0.5,0.4166666666666667,0.0,0.0,0.0,2,0.5,0.5,Design 1,Design 1,"Have an option between Design #1 and Design #2,",4.0,,
988,2074,3,Player object (1024),sell,2023-03-08 03:53:27.839443+00:00,"{""priceA"": 120, ""sharesA"": 0, ""secs_since_round_starts"": 236, ""market"": ""A""}",200.0,43.0,7.0,bi2jfx42,vmu7c279,FULL STUDY,215.0,s2,1,120,110.0,1,10.0,1,buy,0,sell,0.5357259670782416,19,0,0,block 3 (G second),21.0,12.0,Male,1.0,1.0,1.0,"[3, 'block 3 (G second)']",0,1,1,0.5,5.0,-0.5,0.4166666666666667,0.0,0.0,0.0,2,0.5,0.5,Design 1,Design 1,"Have an option between Design #1 and Design #2,",4.0,,
989,2075,3,Player object (1024),buy,2023-03-08 03:54:22.139547+00:00,"{""priceA"": 130, ""sharesA"": 1, ""secs_since_round_starts"": 291, ""market"": ""A""}",70.0,53.0,8.0,bi2jfx42,vmu7c279,FULL STUDY,215.0,s2,1,130,120.0,-1,,1,sell,0,sell,0.4905868559773416,19,0,0,block 3 (G second),21.0,12.0,Male,1.0,1.0,1.0,"[3, 'block 3 (G second)']",0,1,1,0.5,5.0,-0.5,0.4166666666666667,0.0,0.0,0.0,2,0.5,0.5,Design 1,Design 1,"Have an option between Design #1 and Design #2,",4.0,,
990,2076,3,Player object (1024),sell,2023-03-08 03:54:31.681955+00:00,"{""priceA"": 145, ""sharesA"": 0, ""secs_since_round_starts"": 300, ""market"": ""A""}",215.0,54.0,9.0,bi2jfx42,vmu7c279,FULL STUDY,215.0,s2,1,145,130.0,1,15.0,1,buy,0,sell,0.52846438705912,19,0,0,block 3 (G second),21.0,12.0,Male,1.0,1.0,1.0,"[3, 'block 3 (G second)']",0,1,1,0.5,5.0,-0.5,0.4166666666666667,0.0,0.0,0.0,2,0.5,0.5,Design 1,Design 1,"Have an option between Design #1 and Design #2,",4.0,,
991,2077,3,Player object (1024),buy,2023-03-08 03:54:51.844594+00:00,"{""priceA"": 115, ""sharesA"": 1, ""secs_since_round_starts"": 320, ""market"": ""A""}",100.0,58.0,10.0,bi2jfx42,vmu7c279,FULL STUDY,215.0,s2,1,115,145.0,-1,,1,sell,0,sell,0.442461876115205,19,1,0,block 3 (G second),21.0,12.0,Male,1.0,1.0,1.0,"[3, 'block 3 (G second)']",0,1,1,0.5,5.0,-0.5,0.4166666666666667,0.0,0.0,0.0,2,0.5,0.5,Design 1,Design 1,"Have an option between Design #1 and Design #2,",4.0,,
992,2081,4,Player object (1144),sell,2023-03-08 03:56:04.644110+00:00,"{""priceA"": 80, ""sharesA"": 0, ""secs_since_round_starts"": 57, ""market"": ""A""}",130.0,10.0,1.0,bi2jfx42,vmu7c279,FULL STUDY,185.0,s2,1,80,,1,,1,,0,sell,0.5652817482669988,14,0,0,block 3 (G second),21.0,12.0,Male,1.0,1.0,1.0,"[4, 'block 3 (G second)']",1,0,1,0.0,5.0,-0.5,0.23076923076923078,0.13333333333333333,0.3333333333333333,0.25,2,1.0,0.5,Design 1,Design 1,"Have an option between Design #1 and Design #2,",4.0,,
993,2082,4,Player object (1144),buy,2023-03-08 03:56:48.616717+00:00,"{""priceA"": 70, ""sharesA"": 1, ""secs_since_round_starts"": 101, ""market"": ""A""}",60.0,18.0,2.0,bi2jfx42,vmu7c279,FULL STUDY,185.0,s2,1,70,80.0,-1,,1,sell,0,sell,0.4407118028401492,14,1,0,block 3 (G second),21.0,12.0,Male,1.0,1.0,1.0,"[4, 'block 3 (G second)']",1,0,1,0.0,5.0,-0.5,0.23076923076923078,0.13333333333333333,0.3333333333333333,0.25,2,1.0,0.5,Design 1,Design 1,"Have an option between Design #1 and Design #2,",4.0,,
994,2083,4,Player object (1144),sell,2023-03-08 03:57:09.051644+00:00,"{""priceA"": 55, ""sharesA"": 0, ""secs_since_round_starts"": 121, ""market"": ""A""}",115.0,22.0,3.0,bi2jfx42,vmu7c279,FULL STUDY,185.0,s2,1,55,70.0,1,-15.0,1,buy,0,sell,0.4224279859932807,14,1,0,block 3 (G second),21.0,12.0,Male,1.0,1.0,1.0,"[4, 'block 3 (G second)']",1,0,1,0.0,5.0,-0.5,0.23076923076923078,0.13333333333333333,0.3333333333333333,0.25,2,1.0,0.5,Design 1,Design 1,"Have an option between Design #1 and Design #2,",4.0,,
995,2084,4,Player object (1144),buy,2023-03-08 03:57:21.383067+00:00,"{""priceA"": 55, ""sharesA"": 1, ""secs_since_round_starts"": 134, ""market"": ""A""}",60.0,24.0,4.0,bi2jfx42,vmu7c279,FULL STUDY,185.0,s2,1,55,55.0,-1,,1,sell,0,sell,0.4514670992379582,14,0,0,block 3 (G second),21.0,12.0,Male,1.0,1.0,1.0,"[4, 'block 3 (G second)']",1,0,1,0.0,5.0,-0.5,0.23076923076923078,0.13333333333333333,0.3333333333333333,0.25,2,1.0,0.5,Design 1,Design 1,"Have an option between Design #1 and Design #2,",4.0,,
996,2085,4,Player object (1144),sell,2023-03-08 03:57:48.854845+00:00,"{""priceA"": 90, ""sharesA"": 0, ""secs_since_round_starts"": 161, ""market"": ""A""}",150.0,29.0,5.0,bi2jfx42,vmu7c279,FULL STUDY,185.0,s2,1,90,55.0,1,35.0,1,buy,0,sell,0.5712793841154561,14,0,0,block 3 (G second),21.0,12.0,Male,1.0,1.0,1.0,"[4, 'block 3 (G second)']",1,0,1,0.0,5.0,-0.5,0.23076923076923078,0.13333333333333333,0.3333333333333333,0.25,2,1.0,0.5,Design 1,Design 1,"Have an option between Design #1 and Design #2,",4.0,,
997,2087,4,Player object (1144),buy,2023-03-08 03:58:38.586587+00:00,"{""priceA"": 70, ""sharesA"": 1, ""secs_since_round_starts"": 211, ""market"": ""A""}",80.0,37.0,6.0,bi2jfx42,vmu7c279,FULL STUDY,185.0,s2,1,70,90.0,-1,,1,sell,0,sell,0.4570673777008929,14,0,0,block 3 (G second),21.0,12.0,Male,1.0,1.0,1.0,"[4, 'block 3 (G second)']",1,0,1,0.0,5.0,-0.5,0.23076923076923078,0.13333333333333333,0.3333333333333333,0.25,2,1.0,0.5,Design 1,Design 1,"Have an option between Design #1 and Design #2,",4.0,,
998,2088,4,Player object (1144),sell,2023-03-08 03:59:06.746426+00:00,"{""priceA"": 100, ""sharesA"": 0, ""secs_since_round_starts"": 239, ""market"": ""A""}",180.0,43.0,7.0,bi2jfx42,vmu7c279,FULL STUDY,185.0,s2,1,100,70.0,1,30.0,1,buy,0,sell,0.5617190733230237,14,0,1,block 3 (G second),21.0,12.0,Male,1.0,1.0,1.0,"[4, 'block 3 (G second)']",1,0,1,0.0,5.0,-0.5,0.23076923076923078,0.13333333333333333,0.3333333333333333,0.25,2,1.0,0.5,Design 1,Design 1,"Have an option between Design #1 and Design #2,",4.0,,
999,2089,4,Player object (1144),buy,2023-03-08 03:59:37.322320+00:00,"{""priceA"": 100, ""sharesA"": 1, ""secs_since_round_starts"": 270, ""market"": ""A""}",80.0,48.0,8.0,bi2jfx42,vmu7c279,FULL STUDY,185.0,s2,1,100,100.0,-1,,1,sell,0,sell,0.500105737602651,14,0,0,block 3 (G second),21.0,12.0,Male,1.0,1.0,1.0,"[4, 'block 3 (G second)']",1,0,1,0.0,5.0,-0.5,0.23076923076923078,0.13333333333333333,0.3333333333333333,0.25,2,1.0,0.5,Design 1,Design 1,"Have an option between Design #1 and Design #2,",4.0,,
1000,2090,4,Player object (1144),sell,2023-03-08 03:59:50.905022+00:00,"{""priceA"": 105, ""sharesA"": 0, ""secs_since_round_starts"": 283, ""market"": ""A""}",185.0,51.0,9.0,bi2jfx42,vmu7c279,FULL STUDY,185.0,s2,1,105,100.0,1,5.0,1,buy,0,sell,0.5064720763559888,14,0,0,block 3 (G second),21.0,12.0,Male,1.0,1.0,1.0,"[4, 'block 3 (G second)']",1,0,1,0.0,5.0,-0.5,0.23076923076923078,0.13333333333333333,0.3333333333333333,0.25,2,1.0,0.5,Design 1,Design 1,"Have an option between Design #1 and Design #2,",4.0,,
1001,2091,4,Player object (1144),buy,2023-03-08 04:00:07.119395+00:00,"{""priceA"": 75, ""sharesA"": 1, ""secs_since_round_starts"": 299, ""market"": ""A""}",110.0,53.0,10.0,bi2jfx42,vmu7c279,FULL STUDY,185.0,s2,1,75,105.0,-1,,1,sell,0,sell,0.4439854633835125,14,1,0,block 3 (G second),21.0,12.0,Male,1.0,1.0,1.0,"[4, 'block 3 (G second)']",1,0,1,0.0,5.0,-0.5,0.23076923076923078,0.13333333333333333,0.3333333333333333,0.25,2,1.0,0.5,Design 1,Design 1,"Have an option between Design #1 and Design #2,",4.0,,
1002,2092,4,Player object (1144),sell,2023-03-08 04:00:45.266542+00:00,"{""priceA"": 75, ""sharesA"": 0, ""secs_since_round_starts"": 337, ""market"": ""A""}",185.0,60.0,11.0,bi2jfx42,vmu7c279,FULL STUDY,185.0,s2,1,75,75.0,1,0.0,1,buy,0,sell,0.5499940505093152,14,0,1,block 3 (G second),21.0,12.0,Male,1.0,1.0,1.0,"[4, 'block 3 (G second)']",1,0,1,0.0,5.0,-0.5,0.23076923076923078,0.13333333333333333,0.3333333333333333,0.25,2,1.0,0.5,Design 1,Design 1,"Have an option between Design #1 and Design #2,",4.0,,
1003,2096,5,Player object (1264),sell,2023-03-08 04:01:16.930891+00:00,"{""priceA"": 95, ""sharesA"": 0, ""secs_since_round_starts"": 28, ""market"": ""A""}",145.0,6.0,1.0,bi2jfx42,vmu7c279,FULL STUDY,235.0,s2,1,95,,1,,1,,0,sell,0.5560314405213382,17,0,1,block 3 (G second),21.0,12.0,Male,1.0,1.0,1.0,"[5, 'block 3 (G second)']",1,1,1,0.0,5.0,-0.5,0.4166666666666667,0.1111111111111111,1.0,0.3333333333333333,4,0.5,0.5,Design 1,Design 1,"Have an option between Design #1 and Design #2,",4.0,,
1004,2097,5,Player object (1264),buy,2023-03-08 04:01:37.532643+00:00,"{""priceA"": 75, ""sharesA"": 1, ""secs_since_round_starts"": 49, ""market"": ""A""}",70.0,10.0,2.0,bi2jfx42,vmu7c279,FULL STUDY,235.0,s2,1,75,95.0,-1,,1,sell,0,sell,0.4488309348307913,17,1,0,block 3 (G second),21.0,12.0,Male,1.0,1.0,1.0,"[5, 'block 3 (G second)']",1,1,1,0.0,5.0,-0.5,0.4166666666666667,0.1111111111111111,1.0,0.3333333333333333,4,0.5,0.5,Design 1,Design 1,"Have an option between Design #1 and Design #2,",4.0,,
1005,2098,5,Player object (1264),sell,2023-03-08 04:01:51.876750+00:00,"{""priceA"": 100, ""sharesA"": 0, ""secs_since_round_starts"": 63, ""market"": ""A""}",170.0,12.0,3.0,bi2jfx42,vmu7c279,FULL STUDY,235.0,s2,1,100,75.0,1,25.0,1,buy,0,sell,0.5344269279803172,17,0,0,block 3 (G second),21.0,12.0,Male,1.0,1.0,1.0,"[5, 'block 3 (G second)']",1,1,1,0.0,5.0,-0.5,0.4166666666666667,0.1111111111111111,1.0,0.3333333333333333,4,0.5,0.5,Design 1,Design 1,"Have an option between Design #1 and Design #2,",4.0,,
1006,2099,5,Player object (1264),buy,2023-03-08 04:02:02.732671+00:00,"{""priceA"": 80, ""sharesA"": 1, ""secs_since_round_starts"": 74, ""market"": ""A""}",90.0,14.0,4.0,bi2jfx42,vmu7c279,FULL STUDY,235.0,s2,1,80,100.0,-1,,1,sell,0,sell,0.457409789643144,17,0,0,block 3 (G second),21.0,12.0,Male,1.0,1.0,1.0,"[5, 'block 3 (G second)']",1,1,1,0.0,5.0,-0.5,0.4166666666666667,0.1111111111111111,1.0,0.3333333333333333,4,0.5,0.5,Design 1,Design 1,"Have an option between Design #1 and Design #2,",4.0,,
1007,2100,5,Player object (1264),sell,2023-03-08 04:02:32.456950+00:00,"{""priceA"": 95, ""sharesA"": 0, ""secs_since_round_starts"": 104, ""market"": ""A""}",185.0,20.0,5.0,bi2jfx42,vmu7c279,FULL STUDY,235.0,s2,1,95,80.0,1,15.0,1,buy,0,sell,0.5232479875730728,17,0,0,block 3 (G second),21.0,12.0,Male,1.0,1.0,1.0,"[5, 'block 3 (G second)']",1,1,1,0.0,5.0,-0.5,0.4166666666666667,0.1111111111111111,1.0,0.3333333333333333,4,0.5,0.5,Design 1,Design 1,"Have an option between Design #1 and Design #2,",4.0,,
1008,2101,5,Player object (1264),buy,2023-03-08 04:03:25.066222+00:00,"{""priceA"": 80, ""sharesA"": 1, ""secs_since_round_starts"": 156, ""market"": ""A""}",105.0,29.0,6.0,bi2jfx42,vmu7c279,FULL STUDY,235.0,s2,1,80,95.0,-1,,1,sell,0,sell,0.4304345659865384,17,0,0,block 3 (G second),21.0,12.0,Male,1.0,1.0,1.0,"[5, 'block 3 (G second)']",1,1,1,0.0,5.0,-0.5,0.4166666666666667,0.1111111111111111,1.0,0.3333333333333333,4,0.5,0.5,Design 1,Design 1,"Have an option between Design #1 and Design #2,",4.0,,
1009,2103,5,Player object (1264),sell,2023-03-08 04:03:44.578605+00:00,"{""priceA"": 110, ""sharesA"": 0, ""secs_since_round_starts"": 176, ""market"": ""A""}",215.0,33.0,7.0,bi2jfx42,vmu7c279,FULL STUDY,235.0,s2,1,110,80.0,1,30.0,1,buy,0,sell,0.5480287979668599,17,0,1,block 3 (G second),21.0,12.0,Male,1.0,1.0,1.0,"[5, 'block 3 (G second)']",1,1,1,0.0,5.0,-0.5,0.4166666666666667,0.1111111111111111,1.0,0.3333333333333333,4,0.5,0.5,Design 1,Design 1,"Have an option between Design #1 and Design #2,",4.0,,
1010,2104,5,Player object (1264),buy,2023-03-08 04:04:08.560616+00:00,"{""priceA"": 95, ""sharesA"": 1, ""secs_since_round_starts"": 200, ""market"": ""A""}",120.0,37.0,8.0,bi2jfx42,vmu7c279,FULL STUDY,235.0,s2,1,95,110.0,-1,,1,sell,0,sell,0.4805886028013266,17,0,0,block 3 (G second),21.0,12.0,Male,1.0,1.0,1.0,"[5, 'block 3 (G second)']",1,1,1,0.0,5.0,-0.5,0.4166666666666667,0.1111111111111111,1.0,0.3333333333333333,4,0.5,0.5,Design 1,Design 1,"Have an option between Design #1 and Design #2,",4.0,,
1011,2105,5,Player object (1264),sell,2023-03-08 04:04:35.325036+00:00,"{""priceA"": 100, ""sharesA"": 0, ""secs_since_round_starts"": 226, ""market"": ""A""}",220.0,42.0,9.0,bi2jfx42,vmu7c279,FULL STUDY,235.0,s2,1,100,95.0,1,5.0,1,buy,0,sell,0.5529358605422235,17,0,1,block 3 (G second),21.0,12.0,Male,1.0,1.0,1.0,"[5, 'block 3 (G second)']",1,1,1,0.0,5.0,-0.5,0.4166666666666667,0.1111111111111111,1.0,0.3333333333333333,4,0.5,0.5,Design 1,Design 1,"Have an option between Design #1 and Design #2,",4.0,,
1012,2106,5,Player object (1264),buy,2023-03-08 04:05:08.845453+00:00,"{""priceA"": 75, ""sharesA"": 1, ""secs_since_round_starts"": 260, ""market"": ""A""}",145.0,48.0,10.0,bi2jfx42,vmu7c279,FULL STUDY,235.0,s2,1,75,100.0,-1,,1,sell,0,sell,0.4393932183506925,17,1,0,block 3 (G second),21.0,12.0,Male,1.0,1.0,1.0,"[5, 'block 3 (G second)']",1,1,1,0.0,5.0,-0.5,0.4166666666666667,0.1111111111111111,1.0,0.3333333333333333,4,0.5,0.5,Design 1,Design 1,"Have an option between Design #1 and Design #2,",4.0,,
1013,2107,5,Player object (1264),sell,2023-03-08 04:05:31.008565+00:00,"{""priceA"": 95, ""sharesA"": 0, ""secs_since_round_starts"": 282, ""market"": ""A""}",240.0,52.0,11.0,bi2jfx42,vmu7c279,FULL STUDY,235.0,s2,1,95,75.0,1,20.0,1,buy,0,sell,0.5397855680881701,17,0,0,block 3 (G second),21.0,12.0,Male,1.0,1.0,1.0,"[5, 'block 3 (G second)']",1,1,1,0.0,5.0,-0.5,0.4166666666666667,0.1111111111111111,1.0,0.3333333333333333,4,0.5,0.5,Design 1,Design 1,"Have an option between Design #1 and Design #2,",4.0,,
1014,2111,5,Player object (1264),buy,2023-03-08 04:06:09.490414+00:00,"{""priceA"": 70, ""sharesA"": 1, ""secs_since_round_starts"": 321, ""market"": ""A""}",170.0,59.0,12.0,bi2jfx42,vmu7c279,FULL STUDY,235.0,s2,1,70,95.0,-1,,1,sell,0,sell,0.4327023062729965,17,1,0,block 3 (G second),21.0,12.0,Male,1.0,1.0,1.0,"[5, 'block 3 (G second)']",1,1,1,0.0,5.0,-0.5,0.4166666666666667,0.1111111111111111,1.0,0.3333333333333333,4,0.5,0.5,Design 1,Design 1,"Have an option between Design #1 and Design #2,",4.0,,
1015,1829,2,Player object (892),sell,2023-03-07 18:41:41.934852+00:00,"{""priceA"": 100, ""sharesA"": 0, ""secs_since_round_starts"": 46, ""market"": ""A""}",150.0,7.0,1.0,bi5jp617,vmu7c279,FULL STUDY,190.0,s2,1,100,,1,,1,,0,sell,0.4669924949471701,16,0,0,block 1 (G first),20.0,12.0,Female,1.0,1.0,0.0,"[2, 'block 1 (G first)']",1,0,0,0.5,7.0,-0.30000000000000004,0.2222222222222222,0.1,0.5,0.0,2,0.5,0.75,Design 2,Design 2,"Have an option between Design #1 and Design #2,",5.0,,
1016,1830,2,Player object (892),buy,2023-03-07 18:41:43.493531+00:00,"{""priceA"": 85, ""sharesA"": 1, ""secs_since_round_starts"": 47, ""market"": ""A""}",65.0,8.0,2.0,bi5jp617,vmu7c279,FULL STUDY,190.0,s2,1,85,100.0,-1,,1,sell,0,sell,0.4422758127435268,16,1,0,block 1 (G first),20.0,12.0,Female,1.0,1.0,0.0,"[2, 'block 1 (G first)']",1,0,0,0.5,7.0,-0.30000000000000004,0.2222222222222222,0.1,0.5,0.0,2,0.5,0.75,Design 2,Design 2,"Have an option between Design #1 and Design #2,",5.0,,
1017,1831,2,Player object (892),sell,2023-03-07 18:42:06.548404+00:00,"{""priceA"": 80, ""sharesA"": 0, ""secs_since_round_starts"": 70, ""market"": ""A""}",145.0,12.0,3.0,bi5jp617,vmu7c279,FULL STUDY,190.0,s2,1,80,85.0,1,-5.0,1,buy,0,sell,0.502087716794639,16,0,0,block 1 (G first),20.0,12.0,Female,1.0,1.0,0.0,"[2, 'block 1 (G first)']",1,0,0,0.5,7.0,-0.30000000000000004,0.2222222222222222,0.1,0.5,0.0,2,0.5,0.75,Design 2,Design 2,"Have an option between Design #1 and Design #2,",5.0,,
1018,1832,2,Player object (892),buy,2023-03-07 18:43:29.396443+00:00,"{""priceA"": 125, ""sharesA"": 1, ""secs_since_round_starts"": 153, ""market"": ""A""}",20.0,27.0,4.0,bi5jp617,vmu7c279,FULL STUDY,190.0,s2,1,125,80.0,-1,,1,sell,0,sell,0.4549942201992644,16,1,0,block 1 (G first),20.0,12.0,Female,1.0,1.0,0.0,"[2, 'block 1 (G first)']",1,0,0,0.5,7.0,-0.30000000000000004,0.2222222222222222,0.1,0.5,0.0,2,0.5,0.75,Design 2,Design 2,"Have an option between Design #1 and Design #2,",5.0,,
1019,1834,2,Player object (892),sell,2023-03-07 18:51:14.406336+00:00,"{""priceA"": 150, ""sharesA"": 0, ""secs_since_round_starts"": 618, ""market"": ""A""}",170.0,36.0,5.0,bi5jp617,vmu7c279,FULL STUDY,190.0,s2,1,150,125.0,1,25.0,1,buy,0,sell,0.542045663089369,16,0,0,block 1 (G first),20.0,12.0,Female,1.0,1.0,0.0,"[2, 'block 1 (G first)']",1,0,0,0.5,7.0,-0.30000000000000004,0.2222222222222222,0.1,0.5,0.0,2,0.5,0.75,Design 2,Design 2,"Have an option between Design #1 and Design #2,",5.0,,
1020,1835,2,Player object (892),buy,2023-03-07 18:51:23.783015+00:00,"{""priceA"": 140, ""sharesA"": 1, ""secs_since_round_starts"": 628, ""market"": ""A""}",30.0,38.0,6.0,bi5jp617,vmu7c279,FULL STUDY,190.0,s2,1,140,150.0,-1,,1,sell,0,sell,0.4611129934091434,16,0,0,block 1 (G first),20.0,12.0,Female,1.0,1.0,0.0,"[2, 'block 1 (G first)']",1,0,0,0.5,7.0,-0.30000000000000004,0.2222222222222222,0.1,0.5,0.0,2,0.5,0.75,Design 2,Design 2,"Have an option between Design #1 and Design #2,",5.0,,
1021,1836,2,Player object (892),sell,2023-03-07 18:51:34.927850+00:00,"{""priceA"": 140, ""sharesA"": 0, ""secs_since_round_starts"": 639, ""market"": ""A""}",170.0,40.0,7.0,bi5jp617,vmu7c279,FULL STUDY,190.0,s2,1,140,140.0,1,0.0,1,buy,0,sell,0.4916787423410894,16,0,0,block 1 (G first),20.0,12.0,Female,1.0,1.0,0.0,"[2, 'block 1 (G first)']",1,0,0,0.5,7.0,-0.30000000000000004,0.2222222222222222,0.1,0.5,0.0,2,0.5,0.75,Design 2,Design 2,"Have an option between Design #1 and Design #2,",5.0,,
1022,1837,2,Player object (892),buy,2023-03-07 18:51:39.383652+00:00,"{""priceA"": 135, ""sharesA"": 1, ""secs_since_round_starts"": 643, ""market"": ""A""}",35.0,41.0,8.0,bi5jp617,vmu7c279,FULL STUDY,190.0,s2,1,135,140.0,-1,,1,sell,0,sell,0.4592429496222846,16,0,0,block 1 (G first),20.0,12.0,Female,1.0,1.0,0.0,"[2, 'block 1 (G first)']",1,0,0,0.5,7.0,-0.30000000000000004,0.2222222222222222,0.1,0.5,0.0,2,0.5,0.75,Design 2,Design 2,"Have an option between Design #1 and Design #2,",5.0,,
1023,1838,2,Player object (892),sell,2023-03-07 18:52:06.161648+00:00,"{""priceA"": 155, ""sharesA"": 0, ""secs_since_round_starts"": 670, ""market"": ""A""}",190.0,46.0,9.0,bi5jp617,vmu7c279,FULL STUDY,190.0,s2,1,155,135.0,1,20.0,1,buy,0,sell,0.5495494947508355,16,0,1,block 1 (G first),20.0,12.0,Female,1.0,1.0,0.0,"[2, 'block 1 (G first)']",1,0,0,0.5,7.0,-0.30000000000000004,0.2222222222222222,0.1,0.5,0.0,2,0.5,0.75,Design 2,Design 2,"Have an option between Design #1 and Design #2,",5.0,,
1024,1844,3,Player object (1012),sell,2023-03-07 18:56:49.223736+00:00,"{""priceA"": 100, ""sharesA"": 0, ""secs_since_round_starts"": 91, ""market"": ""A""}",150.0,8.0,1.0,bi5jp617,vmu7c279,FULL STUDY,230.0,s2,1,100,,1,,1,,0,sell,0.5057155770500936,19,0,0,block 1 (G first),20.0,12.0,Female,1.0,1.0,0.0,"[3, 'block 1 (G first)']",1,1,0,0.5,7.0,-0.30000000000000004,0.35714285714285715,0.0,1.0,0.0,4,1.0,1.0,Design 2,Design 2,"Have an option between Design #1 and Design #2,",5.0,,
1025,1845,3,Player object (1012),buy,2023-03-07 18:57:04.097210+00:00,"{""priceA"": 110, ""sharesA"": 1, ""secs_since_round_starts"": 105, ""market"": ""A""}",40.0,11.0,2.0,bi5jp617,vmu7c279,FULL STUDY,230.0,s2,1,110,100.0,-1,,1,sell,0,sell,0.5295922419004607,19,0,0,block 1 (G first),20.0,12.0,Female,1.0,1.0,0.0,"[3, 'block 1 (G first)']",1,1,0,0.5,7.0,-0.30000000000000004,0.35714285714285715,0.0,1.0,0.0,4,1.0,1.0,Design 2,Design 2,"Have an option between Design #1 and Design #2,",5.0,,
1026,1846,3,Player object (1012),sell,2023-03-07 18:57:14.601911+00:00,"{""priceA"": 130, ""sharesA"": 0, ""secs_since_round_starts"": 116, ""market"": ""A""}",170.0,13.0,3.0,bi5jp617,vmu7c279,FULL STUDY,230.0,s2,1,130,110.0,1,20.0,1,buy,0,sell,0.5729625045047859,19,0,1,block 1 (G first),20.0,12.0,Female,1.0,1.0,0.0,"[3, 'block 1 (G first)']",1,1,0,0.5,7.0,-0.30000000000000004,0.35714285714285715,0.0,1.0,0.0,4,1.0,1.0,Design 2,Design 2,"Have an option between Design #1 and Design #2,",5.0,,
1027,1847,3,Player object (1012),buy,2023-03-07 18:57:28.859033+00:00,"{""priceA"": 110, ""sharesA"": 1, ""secs_since_round_starts"": 130, ""market"": ""A""}",60.0,15.0,4.0,bi5jp617,vmu7c279,FULL STUDY,230.0,s2,1,110,130.0,-1,,1,sell,0,sell,0.4763410641166328,19,0,0,block 1 (G first),20.0,12.0,Female,1.0,1.0,0.0,"[3, 'block 1 (G first)']",1,1,0,0.5,7.0,-0.30000000000000004,0.35714285714285715,0.0,1.0,0.0,4,1.0,1.0,Design 2,Design 2,"Have an option between Design #1 and Design #2,",5.0,,
1028,1848,3,Player object (1012),sell,2023-03-07 18:57:45.403376+00:00,"{""priceA"": 110, ""sharesA"": 0, ""secs_since_round_starts"": 147, ""market"": ""A""}",170.0,18.0,5.0,bi5jp617,vmu7c279,FULL STUDY,230.0,s2,1,110,110.0,1,0.0,1,buy,0,sell,0.5343536780010194,19,0,0,block 1 (G first),20.0,12.0,Female,1.0,1.0,0.0,"[3, 'block 1 (G first)']",1,1,0,0.5,7.0,-0.30000000000000004,0.35714285714285715,0.0,1.0,0.0,4,1.0,1.0,Design 2,Design 2,"Have an option between Design #1 and Design #2,",5.0,,
1029,1849,3,Player object (1012),buy,2023-03-07 18:57:59.791823+00:00,"{""priceA"": 100, ""sharesA"": 1, ""secs_since_round_starts"": 161, ""market"": ""A""}",70.0,21.0,6.0,bi5jp617,vmu7c279,FULL STUDY,230.0,s2,1,100,110.0,-1,,1,sell,0,sell,0.4692484881524699,19,0,0,block 1 (G first),20.0,12.0,Female,1.0,1.0,0.0,"[3, 'block 1 (G first)']",1,1,0,0.5,7.0,-0.30000000000000004,0.35714285714285715,0.0,1.0,0.0,4,1.0,1.0,Design 2,Design 2,"Have an option between Design #1 and Design #2,",5.0,,
1030,1850,3,Player object (1012),sell,2023-03-07 18:58:22.553834+00:00,"{""priceA"": 110, ""sharesA"": 0, ""secs_since_round_starts"": 184, ""market"": ""A""}",180.0,25.0,7.0,bi5jp617,vmu7c279,FULL STUDY,230.0,s2,1,110,100.0,1,10.0,1,buy,0,sell,0.4872943409941583,19,0,0,block 1 (G first),20.0,12.0,Female,1.0,1.0,0.0,"[3, 'block 1 (G first)']",1,1,0,0.5,7.0,-0.30000000000000004,0.35714285714285715,0.0,1.0,0.0,4,1.0,1.0,Design 2,Design 2,"Have an option between Design #1 and Design #2,",5.0,,
1031,1852,3,Player object (1012),buy,2023-03-07 19:27:04.174261+00:00,"{""priceA"": 100, ""sharesA"": 1, ""secs_since_round_starts"": 1906, ""market"": ""A""}",80.0,33.0,8.0,bi5jp617,vmu7c279,FULL STUDY,230.0,s2,1,100,110.0,-1,,1,sell,0,sell,0.4476889957041811,19,1,0,block 1 (G first),20.0,12.0,Female,1.0,1.0,0.0,"[3, 'block 1 (G first)']",1,1,0,0.5,7.0,-0.30000000000000004,0.35714285714285715,0.0,1.0,0.0,4,1.0,1.0,Design 2,Design 2,"Have an option between Design #1 and Design #2,",5.0,,
1032,1861,3,Player object (1012),sell,2023-03-07 19:27:58.542326+00:00,"{""priceA"": 120, ""sharesA"": 0, ""secs_since_round_starts"": 1960, ""market"": ""A""}",200.0,43.0,10.0,bi5jp617,vmu7c279,FULL STUDY,230.0,s2,1,120,120.0,1,0.0,7,buy,0,sell,0.5357259670782416,19,0,0,block 1 (G first),20.0,12.0,Female,1.0,1.0,0.0,"[3, 'block 1 (G first)']",1,1,0,0.5,7.0,-0.30000000000000004,0.35714285714285715,0.0,1.0,0.0,4,1.0,1.0,Design 2,Design 2,"Have an option between Design #1 and Design #2,",5.0,,
1033,1862,3,Player object (1012),buy,2023-03-07 19:28:30.687914+00:00,"{""priceA"": 110, ""sharesA"": 1, ""secs_since_round_starts"": 1992, ""market"": ""A""}",90.0,49.0,11.0,bi5jp617,vmu7c279,FULL STUDY,230.0,s2,1,110,120.0,-1,,1,sell,0,sell,0.4374794566672981,19,1,0,block 1 (G first),20.0,12.0,Female,1.0,1.0,0.0,"[3, 'block 1 (G first)']",1,1,0,0.5,7.0,-0.30000000000000004,0.35714285714285715,0.0,1.0,0.0,4,1.0,1.0,Design 2,Design 2,"Have an option between Design #1 and Design #2,",5.0,,
1034,1863,3,Player object (1012),sell,2023-03-07 19:28:40.793843+00:00,"{""priceA"": 120, ""sharesA"": 0, ""secs_since_round_starts"": 2002, ""market"": ""A""}",210.0,51.0,12.0,bi5jp617,vmu7c279,FULL STUDY,230.0,s2,1,120,110.0,1,10.0,1,buy,0,sell,0.4588602748157505,19,0,0,block 1 (G first),20.0,12.0,Female,1.0,1.0,0.0,"[3, 'block 1 (G first)']",1,1,0,0.5,7.0,-0.30000000000000004,0.35714285714285715,0.0,1.0,0.0,4,1.0,1.0,Design 2,Design 2,"Have an option between Design #1 and Design #2,",5.0,,
1035,1864,3,Player object (1012),buy,2023-03-07 19:28:52.368092+00:00,"{""priceA"": 130, ""sharesA"": 1, ""secs_since_round_starts"": 2014, ""market"": ""A""}",80.0,53.0,13.0,bi5jp617,vmu7c279,FULL STUDY,230.0,s2,1,130,120.0,-1,,1,sell,0,sell,0.4905868559773416,19,0,0,block 1 (G first),20.0,12.0,Female,1.0,1.0,0.0,"[3, 'block 1 (G first)']",1,1,0,0.5,7.0,-0.30000000000000004,0.35714285714285715,0.0,1.0,0.0,4,1.0,1.0,Design 2,Design 2,"Have an option between Design #1 and Design #2,",5.0,,
1036,1865,3,Player object (1012),sell,2023-03-07 19:29:03.005353+00:00,"{""priceA"": 150, ""sharesA"": 0, ""secs_since_round_starts"": 2024, ""market"": ""A""}",230.0,55.0,14.0,bi5jp617,vmu7c279,FULL STUDY,230.0,s2,1,150,130.0,1,20.0,1,buy,0,sell,0.5546141592279494,19,0,1,block 1 (G first),20.0,12.0,Female,1.0,1.0,0.0,"[3, 'block 1 (G first)']",1,1,0,0.5,7.0,-0.30000000000000004,0.35714285714285715,0.0,1.0,0.0,4,1.0,1.0,Design 2,Design 2,"Have an option between Design #1 and Design #2,",5.0,,
1037,1866,3,Player object (1012),buy,2023-03-07 19:29:21.604784+00:00,"{""priceA"": 115, ""sharesA"": 1, ""secs_since_round_starts"": 2043, ""market"": ""A""}",115.0,58.0,15.0,bi5jp617,vmu7c279,FULL STUDY,230.0,s2,1,115,150.0,-1,,1,sell,0,sell,0.442461876115205,19,1,0,block 1 (G first),20.0,12.0,Female,1.0,1.0,0.0,"[3, 'block 1 (G first)']",1,1,0,0.5,7.0,-0.30000000000000004,0.35714285714285715,0.0,1.0,0.0,4,1.0,1.0,Design 2,Design 2,"Have an option between Design #1 and Design #2,",5.0,,
1038,1870,4,Player object (1132),sell,2023-03-07 19:30:21.153539+00:00,"{""priceA"": 70, ""sharesA"": 0, ""secs_since_round_starts"": 43, ""market"": ""A""}",120.0,9.0,1.0,bi5jp617,vmu7c279,FULL STUDY,115.0,s2,1,70,,1,,1,,0,sell,0.5440818519127735,14,0,1,block 1 (G first),20.0,12.0,Female,1.0,1.0,0.0,"[4, 'block 1 (G first)']",0,0,0,0.5,7.0,-0.30000000000000004,0.2,0.18181818181818182,,0.16666666666666666,4,0.5,1.0,Design 2,Design 2,"Have an option between Design #1 and Design #2,",5.0,,
1039,1871,4,Player object (1132),buy,2023-03-07 19:30:44.125245+00:00,"{""priceA"": 75, ""sharesA"": 1, ""secs_since_round_starts"": 66, ""market"": ""A""}",45.0,13.0,2.0,bi5jp617,vmu7c279,FULL STUDY,115.0,s2,1,75,70.0,-1,,1,sell,0,sell,0.479681559969247,14,0,0,block 1 (G first),20.0,12.0,Female,1.0,1.0,0.0,"[4, 'block 1 (G first)']",0,0,0,0.5,7.0,-0.30000000000000004,0.2,0.18181818181818182,,0.16666666666666666,4,0.5,1.0,Design 2,Design 2,"Have an option between Design #1 and Design #2,",5.0,,
1040,1872,4,Player object (1132),sell,2023-03-07 19:31:18.843674+00:00,"{""priceA"": 85, ""sharesA"": 0, ""secs_since_round_starts"": 101, ""market"": ""A""}",130.0,19.0,3.0,bi5jp617,vmu7c279,FULL STUDY,115.0,s2,1,85,75.0,1,10.0,1,buy,0,sell,0.4934202415852731,14,0,0,block 1 (G first),20.0,12.0,Female,1.0,1.0,0.0,"[4, 'block 1 (G first)']",0,0,0,0.5,7.0,-0.30000000000000004,0.2,0.18181818181818182,,0.16666666666666666,4,0.5,1.0,Design 2,Design 2,"Have an option between Design #1 and Design #2,",5.0,,
1041,1873,4,Player object (1132),buy,2023-03-07 19:31:26.781867+00:00,"{""priceA"": 65, ""sharesA"": 1, ""secs_since_round_starts"": 109, ""market"": ""A""}",65.0,21.0,4.0,bi5jp617,vmu7c279,FULL STUDY,115.0,s2,1,65,85.0,-1,,1,sell,0,sell,0.4378043684469758,14,0,0,block 1 (G first),20.0,12.0,Female,1.0,1.0,0.0,"[4, 'block 1 (G first)']",0,0,0,0.5,7.0,-0.30000000000000004,0.2,0.18181818181818182,,0.16666666666666666,4,0.5,1.0,Design 2,Design 2,"Have an option between Design #1 and Design #2,",5.0,,
1042,1874,4,Player object (1132),sell,2023-03-07 19:32:00.168958+00:00,"{""priceA"": 65, ""sharesA"": 0, ""secs_since_round_starts"": 142, ""market"": ""A""}",130.0,27.0,5.0,bi5jp617,vmu7c279,FULL STUDY,115.0,s2,1,65,65.0,1,0.0,1,buy,0,sell,0.5259713378953906,14,0,0,block 1 (G first),20.0,12.0,Female,1.0,1.0,0.0,"[4, 'block 1 (G first)']",0,0,0,0.5,7.0,-0.30000000000000004,0.2,0.18181818181818182,,0.16666666666666666,4,0.5,1.0,Design 2,Design 2,"Have an option between Design #1 and Design #2,",5.0,,
1043,1876,4,Player object (1132),buy,2023-03-07 19:32:47.288115+00:00,"{""priceA"": 100, ""sharesA"": 1, ""secs_since_round_starts"": 189, ""market"": ""A""}",30.0,33.0,6.0,bi5jp617,vmu7c279,FULL STUDY,115.0,s2,1,100,65.0,-1,,1,sell,0,sell,0.5473882863317556,14,0,0,block 1 (G first),20.0,12.0,Female,1.0,1.0,0.0,"[4, 'block 1 (G first)']",0,0,0,0.5,7.0,-0.30000000000000004,0.2,0.18181818181818182,,0.16666666666666666,4,0.5,1.0,Design 2,Design 2,"Have an option between Design #1 and Design #2,",5.0,,
1044,1877,4,Player object (1132),sell,2023-03-07 19:32:50.938181+00:00,"{""priceA"": 95, ""sharesA"": 0, ""secs_since_round_starts"": 193, ""market"": ""A""}",125.0,34.0,7.0,bi5jp617,vmu7c279,FULL STUDY,115.0,s2,1,95,100.0,1,-5.0,1,buy,0,sell,0.4981543075921684,14,0,0,block 1 (G first),20.0,12.0,Female,1.0,1.0,0.0,"[4, 'block 1 (G first)']",0,0,0,0.5,7.0,-0.30000000000000004,0.2,0.18181818181818182,,0.16666666666666666,4,0.5,1.0,Design 2,Design 2,"Have an option between Design #1 and Design #2,",5.0,,
1045,1878,4,Player object (1132),buy,2023-03-07 19:32:56.800148+00:00,"{""priceA"": 100, ""sharesA"": 1, ""secs_since_round_starts"": 199, ""market"": ""A""}",25.0,35.0,8.0,bi5jp617,vmu7c279,FULL STUDY,115.0,s2,1,100,95.0,-1,,1,sell,0,sell,0.5337204628349665,14,0,0,block 1 (G first),20.0,12.0,Female,1.0,1.0,0.0,"[4, 'block 1 (G first)']",0,0,0,0.5,7.0,-0.30000000000000004,0.2,0.18181818181818182,,0.16666666666666666,4,0.5,1.0,Design 2,Design 2,"Have an option between Design #1 and Design #2,",5.0,,
1046,1879,4,Player object (1132),sell,2023-03-07 19:33:42.624636+00:00,"{""priceA"": 100, ""sharesA"": 0, ""secs_since_round_starts"": 245, ""market"": ""A""}",125.0,43.0,9.0,bi5jp617,vmu7c279,FULL STUDY,115.0,s2,1,100,100.0,1,0.0,1,buy,0,sell,0.5617190733230237,14,0,1,block 1 (G first),20.0,12.0,Female,1.0,1.0,0.0,"[4, 'block 1 (G first)']",0,0,0,0.5,7.0,-0.30000000000000004,0.2,0.18181818181818182,,0.16666666666666666,4,0.5,1.0,Design 2,Design 2,"Have an option between Design #1 and Design #2,",5.0,,
1047,1880,4,Player object (1132),buy,2023-03-07 19:34:28.967232+00:00,"{""priceA"": 90, ""sharesA"": 1, ""secs_since_round_starts"": 291, ""market"": ""A""}",35.0,52.0,10.0,bi5jp617,vmu7c279,FULL STUDY,115.0,s2,1,90,100.0,-1,,1,sell,0,sell,0.4694909620846048,14,0,0,block 1 (G first),20.0,12.0,Female,1.0,1.0,0.0,"[4, 'block 1 (G first)']",0,0,0,0.5,7.0,-0.30000000000000004,0.2,0.18181818181818182,,0.16666666666666666,4,0.5,1.0,Design 2,Design 2,"Have an option between Design #1 and Design #2,",5.0,,
1048,1881,4,Player object (1132),sell,2023-03-07 19:34:39.467771+00:00,"{""priceA"": 85, ""sharesA"": 0, ""secs_since_round_starts"": 302, ""market"": ""A""}",120.0,54.0,11.0,bi5jp617,vmu7c279,FULL STUDY,115.0,s2,1,85,90.0,1,-5.0,1,buy,0,sell,0.4957421237757241,14,0,0,block 1 (G first),20.0,12.0,Female,1.0,1.0,0.0,"[4, 'block 1 (G first)']",0,0,0,0.5,7.0,-0.30000000000000004,0.2,0.18181818181818182,,0.16666666666666666,4,0.5,1.0,Design 2,Design 2,"Have an option between Design #1 and Design #2,",5.0,,
1049,1882,4,Player object (1132),buy,2023-03-07 19:34:50.413987+00:00,"{""priceA"": 65, ""sharesA"": 1, ""secs_since_round_starts"": 313, ""market"": ""A""}",55.0,56.0,12.0,bi5jp617,vmu7c279,FULL STUDY,115.0,s2,1,65,85.0,-1,,1,sell,0,sell,0.4388999887324031,14,0,0,block 1 (G first),20.0,12.0,Female,1.0,1.0,0.0,"[4, 'block 1 (G first)']",0,0,0,0.5,7.0,-0.30000000000000004,0.2,0.18181818181818182,,0.16666666666666666,4,0.5,1.0,Design 2,Design 2,"Have an option between Design #1 and Design #2,",5.0,,
1050,1883,4,Player object (1132),sell,2023-03-07 19:35:03.543940+00:00,"{""priceA"": 60, ""sharesA"": 0, ""secs_since_round_starts"": 326, ""market"": ""A""}",115.0,58.0,13.0,bi5jp617,vmu7c279,FULL STUDY,115.0,s2,1,60,65.0,1,-5.0,1,buy,0,sell,0.4809250988502129,14,0,0,block 1 (G first),20.0,12.0,Female,1.0,1.0,0.0,"[4, 'block 1 (G first)']",0,0,0,0.5,7.0,-0.30000000000000004,0.2,0.18181818181818182,,0.16666666666666666,4,0.5,1.0,Design 2,Design 2,"Have an option between Design #1 and Design #2,",5.0,,
1051,1887,5,Player object (1252),sell,2023-03-07 19:36:12.145314+00:00,"{""priceA"": 80, ""sharesA"": 0, ""secs_since_round_starts"": 52, ""market"": ""A""}",130.0,9.0,1.0,bi5jp617,vmu7c279,FULL STUDY,100.0,s2,1,80,,1,,1,,0,sell,0.4765586288879626,17,0,0,block 1 (G first),20.0,12.0,Female,1.0,1.0,0.0,"[5, 'block 1 (G first)']",0,1,0,1.0,7.0,-0.30000000000000004,0.5,0.3,1.0,0.3333333333333333,4,0.5,1.0,Design 2,Design 2,"Have an option between Design #1 and Design #2,",5.0,,
1052,1889,5,Player object (1252),buy,2023-03-07 19:42:41.665456+00:00,"{""priceA"": 95, ""sharesA"": 1, ""secs_since_round_starts"": 442, ""market"": ""A""}",35.0,37.0,2.0,bi5jp617,vmu7c279,FULL STUDY,100.0,s2,1,95,80.0,-1,,1,sell,0,sell,0.4805886028013266,17,0,0,block 1 (G first),20.0,12.0,Female,1.0,1.0,0.0,"[5, 'block 1 (G first)']",0,1,0,1.0,7.0,-0.30000000000000004,0.5,0.3,1.0,0.3333333333333333,4,0.5,1.0,Design 2,Design 2,"Have an option between Design #1 and Design #2,",5.0,,
1053,1890,5,Player object (1252),sell,2023-03-07 19:43:10.789881+00:00,"{""priceA"": 100, ""sharesA"": 0, ""secs_since_round_starts"": 471, ""market"": ""A""}",135.0,42.0,3.0,bi5jp617,vmu7c279,FULL STUDY,100.0,s2,1,100,95.0,1,5.0,1,buy,0,sell,0.5529358605422235,17,0,1,block 1 (G first),20.0,12.0,Female,1.0,1.0,0.0,"[5, 'block 1 (G first)']",0,1,0,1.0,7.0,-0.30000000000000004,0.5,0.3,1.0,0.3333333333333333,4,0.5,1.0,Design 2,Design 2,"Have an option between Design #1 and Design #2,",5.0,,
1054,1891,5,Player object (1252),buy,2023-03-07 19:43:32.677349+00:00,"{""priceA"": 95, ""sharesA"": 1, ""secs_since_round_starts"": 493, ""market"": ""A""}",40.0,46.0,4.0,bi5jp617,vmu7c279,FULL STUDY,100.0,s2,1,95,100.0,-1,,1,sell,0,sell,0.4967862103563366,17,0,0,block 1 (G first),20.0,12.0,Female,1.0,1.0,0.0,"[5, 'block 1 (G first)']",0,1,0,1.0,7.0,-0.30000000000000004,0.5,0.3,1.0,0.3333333333333333,4,0.5,1.0,Design 2,Design 2,"Have an option between Design #1 and Design #2,",5.0,,
1055,1892,5,Player object (1252),sell,2023-03-07 19:43:40.652373+00:00,"{""priceA"": 75, ""sharesA"": 0, ""secs_since_round_starts"": 501, ""market"": ""A""}",115.0,48.0,5.0,bi5jp617,vmu7c279,FULL STUDY,100.0,s2,1,75,95.0,1,-20.0,1,buy,0,sell,0.4393932183506925,17,1,0,block 1 (G first),20.0,12.0,Female,1.0,1.0,0.0,"[5, 'block 1 (G first)']",0,1,0,1.0,7.0,-0.30000000000000004,0.5,0.3,1.0,0.3333333333333333,4,0.5,1.0,Design 2,Design 2,"Have an option between Design #1 and Design #2,",5.0,,
1056,1893,5,Player object (1252),buy,2023-03-07 19:43:57.572005+00:00,"{""priceA"": 85, ""sharesA"": 1, ""secs_since_round_starts"": 518, ""market"": ""A""}",30.0,51.0,6.0,bi5jp617,vmu7c279,FULL STUDY,100.0,s2,1,85,75.0,-1,,1,sell,0,sell,0.5069151322589074,17,0,0,block 1 (G first),20.0,12.0,Female,1.0,1.0,0.0,"[5, 'block 1 (G first)']",0,1,0,1.0,7.0,-0.30000000000000004,0.5,0.3,1.0,0.3333333333333333,4,0.5,1.0,Design 2,Design 2,"Have an option between Design #1 and Design #2,",5.0,,
1057,1894,5,Player object (1252),sell,2023-03-07 19:44:08.621406+00:00,"{""priceA"": 85, ""sharesA"": 0, ""secs_since_round_starts"": 529, ""market"": ""A""}",115.0,53.0,7.0,bi5jp617,vmu7c279,FULL STUDY,100.0,s2,1,85,85.0,1,0.0,1,buy,0,sell,0.4927925471404216,17,0,0,block 1 (G first),20.0,12.0,Female,1.0,1.0,0.0,"[5, 'block 1 (G first)']",0,1,0,1.0,7.0,-0.30000000000000004,0.5,0.3,1.0,0.3333333333333333,4,0.5,1.0,Design 2,Design 2,"Have an option between Design #1 and Design #2,",5.0,,
1058,1895,5,Player object (1252),buy,2023-03-07 19:44:13.504503+00:00,"{""priceA"": 95, ""sharesA"": 1, ""secs_since_round_starts"": 534, ""market"": ""A""}",20.0,54.0,8.0,bi5jp617,vmu7c279,FULL STUDY,100.0,s2,1,95,85.0,-1,,1,sell,0,sell,0.5299980248683189,17,0,0,block 1 (G first),20.0,12.0,Female,1.0,1.0,0.0,"[5, 'block 1 (G first)']",0,1,0,1.0,7.0,-0.30000000000000004,0.5,0.3,1.0,0.3333333333333333,4,0.5,1.0,Design 2,Design 2,"Have an option between Design #1 and Design #2,",5.0,,
1059,1896,5,Player object (1252),sell,2023-03-07 19:44:19.753038+00:00,"{""priceA"": 80, ""sharesA"": 0, ""secs_since_round_starts"": 540, ""market"": ""A""}",100.0,55.0,9.0,bi5jp617,vmu7c279,FULL STUDY,100.0,s2,1,80,95.0,1,-15.0,1,buy,0,sell,0.4859141076178286,17,0,0,block 1 (G first),20.0,12.0,Female,1.0,1.0,0.0,"[5, 'block 1 (G first)']",0,1,0,1.0,7.0,-0.30000000000000004,0.5,0.3,1.0,0.3333333333333333,4,0.5,1.0,Design 2,Design 2,"Have an option between Design #1 and Design #2,",5.0,,
1060,1897,5,Player object (1252),buy,2023-03-07 19:44:47.198888+00:00,"{""priceA"": 65, ""sharesA"": 1, ""secs_since_round_starts"": 567, ""market"": ""A""}",35.0,60.0,10.0,bi5jp617,vmu7c279,FULL STUDY,100.0,s2,1,65,80.0,-1,,1,sell,0,sell,0.4189820782479906,17,0,0,block 1 (G first),20.0,12.0,Female,1.0,1.0,0.0,"[5, 'block 1 (G first)']",0,1,0,1.0,7.0,-0.30000000000000004,0.5,0.3,1.0,0.3333333333333333,4,0.5,1.0,Design 2,Design 2,"Have an option between Design #1 and Design #2,",5.0,,
1061,4630,2,Player object (955),sell,2023-03-10 02:40:49.727574+00:00,"{""priceA"": 105, ""sharesA"": 0, ""secs_since_round_starts"": 90, ""market"": ""A""}",155.0,16.0,1.0,bsjfe8ds,vmu7c279,FULL STUDY,190.0,s1,1,105,,1,,1,,0,sell,0.5185790363913291,16,0,0,block 4 (G second),21.0,12.0,Female,1.0,1.0,1.0,"[2, 'block 4 (G second)']",0,1,1,0.0,8.0,-0.19999999999999996,0.2,0.0,0.0,0.0,4,1.0,0.5,Design 2,Design 2,"Have an option between Design #1 and Design #2,",,3.0,5.0
1062,4632,2,Player object (955),buy,2023-03-10 02:41:23.045498+00:00,"{""priceA"": 140, ""sharesA"": 1, ""secs_since_round_starts"": 124, ""market"": ""A""}",15.0,22.0,2.0,bsjfe8ds,vmu7c279,FULL STUDY,190.0,s1,1,140,105.0,-1,,1,sell,0,sell,0.5695815034421478,16,0,0,block 4 (G second),21.0,12.0,Female,1.0,1.0,1.0,"[2, 'block 4 (G second)']",0,1,1,0.0,8.0,-0.19999999999999996,0.2,0.0,0.0,0.0,4,1.0,0.5,Design 2,Design 2,"Have an option between Design #1 and Design #2,",,3.0,5.0
1063,4633,2,Player object (955),sell,2023-03-10 02:41:39.439395+00:00,"{""priceA"": 145, ""sharesA"": 0, ""secs_since_round_starts"": 140, ""market"": ""A""}",160.0,25.0,3.0,bsjfe8ds,vmu7c279,FULL STUDY,190.0,s1,1,145,140.0,1,5.0,1,buy,0,sell,0.5294358264188312,16,0,0,block 4 (G second),21.0,12.0,Female,1.0,1.0,1.0,"[2, 'block 4 (G second)']",0,1,1,0.0,8.0,-0.19999999999999996,0.2,0.0,0.0,0.0,4,1.0,0.5,Design 2,Design 2,"Have an option between Design #1 and Design #2,",,3.0,5.0
1064,4634,2,Player object (955),buy,2023-03-10 02:42:07.743836+00:00,"{""priceA"": 125, ""sharesA"": 1, ""secs_since_round_starts"": 168, ""market"": ""A""}",35.0,30.0,4.0,bsjfe8ds,vmu7c279,FULL STUDY,190.0,s1,1,125,145.0,-1,,1,sell,0,sell,0.4785999259850118,16,0,0,block 4 (G second),21.0,12.0,Female,1.0,1.0,1.0,"[2, 'block 4 (G second)']",0,1,1,0.0,8.0,-0.19999999999999996,0.2,0.0,0.0,0.0,4,1.0,0.5,Design 2,Design 2,"Have an option between Design #1 and Design #2,",,3.0,5.0
1065,4636,2,Player object (955),sell,2023-03-10 02:42:47.037935+00:00,"{""priceA"": 145, ""sharesA"": 0, ""secs_since_round_starts"": 208, ""market"": ""A""}",180.0,37.0,5.0,bsjfe8ds,vmu7c279,FULL STUDY,190.0,s1,1,145,125.0,1,20.0,1,buy,0,sell,0.494384744736363,16,0,0,block 4 (G second),21.0,12.0,Female,1.0,1.0,1.0,"[2, 'block 4 (G second)']",0,1,1,0.0,8.0,-0.19999999999999996,0.2,0.0,0.0,0.0,4,1.0,0.5,Design 2,Design 2,"Have an option between Design #1 and Design #2,",,3.0,5.0
1066,4637,2,Player object (955),buy,2023-03-10 02:43:25.854751+00:00,"{""priceA"": 130, ""sharesA"": 1, ""secs_since_round_starts"": 246, ""market"": ""A""}",50.0,44.0,6.0,bsjfe8ds,vmu7c279,FULL STUDY,190.0,s1,1,130,145.0,-1,,1,sell,0,sell,0.4799987600827208,16,0,0,block 4 (G second),21.0,12.0,Female,1.0,1.0,1.0,"[2, 'block 4 (G second)']",0,1,1,0.0,8.0,-0.19999999999999996,0.2,0.0,0.0,0.0,4,1.0,0.5,Design 2,Design 2,"Have an option between Design #1 and Design #2,",,3.0,5.0
1067,4638,2,Player object (955),sell,2023-03-10 02:43:42.115141+00:00,"{""priceA"": 140, ""sharesA"": 0, ""secs_since_round_starts"": 263, ""market"": ""A""}",190.0,47.0,7.0,bsjfe8ds,vmu7c279,FULL STUDY,190.0,s1,1,140,130.0,1,10.0,1,buy,0,sell,0.4996814899229063,16,0,0,block 4 (G second),21.0,12.0,Female,1.0,1.0,1.0,"[2, 'block 4 (G second)']",0,1,1,0.0,8.0,-0.19999999999999996,0.2,0.0,0.0,0.0,4,1.0,0.5,Design 2,Design 2,"Have an option between Design #1 and Design #2,",,3.0,5.0
1068,4639,2,Player object (955),buy,2023-03-10 02:44:12.551597+00:00,"{""priceA"": 125, ""sharesA"": 1, ""secs_since_round_starts"": 292, ""market"": ""A""}",65.0,52.0,8.0,bsjfe8ds,vmu7c279,FULL STUDY,190.0,s1,1,125,140.0,-1,,1,sell,0,sell,0.4439176376077041,16,1,0,block 4 (G second),21.0,12.0,Female,1.0,1.0,1.0,"[2, 'block 4 (G second)']",0,1,1,0.0,8.0,-0.19999999999999996,0.2,0.0,0.0,0.0,4,1.0,0.5,Design 2,Design 2,"Have an option between Design #1 and Design #2,",,3.0,5.0
1069,4643,3,Player object (1075),sell,2023-03-10 02:45:58.406105+00:00,"{""priceA"": 110, ""sharesA"": 0, ""secs_since_round_starts"": 55, ""market"": ""A""}",160.0,11.0,1.0,bsjfe8ds,vmu7c279,FULL STUDY,180.0,s1,1,110,,1,,1,,0,sell,0.5295922419004607,19,0,0,block 4 (G second),21.0,12.0,Female,1.0,1.0,1.0,"[3, 'block 4 (G second)']",0,0,1,0.5,8.0,-0.19999999999999996,0.26666666666666666,0.11764705882352941,0.0,0.0,2,0.5,0.25,Design 2,Design 2,"Have an option between Design #1 and Design #2,",,3.0,5.0
1070,4644,3,Player object (1075),buy,2023-03-10 02:46:26.218241+00:00,"{""priceA"": 100, ""sharesA"": 1, ""secs_since_round_starts"": 82, ""market"": ""A""}",60.0,16.0,2.0,bsjfe8ds,vmu7c279,FULL STUDY,180.0,s1,1,100,110.0,-1,,1,sell,0,sell,0.4486815727575955,19,1,0,block 4 (G second),21.0,12.0,Female,1.0,1.0,1.0,"[3, 'block 4 (G second)']",0,0,1,0.5,8.0,-0.19999999999999996,0.26666666666666666,0.11764705882352941,0.0,0.0,2,0.5,0.25,Design 2,Design 2,"Have an option between Design #1 and Design #2,",,3.0,5.0
1071,4645,3,Player object (1075),sell,2023-03-10 02:47:15.306560+00:00,"{""priceA"": 110, ""sharesA"": 0, ""secs_since_round_starts"": 131, ""market"": ""A""}",170.0,25.0,3.0,bsjfe8ds,vmu7c279,FULL STUDY,180.0,s1,1,110,100.0,1,10.0,1,buy,0,sell,0.4872943409941583,19,0,0,block 4 (G second),21.0,12.0,Female,1.0,1.0,1.0,"[3, 'block 4 (G second)']",0,0,1,0.5,8.0,-0.19999999999999996,0.26666666666666666,0.11764705882352941,0.0,0.0,2,0.5,0.25,Design 2,Design 2,"Have an option between Design #1 and Design #2,",,3.0,5.0
1072,4646,3,Player object (1075),buy,2023-03-10 02:47:22.200103+00:00,"{""priceA"": 115, ""sharesA"": 1, ""secs_since_round_starts"": 137, ""market"": ""A""}",55.0,26.0,4.0,bsjfe8ds,vmu7c279,FULL STUDY,180.0,s1,1,115,110.0,-1,,1,sell,0,sell,0.526172546586359,19,0,0,block 4 (G second),21.0,12.0,Female,1.0,1.0,1.0,"[3, 'block 4 (G second)']",0,0,1,0.5,8.0,-0.19999999999999996,0.26666666666666666,0.11764705882352941,0.0,0.0,2,0.5,0.25,Design 2,Design 2,"Have an option between Design #1 and Design #2,",,3.0,5.0
1073,4648,3,Player object (1075),sell,2023-03-10 02:48:37.363422+00:00,"{""priceA"": 100, ""sharesA"": 0, ""secs_since_round_starts"": 213, ""market"": ""A""}",155.0,40.0,5.0,bsjfe8ds,vmu7c279,FULL STUDY,180.0,s1,1,100,115.0,1,-15.0,1,buy,0,sell,0.4804175727303482,19,0,0,block 4 (G second),21.0,12.0,Female,1.0,1.0,1.0,"[3, 'block 4 (G second)']",0,0,1,0.5,8.0,-0.19999999999999996,0.26666666666666666,0.11764705882352941,0.0,0.0,2,0.5,0.25,Design 2,Design 2,"Have an option between Design #1 and Design #2,",,3.0,5.0
1074,4649,3,Player object (1075),buy,2023-03-10 02:48:45.917779+00:00,"{""priceA"": 95, ""sharesA"": 1, ""secs_since_round_starts"": 222, ""market"": ""A""}",60.0,41.0,6.0,bsjfe8ds,vmu7c279,FULL STUDY,180.0,s1,1,95,100.0,-1,,1,sell,0,sell,0.4514823197003955,19,0,0,block 4 (G second),21.0,12.0,Female,1.0,1.0,1.0,"[3, 'block 4 (G second)']",0,0,1,0.5,8.0,-0.19999999999999996,0.26666666666666666,0.11764705882352941,0.0,0.0,2,0.5,0.25,Design 2,Design 2,"Have an option between Design #1 and Design #2,",,3.0,5.0
1075,4650,3,Player object (1075),sell,2023-03-10 02:48:56.095117+00:00,"{""priceA"": 120, ""sharesA"": 0, ""secs_since_round_starts"": 232, ""market"": ""A""}",180.0,43.0,7.0,bsjfe8ds,vmu7c279,FULL STUDY,180.0,s1,1,120,95.0,1,25.0,1,buy,0,sell,0.5357259670782416,19,0,0,block 4 (G second),21.0,12.0,Female,1.0,1.0,1.0,"[3, 'block 4 (G second)']",0,0,1,0.5,8.0,-0.19999999999999996,0.26666666666666666,0.11764705882352941,0.0,0.0,2,0.5,0.25,Design 2,Design 2,"Have an option between Design #1 and Design #2,",,3.0,5.0
1076,4651,3,Player object (1075),buy,2023-03-10 02:49:00.874301+00:00,"{""priceA"": 135, ""sharesA"": 1, ""secs_since_round_starts"": 237, ""market"": ""A""}",45.0,44.0,8.0,bsjfe8ds,vmu7c279,FULL STUDY,180.0,s1,1,135,120.0,-1,,1,sell,0,sell,0.5595824488336746,19,0,1,block 4 (G second),21.0,12.0,Female,1.0,1.0,1.0,"[3, 'block 4 (G second)']",0,0,1,0.5,8.0,-0.19999999999999996,0.26666666666666666,0.11764705882352941,0.0,0.0,2,0.5,0.25,Design 2,Design 2,"Have an option between Design #1 and Design #2,",,3.0,5.0
1077,4652,3,Player object (1075),sell,2023-03-10 02:49:04.724104+00:00,"{""priceA"": 125, ""sharesA"": 0, ""secs_since_round_starts"": 241, ""market"": ""A""}",170.0,45.0,9.0,bsjfe8ds,vmu7c279,FULL STUDY,180.0,s1,1,125,135.0,1,-10.0,1,buy,0,sell,0.5067886105922249,19,0,0,block 4 (G second),21.0,12.0,Female,1.0,1.0,1.0,"[3, 'block 4 (G second)']",0,0,1,0.5,8.0,-0.19999999999999996,0.26666666666666666,0.11764705882352941,0.0,0.0,2,0.5,0.25,Design 2,Design 2,"Have an option between Design #1 and Design #2,",,3.0,5.0
1078,4653,3,Player object (1075),buy,2023-03-10 02:49:27.485544+00:00,"{""priceA"": 110, ""sharesA"": 1, ""secs_since_round_starts"": 264, ""market"": ""A""}",60.0,49.0,10.0,bsjfe8ds,vmu7c279,FULL STUDY,180.0,s1,1,110,125.0,-1,,1,sell,0,sell,0.4374794566672981,19,1,0,block 4 (G second),21.0,12.0,Female,1.0,1.0,1.0,"[3, 'block 4 (G second)']",0,0,1,0.5,8.0,-0.19999999999999996,0.26666666666666666,0.11764705882352941,0.0,0.0,2,0.5,0.25,Design 2,Design 2,"Have an option between Design #1 and Design #2,",,3.0,5.0
1079,4654,3,Player object (1075),sell,2023-03-10 02:49:51.191430+00:00,"{""priceA"": 130, ""sharesA"": 0, ""secs_since_round_starts"": 287, ""market"": ""A""}",190.0,53.0,11.0,bsjfe8ds,vmu7c279,FULL STUDY,180.0,s1,1,130,110.0,1,20.0,1,buy,0,sell,0.4905868559773416,19,0,0,block 4 (G second),21.0,12.0,Female,1.0,1.0,1.0,"[3, 'block 4 (G second)']",0,0,1,0.5,8.0,-0.19999999999999996,0.26666666666666666,0.11764705882352941,0.0,0.0,2,0.5,0.25,Design 2,Design 2,"Have an option between Design #1 and Design #2,",,3.0,5.0
1080,4655,3,Player object (1075),buy,2023-03-10 02:50:22.094746+00:00,"{""priceA"": 125, ""sharesA"": 1, ""secs_since_round_starts"": 318, ""market"": ""A""}",65.0,59.0,12.0,bsjfe8ds,vmu7c279,FULL STUDY,180.0,s1,1,125,130.0,-1,,1,sell,0,sell,0.4946618842475483,19,0,0,block 4 (G second),21.0,12.0,Female,1.0,1.0,1.0,"[3, 'block 4 (G second)']",0,0,1,0.5,8.0,-0.19999999999999996,0.26666666666666666,0.11764705882352941,0.0,0.0,2,0.5,0.25,Design 2,Design 2,"Have an option between Design #1 and Design #2,",,3.0,5.0
1081,4660,4,Player object (1195),sell,2023-03-10 02:56:19.369880+00:00,"{""priceA"": 100, ""sharesA"": 0, ""secs_since_round_starts"": 240, ""market"": ""A""}",150.0,45.0,1.0,bsjfe8ds,vmu7c279,FULL STUDY,140.0,s1,1,100,,1,,1,,0,sell,0.5193741863096629,14,0,0,block 4 (G second),21.0,12.0,Female,1.0,1.0,1.0,"[4, 'block 4 (G second)']",1,1,1,0.5,8.0,-0.19999999999999996,0.0,0.0,,0.0,4,0.5,0.75,Design 2,Design 2,"Have an option between Design #1 and Design #2,",,3.0,5.0
1082,4661,4,Player object (1195),buy,2023-03-10 02:57:08.779229+00:00,"{""priceA"": 85, ""sharesA"": 1, ""secs_since_round_starts"": 289, ""market"": ""A""}",65.0,54.0,2.0,bsjfe8ds,vmu7c279,FULL STUDY,140.0,s1,1,85,100.0,-1,,1,sell,0,sell,0.4957421237757241,14,0,0,block 4 (G second),21.0,12.0,Female,1.0,1.0,1.0,"[4, 'block 4 (G second)']",1,1,1,0.5,8.0,-0.19999999999999996,0.0,0.0,,0.0,4,0.5,0.75,Design 2,Design 2,"Have an option between Design #1 and Design #2,",,3.0,5.0
1083,4665,5,Player object (1315),sell,2023-03-10 02:58:26.349363+00:00,"{""priceA"": 90, ""sharesA"": 0, ""secs_since_round_starts"": 36, ""market"": ""A""}",140.0,8.0,1.0,bsjfe8ds,vmu7c279,FULL STUDY,210.0,s1,1,90,,1,,1,,0,sell,0.5166236645513725,17,0,0,block 4 (G second),21.0,12.0,Female,1.0,1.0,1.0,"[5, 'block 4 (G second)']",1,0,1,1.0,8.0,-0.19999999999999996,0.14285714285714285,0.08333333333333333,0.0,0.0,5,0.25,1.0,Design 2,Design 2,"Have an option between Design #1 and Design #2,",,3.0,5.0
1084,4666,5,Player object (1315),buy,2023-03-10 02:58:37.378946+00:00,"{""priceA"": 75, ""sharesA"": 1, ""secs_since_round_starts"": 47, ""market"": ""A""}",65.0,10.0,2.0,bsjfe8ds,vmu7c279,FULL STUDY,210.0,s1,1,75,90.0,-1,,1,sell,0,sell,0.4488309348307913,17,1,0,block 4 (G second),21.0,12.0,Female,1.0,1.0,1.0,"[5, 'block 4 (G second)']",1,0,1,1.0,8.0,-0.19999999999999996,0.14285714285714285,0.08333333333333333,0.0,0.0,5,0.25,1.0,Design 2,Design 2,"Have an option between Design #1 and Design #2,",,3.0,5.0
1085,4667,5,Player object (1315),sell,2023-03-10 02:58:53.154485+00:00,"{""priceA"": 85, ""sharesA"": 0, ""secs_since_round_starts"": 63, ""market"": ""A""}",150.0,13.0,3.0,bsjfe8ds,vmu7c279,FULL STUDY,210.0,s1,1,85,75.0,1,10.0,1,buy,0,sell,0.4890232705715233,17,0,0,block 4 (G second),21.0,12.0,Female,1.0,1.0,1.0,"[5, 'block 4 (G second)']",1,0,1,1.0,8.0,-0.19999999999999996,0.14285714285714285,0.08333333333333333,0.0,0.0,5,0.25,1.0,Design 2,Design 2,"Have an option between Design #1 and Design #2,",,3.0,5.0
1086,4668,5,Player object (1315),buy,2023-03-10 02:59:05.846298+00:00,"{""priceA"": 90, ""sharesA"": 1, ""secs_since_round_starts"": 74, ""market"": ""A""}",60.0,15.0,4.0,bsjfe8ds,vmu7c279,FULL STUDY,210.0,s1,1,90,85.0,-1,,1,sell,0,sell,0.505231414156075,17,0,0,block 4 (G second),21.0,12.0,Female,1.0,1.0,1.0,"[5, 'block 4 (G second)']",1,0,1,1.0,8.0,-0.19999999999999996,0.14285714285714285,0.08333333333333333,0.0,0.0,5,0.25,1.0,Design 2,Design 2,"Have an option between Design #1 and Design #2,",,3.0,5.0
1087,4669,5,Player object (1315),sell,2023-03-10 02:59:42.228556+00:00,"{""priceA"": 90, ""sharesA"": 0, ""secs_since_round_starts"": 112, ""market"": ""A""}",150.0,22.0,5.0,bsjfe8ds,vmu7c279,FULL STUDY,210.0,s1,1,90,90.0,1,0.0,1,buy,0,sell,0.5007328859118227,17,0,0,block 4 (G second),21.0,12.0,Female,1.0,1.0,1.0,"[5, 'block 4 (G second)']",1,0,1,1.0,8.0,-0.19999999999999996,0.14285714285714285,0.08333333333333333,0.0,0.0,5,0.25,1.0,Design 2,Design 2,"Have an option between Design #1 and Design #2,",,3.0,5.0
1088,4670,5,Player object (1315),buy,2023-03-10 03:00:16.325750+00:00,"{""priceA"": 85, ""sharesA"": 1, ""secs_since_round_starts"": 146, ""market"": ""A""}",65.0,28.0,6.0,bsjfe8ds,vmu7c279,FULL STUDY,210.0,s1,1,85,90.0,-1,,1,sell,0,sell,0.4496194529460131,17,1,0,block 4 (G second),21.0,12.0,Female,1.0,1.0,1.0,"[5, 'block 4 (G second)']",1,0,1,1.0,8.0,-0.19999999999999996,0.14285714285714285,0.08333333333333333,0.0,0.0,5,0.25,1.0,Design 2,Design 2,"Have an option between Design #1 and Design #2,",,3.0,5.0
1089,4672,5,Player object (1315),sell,2023-03-10 03:00:52.561868+00:00,"{""priceA"": 120, ""sharesA"": 0, ""secs_since_round_starts"": 182, ""market"": ""A""}",185.0,34.0,7.0,bsjfe8ds,vmu7c279,FULL STUDY,210.0,s1,1,120,85.0,1,35.0,1,buy,0,sell,0.5679672812132522,17,0,0,block 4 (G second),21.0,12.0,Female,1.0,1.0,1.0,"[5, 'block 4 (G second)']",1,0,1,1.0,8.0,-0.19999999999999996,0.14285714285714285,0.08333333333333333,0.0,0.0,5,0.25,1.0,Design 2,Design 2,"Have an option between Design #1 and Design #2,",,3.0,5.0
1090,4673,5,Player object (1315),buy,2023-03-10 03:01:17.585902+00:00,"{""priceA"": 70, ""sharesA"": 1, ""secs_since_round_starts"": 207, ""market"": ""A""}",115.0,39.0,8.0,bsjfe8ds,vmu7c279,FULL STUDY,210.0,s1,1,70,120.0,-1,,1,sell,0,sell,0.4317803147869401,17,0,0,block 4 (G second),21.0,12.0,Female,1.0,1.0,1.0,"[5, 'block 4 (G second)']",1,0,1,1.0,8.0,-0.19999999999999996,0.14285714285714285,0.08333333333333333,0.0,0.0,5,0.25,1.0,Design 2,Design 2,"Have an option between Design #1 and Design #2,",,3.0,5.0
1091,4674,5,Player object (1315),sell,2023-03-10 03:01:44.275091+00:00,"{""priceA"": 105, ""sharesA"": 0, ""secs_since_round_starts"": 234, ""market"": ""A""}",220.0,44.0,9.0,bsjfe8ds,vmu7c279,FULL STUDY,210.0,s1,1,105,70.0,1,35.0,1,buy,0,sell,0.515125859635568,17,0,0,block 4 (G second),21.0,12.0,Female,1.0,1.0,1.0,"[5, 'block 4 (G second)']",1,0,1,1.0,8.0,-0.19999999999999996,0.14285714285714285,0.08333333333333333,0.0,0.0,5,0.25,1.0,Design 2,Design 2,"Have an option between Design #1 and Design #2,",,3.0,5.0
1092,4675,5,Player object (1315),buy,2023-03-10 03:02:07.678097+00:00,"{""priceA"": 75, ""sharesA"": 1, ""secs_since_round_starts"": 257, ""market"": ""A""}",145.0,48.0,10.0,bsjfe8ds,vmu7c279,FULL STUDY,210.0,s1,1,75,105.0,-1,,1,sell,0,sell,0.4393932183506925,17,1,0,block 4 (G second),21.0,12.0,Female,1.0,1.0,1.0,"[5, 'block 4 (G second)']",1,0,1,1.0,8.0,-0.19999999999999996,0.14285714285714285,0.08333333333333333,0.0,0.0,5,0.25,1.0,Design 2,Design 2,"Have an option between Design #1 and Design #2,",,3.0,5.0
1093,3008,2,Player object (920),sell,2023-03-09 00:01:21.148565+00:00,"{""priceA"": 105, ""sharesA"": 0, ""secs_since_round_starts"": 89, ""market"": ""A""}",155.0,16.0,2.0,cj9n1uj4,vmu7c279,FULL STUDY,170.0,s1,1,105,110.0,1,-5.0,1,,0,sell,0.5185790363913291,16,0,0,block 2 (G first),22.0,12.0,Female,1.0,1.0,1.0,"[2, 'block 2 (G first)']",1,1,0,0.0,5.0,-0.5,0.38461538461538464,0.0,0.3333333333333333,0.0,4,1.0,0.25,Design 1,Design 1,Only trade on Design #1,,3.0,3.0
1094,3011,2,Player object (920),buy,2023-03-09 00:02:22.625958+00:00,"{""priceA"": 125, ""sharesA"": 1, ""secs_since_round_starts"": 150, ""market"": ""A""}",30.0,27.0,3.0,cj9n1uj4,vmu7c279,FULL STUDY,170.0,s1,1,125,105.0,-1,,1,sell,0,sell,0.4549942201992644,16,1,0,block 2 (G first),22.0,12.0,Female,1.0,1.0,1.0,"[2, 'block 2 (G first)']",1,1,0,0.0,5.0,-0.5,0.38461538461538464,0.0,0.3333333333333333,0.0,4,1.0,0.25,Design 1,Design 1,Only trade on Design #1,,3.0,3.0
1095,3013,2,Player object (920),sell,2023-03-09 00:03:02.206115+00:00,"{""priceA"": 130, ""sharesA"": 0, ""secs_since_round_starts"": 190, ""market"": ""A""}",160.0,33.0,4.0,cj9n1uj4,vmu7c279,FULL STUDY,170.0,s1,1,130,125.0,1,5.0,1,buy,0,sell,0.499206602391208,16,0,0,block 2 (G first),22.0,12.0,Female,1.0,1.0,1.0,"[2, 'block 2 (G first)']",1,1,0,0.0,5.0,-0.5,0.38461538461538464,0.0,0.3333333333333333,0.0,4,1.0,0.25,Design 1,Design 1,Only trade on Design #1,,3.0,3.0
1096,3014,2,Player object (920),buy,2023-03-09 00:03:10.313010+00:00,"{""priceA"": 140, ""sharesA"": 1, ""secs_since_round_starts"": 198, ""market"": ""A""}",20.0,35.0,5.0,cj9n1uj4,vmu7c279,FULL STUDY,170.0,s1,1,140,130.0,-1,,1,sell,0,sell,0.5101876173062244,16,0,0,block 2 (G first),22.0,12.0,Female,1.0,1.0,1.0,"[2, 'block 2 (G first)']",1,1,0,0.0,5.0,-0.5,0.38461538461538464,0.0,0.3333333333333333,0.0,4,1.0,0.25,Design 1,Design 1,Only trade on Design #1,,3.0,3.0
1097,3016,2,Player object (920),sell,2023-03-09 00:03:22.438513+00:00,"{""priceA"": 145, ""sharesA"": 0, ""secs_since_round_starts"": 210, ""market"": ""A""}",165.0,37.0,6.0,cj9n1uj4,vmu7c279,FULL STUDY,170.0,s1,1,145,140.0,1,5.0,1,buy,0,sell,0.494384744736363,16,0,0,block 2 (G first),22.0,12.0,Female,1.0,1.0,1.0,"[2, 'block 2 (G first)']",1,1,0,0.0,5.0,-0.5,0.38461538461538464,0.0,0.3333333333333333,0.0,4,1.0,0.25,Design 1,Design 1,Only trade on Design #1,,3.0,3.0
1098,3017,2,Player object (920),buy,2023-03-09 00:03:43.626273+00:00,"{""priceA"": 135, ""sharesA"": 1, ""secs_since_round_starts"": 231, ""market"": ""A""}",30.0,41.0,7.0,cj9n1uj4,vmu7c279,FULL STUDY,170.0,s1,1,135,145.0,-1,,1,sell,0,sell,0.4592429496222846,16,0,0,block 2 (G first),22.0,12.0,Female,1.0,1.0,1.0,"[2, 'block 2 (G first)']",1,1,0,0.0,5.0,-0.5,0.38461538461538464,0.0,0.3333333333333333,0.0,4,1.0,0.25,Design 1,Design 1,Only trade on Design #1,,3.0,3.0
1099,3018,2,Player object (920),sell,2023-03-09 00:04:12.147546+00:00,"{""priceA"": 155, ""sharesA"": 0, ""secs_since_round_starts"": 260, ""market"": ""A""}",185.0,46.0,8.0,cj9n1uj4,vmu7c279,FULL STUDY,170.0,s1,1,155,135.0,1,20.0,1,buy,0,sell,0.5495494947508355,16,0,1,block 2 (G first),22.0,12.0,Female,1.0,1.0,1.0,"[2, 'block 2 (G first)']",1,1,0,0.0,5.0,-0.5,0.38461538461538464,0.0,0.3333333333333333,0.0,4,1.0,0.25,Design 1,Design 1,Only trade on Design #1,,3.0,3.0
1100,3019,2,Player object (920),buy,2023-03-09 00:04:16.541299+00:00,"{""priceA"": 140, ""sharesA"": 1, ""secs_since_round_starts"": 264, ""market"": ""A""}",45.0,47.0,9.0,cj9n1uj4,vmu7c279,FULL STUDY,170.0,s1,1,140,155.0,-1,,1,sell,0,sell,0.4996814899229063,16,0,0,block 2 (G first),22.0,12.0,Female,1.0,1.0,1.0,"[2, 'block 2 (G first)']",1,1,0,0.0,5.0,-0.5,0.38461538461538464,0.0,0.3333333333333333,0.0,4,1.0,0.25,Design 1,Design 1,Only trade on Design #1,,3.0,3.0
1101,3020,2,Player object (920),sell,2023-03-09 00:04:23.119287+00:00,"{""priceA"": 155, ""sharesA"": 0, ""secs_since_round_starts"": 271, ""market"": ""A""}",200.0,48.0,10.0,cj9n1uj4,vmu7c279,FULL STUDY,170.0,s1,1,155,140.0,1,15.0,1,buy,0,sell,0.5347792584548927,16,0,0,block 2 (G first),22.0,12.0,Female,1.0,1.0,1.0,"[2, 'block 2 (G first)']",1,1,0,0.0,5.0,-0.5,0.38461538461538464,0.0,0.3333333333333333,0.0,4,1.0,0.25,Design 1,Design 1,Only trade on Design #1,,3.0,3.0
1102,3022,2,Player object (920),buy,2023-03-09 00:04:39.477428+00:00,"{""priceA"": 155, ""sharesA"": 1, ""secs_since_round_starts"": 287, ""market"": ""A""}",45.0,50.0,11.0,cj9n1uj4,vmu7c279,FULL STUDY,170.0,s1,1,155,155.0,-1,,1,sell,0,sell,0.5063294801170398,16,0,0,block 2 (G first),22.0,12.0,Female,1.0,1.0,1.0,"[2, 'block 2 (G first)']",1,1,0,0.0,5.0,-0.5,0.38461538461538464,0.0,0.3333333333333333,0.0,4,1.0,0.25,Design 1,Design 1,Only trade on Design #1,,3.0,3.0
1103,3030,3,Player object (1040),sell,2023-03-09 00:06:29.501498+00:00,"{""priceA"": 95, ""sharesA"": 0, ""secs_since_round_starts"": 48, ""market"": ""A""}",145.0,10.0,2.0,cj9n1uj4,vmu7c279,FULL STUDY,150.0,s1,1,95,90.0,1,5.0,1,,0,sell,0.4922087569005138,19,0,0,block 2 (G first),22.0,12.0,Female,1.0,1.0,1.0,"[3, 'block 2 (G first)']",1,0,0,0.5,5.0,-0.5,0.25,0.15384615384615385,0.0,0.2,2,0.5,0.25,Design 1,Design 1,Only trade on Design #1,,3.0,3.0
1104,3031,3,Player object (1040),buy,2023-03-09 00:06:54.955003+00:00,"{""priceA"": 110, ""sharesA"": 1, ""secs_since_round_starts"": 74, ""market"": ""A""}",35.0,15.0,3.0,cj9n1uj4,vmu7c279,FULL STUDY,150.0,s1,1,110,95.0,-1,,1,sell,0,sell,0.4763410641166328,19,0,0,block 2 (G first),22.0,12.0,Female,1.0,1.0,1.0,"[3, 'block 2 (G first)']",1,0,0,0.5,5.0,-0.5,0.25,0.15384615384615385,0.0,0.2,2,0.5,0.25,Design 1,Design 1,Only trade on Design #1,,3.0,3.0
1105,3032,3,Player object (1040),sell,2023-03-09 00:07:03.296844+00:00,"{""priceA"": 100, ""sharesA"": 0, ""secs_since_round_starts"": 82, ""market"": ""A""}",135.0,16.0,4.0,cj9n1uj4,vmu7c279,FULL STUDY,150.0,s1,1,100,110.0,1,-10.0,1,buy,0,sell,0.4486815727575955,19,1,0,block 2 (G first),22.0,12.0,Female,1.0,1.0,1.0,"[3, 'block 2 (G first)']",1,0,0,0.5,5.0,-0.5,0.25,0.15384615384615385,0.0,0.2,2,0.5,0.25,Design 1,Design 1,Only trade on Design #1,,3.0,3.0
1106,3033,3,Player object (1040),buy,2023-03-09 00:07:05.506305+00:00,"{""priceA"": 105, ""sharesA"": 1, ""secs_since_round_starts"": 84, ""market"": ""A""}",30.0,17.0,5.0,cj9n1uj4,vmu7c279,FULL STUDY,150.0,s1,1,105,100.0,-1,,1,sell,0,sell,0.4990675303551922,19,0,0,block 2 (G first),22.0,12.0,Female,1.0,1.0,1.0,"[3, 'block 2 (G first)']",1,0,0,0.5,5.0,-0.5,0.25,0.15384615384615385,0.0,0.2,2,0.5,0.25,Design 1,Design 1,Only trade on Design #1,,3.0,3.0
1107,3034,3,Player object (1040),sell,2023-03-09 00:07:23.334488+00:00,"{""priceA"": 115, ""sharesA"": 0, ""secs_since_round_starts"": 102, ""market"": ""A""}",145.0,20.0,6.0,cj9n1uj4,vmu7c279,FULL STUDY,150.0,s1,1,115,105.0,1,10.0,1,buy,0,sell,0.5061230669509241,19,0,0,block 2 (G first),22.0,12.0,Female,1.0,1.0,1.0,"[3, 'block 2 (G first)']",1,0,0,0.5,5.0,-0.5,0.25,0.15384615384615385,0.0,0.2,2,0.5,0.25,Design 1,Design 1,Only trade on Design #1,,3.0,3.0
1108,3035,3,Player object (1040),buy,2023-03-09 00:07:28.933552+00:00,"{""priceA"": 100, ""sharesA"": 1, ""secs_since_round_starts"": 108, ""market"": ""A""}",45.0,21.0,7.0,cj9n1uj4,vmu7c279,FULL STUDY,150.0,s1,1,100,115.0,-1,,1,sell,0,sell,0.4692484881524699,19,0,0,block 2 (G first),22.0,12.0,Female,1.0,1.0,1.0,"[3, 'block 2 (G first)']",1,0,0,0.5,5.0,-0.5,0.25,0.15384615384615385,0.0,0.2,2,0.5,0.25,Design 1,Design 1,Only trade on Design #1,,3.0,3.0
1109,3037,3,Player object (1040),sell,2023-03-09 00:08:28.789728+00:00,"{""priceA"": 110, ""sharesA"": 0, ""secs_since_round_starts"": 168, ""market"": ""A""}",155.0,32.0,8.0,cj9n1uj4,vmu7c279,FULL STUDY,150.0,s1,1,110,100.0,1,10.0,1,buy,0,sell,0.4748947710808772,19,0,0,block 2 (G first),22.0,12.0,Female,1.0,1.0,1.0,"[3, 'block 2 (G first)']",1,0,0,0.5,5.0,-0.5,0.25,0.15384615384615385,0.0,0.2,2,0.5,0.25,Design 1,Design 1,Only trade on Design #1,,3.0,3.0
1110,3038,3,Player object (1040),buy,2023-03-09 00:08:49.870263+00:00,"{""priceA"": 100, ""sharesA"": 1, ""secs_since_round_starts"": 189, ""market"": ""A""}",55.0,36.0,9.0,cj9n1uj4,vmu7c279,FULL STUDY,150.0,s1,1,100,110.0,-1,,1,sell,0,sell,0.440139794868048,19,0,0,block 2 (G first),22.0,12.0,Female,1.0,1.0,1.0,"[3, 'block 2 (G first)']",1,0,0,0.5,5.0,-0.5,0.25,0.15384615384615385,0.0,0.2,2,0.5,0.25,Design 1,Design 1,Only trade on Design #1,,3.0,3.0
1111,3039,3,Player object (1040),sell,2023-03-09 00:09:23.874318+00:00,"{""priceA"": 105, ""sharesA"": 0, ""secs_since_round_starts"": 223, ""market"": ""A""}",160.0,42.0,10.0,cj9n1uj4,vmu7c279,FULL STUDY,150.0,s1,1,105,100.0,1,5.0,1,buy,0,sell,0.5010477910686952,19,0,0,block 2 (G first),22.0,12.0,Female,1.0,1.0,1.0,"[3, 'block 2 (G first)']",1,0,0,0.5,5.0,-0.5,0.25,0.15384615384615385,0.0,0.2,2,0.5,0.25,Design 1,Design 1,Only trade on Design #1,,3.0,3.0
1112,3043,3,Player object (1040),buy,2023-03-09 00:10:13.835774+00:00,"{""priceA"": 125, ""sharesA"": 1, ""secs_since_round_starts"": 273, ""market"": ""A""}",35.0,50.0,12.0,cj9n1uj4,vmu7c279,FULL STUDY,150.0,s1,1,125,130.0,-1,,1,sell,0,sell,0.4911246412164243,19,0,0,block 2 (G first),22.0,12.0,Female,1.0,1.0,1.0,"[3, 'block 2 (G first)']",1,0,0,0.5,5.0,-0.5,0.25,0.15384615384615385,0.0,0.2,2,0.5,0.25,Design 1,Design 1,Only trade on Design #1,,3.0,3.0
1113,3044,3,Player object (1040),sell,2023-03-09 00:10:29.704395+00:00,"{""priceA"": 130, ""sharesA"": 0, ""secs_since_round_starts"": 289, ""market"": ""A""}",165.0,53.0,13.0,cj9n1uj4,vmu7c279,FULL STUDY,150.0,s1,1,130,125.0,1,5.0,1,buy,0,sell,0.4905868559773416,19,0,0,block 2 (G first),22.0,12.0,Female,1.0,1.0,1.0,"[3, 'block 2 (G first)']",1,0,0,0.5,5.0,-0.5,0.25,0.15384615384615385,0.0,0.2,2,0.5,0.25,Design 1,Design 1,Only trade on Design #1,,3.0,3.0
1114,3045,3,Player object (1040),buy,2023-03-09 00:10:51.850552+00:00,"{""priceA"": 130, ""sharesA"": 1, ""secs_since_round_starts"": 311, ""market"": ""A""}",35.0,57.0,14.0,cj9n1uj4,vmu7c279,FULL STUDY,150.0,s1,1,130,130.0,-1,,1,sell,0,sell,0.46726452652799,19,0,0,block 2 (G first),22.0,12.0,Female,1.0,1.0,1.0,"[3, 'block 2 (G first)']",1,0,0,0.5,5.0,-0.5,0.25,0.15384615384615385,0.0,0.2,2,0.5,0.25,Design 1,Design 1,Only trade on Design #1,,3.0,3.0
1115,3051,4,Player object (1160),sell,2023-03-09 00:13:39.211102+00:00,"{""priceA"": 80, ""sharesA"": 0, ""secs_since_round_starts"": 145, ""market"": ""A""}",130.0,28.0,2.0,cj9n1uj4,vmu7c279,FULL STUDY,125.0,s1,1,80,70.0,1,10.0,1,,0,sell,0.5529051331090981,14,0,1,block 2 (G first),22.0,12.0,Female,1.0,1.0,1.0,"[4, 'block 2 (G first)']",0,1,0,0.5,5.0,-0.5,0.4,0.02631578947368421,0.5,0.125,4,0.5,0.25,Design 1,Design 1,Only trade on Design #1,,3.0,3.0
1116,3053,4,Player object (1160),buy,2023-03-09 00:14:10.514154+00:00,"{""priceA"": 95, ""sharesA"": 1, ""secs_since_round_starts"": 176, ""market"": ""A""}",35.0,34.0,3.0,cj9n1uj4,vmu7c279,FULL STUDY,125.0,s1,1,95,80.0,-1,,1,sell,0,sell,0.4981543075921684,14,0,0,block 2 (G first),22.0,12.0,Female,1.0,1.0,1.0,"[4, 'block 2 (G first)']",0,1,0,0.5,5.0,-0.5,0.4,0.02631578947368421,0.5,0.125,4,0.5,0.25,Design 1,Design 1,Only trade on Design #1,,3.0,3.0
1117,3054,4,Player object (1160),sell,2023-03-09 00:15:00.828423+00:00,"{""priceA"": 100, ""sharesA"": 0, ""secs_since_round_starts"": 226, ""market"": ""A""}",135.0,43.0,4.0,cj9n1uj4,vmu7c279,FULL STUDY,125.0,s1,1,100,95.0,1,5.0,1,buy,0,sell,0.5617190733230237,14,0,1,block 2 (G first),22.0,12.0,Female,1.0,1.0,1.0,"[4, 'block 2 (G first)']",0,1,0,0.5,5.0,-0.5,0.4,0.02631578947368421,0.5,0.125,4,0.5,0.25,Design 1,Design 1,Only trade on Design #1,,3.0,3.0
1118,3055,4,Player object (1160),buy,2023-03-09 00:15:27.061182+00:00,"{""priceA"": 100, ""sharesA"": 1, ""secs_since_round_starts"": 253, ""market"": ""A""}",35.0,48.0,5.0,cj9n1uj4,vmu7c279,FULL STUDY,125.0,s1,1,100,100.0,-1,,1,sell,0,sell,0.500105737602651,14,0,0,block 2 (G first),22.0,12.0,Female,1.0,1.0,1.0,"[4, 'block 2 (G first)']",0,1,0,0.5,5.0,-0.5,0.4,0.02631578947368421,0.5,0.125,4,0.5,0.25,Design 1,Design 1,Only trade on Design #1,,3.0,3.0
1119,3056,4,Player object (1160),sell,2023-03-09 00:15:44.746084+00:00,"{""priceA"": 105, ""sharesA"": 0, ""secs_since_round_starts"": 270, ""market"": ""A""}",140.0,51.0,6.0,cj9n1uj4,vmu7c279,FULL STUDY,125.0,s1,1,105,100.0,1,5.0,1,buy,0,sell,0.5064720763559888,14,0,0,block 2 (G first),22.0,12.0,Female,1.0,1.0,1.0,"[4, 'block 2 (G first)']",0,1,0,0.5,5.0,-0.5,0.4,0.02631578947368421,0.5,0.125,4,0.5,0.25,Design 1,Design 1,Only trade on Design #1,,3.0,3.0
1120,3057,4,Player object (1160),buy,2023-03-09 00:15:49.625604+00:00,"{""priceA"": 90, ""sharesA"": 1, ""secs_since_round_starts"": 275, ""market"": ""A""}",50.0,52.0,7.0,cj9n1uj4,vmu7c279,FULL STUDY,125.0,s1,1,90,105.0,-1,,1,sell,0,sell,0.4694909620846048,14,0,0,block 2 (G first),22.0,12.0,Female,1.0,1.0,1.0,"[4, 'block 2 (G first)']",0,1,0,0.5,5.0,-0.5,0.4,0.02631578947368421,0.5,0.125,4,0.5,0.25,Design 1,Design 1,Only trade on Design #1,,3.0,3.0
1121,3061,5,Player object (1280),sell,2023-03-09 00:17:18.988776+00:00,"{""priceA"": 90, ""sharesA"": 0, ""secs_since_round_starts"": 39, ""market"": ""A""}",140.0,8.0,1.0,cj9n1uj4,vmu7c279,FULL STUDY,230.0,s1,1,90,,1,,1,,0,sell,0.5166236645513725,17,0,0,block 2 (G first),22.0,12.0,Female,1.0,1.0,1.0,"[5, 'block 2 (G first)']",0,0,0,0.5,5.0,-0.5,0.16,0.06666666666666667,0.25,0.0,4,0.5,0.25,Design 1,Design 1,Only trade on Design #1,,3.0,3.0
1122,3062,5,Player object (1280),buy,2023-03-09 00:17:26.347439+00:00,"{""priceA"": 75, ""sharesA"": 1, ""secs_since_round_starts"": 46, ""market"": ""A""}",65.0,10.0,2.0,cj9n1uj4,vmu7c279,FULL STUDY,230.0,s1,1,75,90.0,-1,,1,sell,0,sell,0.4488309348307913,17,1,0,block 2 (G first),22.0,12.0,Female,1.0,1.0,1.0,"[5, 'block 2 (G first)']",0,0,0,0.5,5.0,-0.5,0.16,0.06666666666666667,0.25,0.0,4,0.5,0.25,Design 1,Design 1,Only trade on Design #1,,3.0,3.0
1123,3065,5,Player object (1280),sell,2023-03-09 00:18:28.832391+00:00,"{""priceA"": 105, ""sharesA"": 0, ""secs_since_round_starts"": 109, ""market"": ""A""}",170.0,21.0,4.0,cj9n1uj4,vmu7c279,FULL STUDY,230.0,s1,1,105,90.0,1,15.0,1,buy,0,sell,0.5510362930796925,17,0,1,block 2 (G first),22.0,12.0,Female,1.0,1.0,1.0,"[5, 'block 2 (G first)']",0,0,0,0.5,5.0,-0.5,0.16,0.06666666666666667,0.25,0.0,4,0.5,0.25,Design 1,Design 1,Only trade on Design #1,,3.0,3.0
1124,3066,5,Player object (1280),buy,2023-03-09 00:18:38.836322+00:00,"{""priceA"": 95, ""sharesA"": 1, ""secs_since_round_starts"": 119, ""market"": ""A""}",75.0,23.0,5.0,cj9n1uj4,vmu7c279,FULL STUDY,230.0,s1,1,95,105.0,-1,,1,sell,0,sell,0.5355078155027276,17,0,0,block 2 (G first),22.0,12.0,Female,1.0,1.0,1.0,"[5, 'block 2 (G first)']",0,0,0,0.5,5.0,-0.5,0.16,0.06666666666666667,0.25,0.0,4,0.5,0.25,Design 1,Design 1,Only trade on Design #1,,3.0,3.0
1125,3067,5,Player object (1280),sell,2023-03-09 00:18:53.931889+00:00,"{""priceA"": 105, ""sharesA"": 0, ""secs_since_round_starts"": 134, ""market"": ""A""}",180.0,26.0,6.0,cj9n1uj4,vmu7c279,FULL STUDY,230.0,s1,1,105,95.0,1,10.0,1,buy,0,sell,0.5182690684964619,17,0,0,block 2 (G first),22.0,12.0,Female,1.0,1.0,1.0,"[5, 'block 2 (G first)']",0,0,0,0.5,5.0,-0.5,0.16,0.06666666666666667,0.25,0.0,4,0.5,0.25,Design 1,Design 1,Only trade on Design #1,,3.0,3.0
1126,3068,5,Player object (1280),buy,2023-03-09 00:19:10.791594+00:00,"{""priceA"": 80, ""sharesA"": 1, ""secs_since_round_starts"": 151, ""market"": ""A""}",100.0,29.0,7.0,cj9n1uj4,vmu7c279,FULL STUDY,230.0,s1,1,80,105.0,-1,,1,sell,0,sell,0.4304345659865384,17,0,0,block 2 (G first),22.0,12.0,Female,1.0,1.0,1.0,"[5, 'block 2 (G first)']",0,0,0,0.5,5.0,-0.5,0.16,0.06666666666666667,0.25,0.0,4,0.5,0.25,Design 1,Design 1,Only trade on Design #1,,3.0,3.0
1127,3070,5,Player object (1280),sell,2023-03-09 00:19:37.306548+00:00,"{""priceA"": 120, ""sharesA"": 0, ""secs_since_round_starts"": 177, ""market"": ""A""}",220.0,34.0,8.0,cj9n1uj4,vmu7c279,FULL STUDY,230.0,s1,1,120,80.0,1,40.0,1,buy,0,sell,0.5679672812132522,17,0,0,block 2 (G first),22.0,12.0,Female,1.0,1.0,1.0,"[5, 'block 2 (G first)']",0,0,0,0.5,5.0,-0.5,0.16,0.06666666666666667,0.25,0.0,4,0.5,0.25,Design 1,Design 1,Only trade on Design #1,,3.0,3.0
1128,3071,5,Player object (1280),buy,2023-03-09 00:20:04.529653+00:00,"{""priceA"": 70, ""sharesA"": 1, ""secs_since_round_starts"": 205, ""market"": ""A""}",150.0,39.0,9.0,cj9n1uj4,vmu7c279,FULL STUDY,230.0,s1,1,70,120.0,-1,,1,sell,0,sell,0.4317803147869401,17,0,0,block 2 (G first),22.0,12.0,Female,1.0,1.0,1.0,"[5, 'block 2 (G first)']",0,0,0,0.5,5.0,-0.5,0.16,0.06666666666666667,0.25,0.0,4,0.5,0.25,Design 1,Design 1,Only trade on Design #1,,3.0,3.0
1129,3072,5,Player object (1280),sell,2023-03-09 00:20:33.202307+00:00,"{""priceA"": 105, ""sharesA"": 0, ""secs_since_round_starts"": 233, ""market"": ""A""}",255.0,44.0,10.0,cj9n1uj4,vmu7c279,FULL STUDY,230.0,s1,1,105,70.0,1,35.0,1,buy,0,sell,0.515125859635568,17,0,0,block 2 (G first),22.0,12.0,Female,1.0,1.0,1.0,"[5, 'block 2 (G first)']",0,0,0,0.5,5.0,-0.5,0.16,0.06666666666666667,0.25,0.0,4,0.5,0.25,Design 1,Design 1,Only trade on Design #1,,3.0,3.0
1130,3073,5,Player object (1280),buy,2023-03-09 00:20:49.037269+00:00,"{""priceA"": 90, ""sharesA"": 1, ""secs_since_round_starts"": 249, ""market"": ""A""}",165.0,47.0,11.0,cj9n1uj4,vmu7c279,FULL STUDY,230.0,s1,1,90,105.0,-1,,1,sell,0,sell,0.4627742743797309,17,0,0,block 2 (G first),22.0,12.0,Female,1.0,1.0,1.0,"[5, 'block 2 (G first)']",0,0,0,0.5,5.0,-0.5,0.16,0.06666666666666667,0.25,0.0,4,0.5,0.25,Design 1,Design 1,Only trade on Design #1,,3.0,3.0
1131,2148,2,Player object (908),sell,2023-03-08 04:13:01.451507+00:00,"{""priceA"": 130, ""sharesA"": 0, ""secs_since_round_starts"": 111, ""market"": ""A""}",180.0,19.0,1.0,dhiqzueo,vmu7c279,FULL STUDY,210.0,s1,1,130,,1,,1,,0,sell,0.5813773703663461,16,0,1,block 4 (G second),21.0,11.0,Male,1.0,1.0,1.0,"[2, 'block 4 (G second)']",0,1,1,0.5,7.0,-0.21666666666666667,0.07692307692307693,0.0,0.25,0.0,4,1.0,0.5,Design 2,Design 1,"Have an option between Design #1 and Design #2,",,5.0,4.0
1132,2155,2,Player object (908),buy,2023-03-08 04:13:45.350936+00:00,"{""priceA"": 125, ""sharesA"": 1, ""secs_since_round_starts"": 155, ""market"": ""A""}",55.0,27.0,2.0,dhiqzueo,vmu7c279,FULL STUDY,210.0,s1,1,125,130.0,-1,,1,sell,0,sell,0.4549942201992644,16,1,0,block 4 (G second),21.0,11.0,Male,1.0,1.0,1.0,"[2, 'block 4 (G second)']",0,1,1,0.5,7.0,-0.21666666666666667,0.07692307692307693,0.0,0.25,0.0,4,1.0,0.5,Design 2,Design 1,"Have an option between Design #1 and Design #2,",,5.0,4.0
1133,2179,2,Player object (908),sell,2023-03-08 04:15:45.839835+00:00,"{""priceA"": 155, ""sharesA"": 0, ""secs_since_round_starts"": 275, ""market"": ""A""}",210.0,48.0,3.0,dhiqzueo,vmu7c279,FULL STUDY,210.0,s1,1,155,125.0,1,30.0,1,buy,0,sell,0.5347792584548927,16,0,0,block 4 (G second),21.0,11.0,Male,1.0,1.0,1.0,"[2, 'block 4 (G second)']",0,1,1,0.5,7.0,-0.21666666666666667,0.07692307692307693,0.0,0.25,0.0,4,1.0,0.5,Design 2,Design 1,"Have an option between Design #1 and Design #2,",,5.0,4.0
1134,2185,2,Player object (908),buy,2023-03-08 04:16:06.924774+00:00,"{""priceA"": 125, ""sharesA"": 1, ""secs_since_round_starts"": 296, ""market"": ""A""}",85.0,52.0,4.0,dhiqzueo,vmu7c279,FULL STUDY,210.0,s1,1,125,155.0,-1,,1,sell,0,sell,0.4439176376077041,16,1,0,block 4 (G second),21.0,11.0,Male,1.0,1.0,1.0,"[2, 'block 4 (G second)']",0,1,1,0.5,7.0,-0.21666666666666667,0.07692307692307693,0.0,0.25,0.0,4,1.0,0.5,Design 2,Design 1,"Have an option between Design #1 and Design #2,",,5.0,4.0
1135,2207,3,Player object (1028),sell,2023-03-08 04:18:06.696251+00:00,"{""priceA"": 130, ""sharesA"": 0, ""secs_since_round_starts"": 67, ""market"": ""A""}",180.0,13.0,1.0,dhiqzueo,vmu7c279,FULL STUDY,210.0,s1,1,130,,1,,1,,0,sell,0.5729625045047859,19,0,1,block 4 (G second),21.0,11.0,Male,1.0,1.0,1.0,"[3, 'block 4 (G second)']",0,0,1,0.5,7.0,-0.21666666666666667,0.15,0.0,0.6666666666666666,0.0,2,0.5,0.75,Design 2,Design 1,"Have an option between Design #1 and Design #2,",,5.0,4.0
1136,2209,3,Player object (1028),buy,2023-03-08 04:18:24.553253+00:00,"{""priceA"": 100, ""sharesA"": 1, ""secs_since_round_starts"": 85, ""market"": ""A""}",80.0,16.0,2.0,dhiqzueo,vmu7c279,FULL STUDY,210.0,s1,1,100,130.0,-1,,1,sell,0,sell,0.4486815727575955,19,1,0,block 4 (G second),21.0,11.0,Male,1.0,1.0,1.0,"[3, 'block 4 (G second)']",0,0,1,0.5,7.0,-0.21666666666666667,0.15,0.0,0.6666666666666666,0.0,2,0.5,0.75,Design 2,Design 1,"Have an option between Design #1 and Design #2,",,5.0,4.0
1137,2223,3,Player object (1028),sell,2023-03-08 04:19:40.062485+00:00,"{""priceA"": 120, ""sharesA"": 0, ""secs_since_round_starts"": 160, ""market"": ""A""}",200.0,30.0,3.0,dhiqzueo,vmu7c279,FULL STUDY,210.0,s1,1,120,100.0,1,20.0,1,buy,0,sell,0.570054331362491,19,0,1,block 4 (G second),21.0,11.0,Male,1.0,1.0,1.0,"[3, 'block 4 (G second)']",0,0,1,0.5,7.0,-0.21666666666666667,0.15,0.0,0.6666666666666666,0.0,2,0.5,0.75,Design 2,Design 1,"Have an option between Design #1 and Design #2,",,5.0,4.0
1138,2227,3,Player object (1028),buy,2023-03-08 04:20:01.753348+00:00,"{""priceA"": 100, ""sharesA"": 1, ""secs_since_round_starts"": 182, ""market"": ""A""}",100.0,33.0,4.0,dhiqzueo,vmu7c279,FULL STUDY,210.0,s1,1,100,120.0,-1,,1,sell,0,sell,0.4476889957041811,19,1,0,block 4 (G second),21.0,11.0,Male,1.0,1.0,1.0,"[3, 'block 4 (G second)']",0,0,1,0.5,7.0,-0.21666666666666667,0.15,0.0,0.6666666666666666,0.0,2,0.5,0.75,Design 2,Design 1,"Have an option between Design #1 and Design #2,",,5.0,4.0
1139,2229,3,Player object (1028),sell,2023-03-08 04:20:56.552611+00:00,"{""priceA"": 120, ""sharesA"": 0, ""secs_since_round_starts"": 237, ""market"": ""A""}",220.0,43.0,5.0,dhiqzueo,vmu7c279,FULL STUDY,210.0,s1,1,120,100.0,1,20.0,1,buy,0,sell,0.5357259670782416,19,0,0,block 4 (G second),21.0,11.0,Male,1.0,1.0,1.0,"[3, 'block 4 (G second)']",0,0,1,0.5,7.0,-0.21666666666666667,0.15,0.0,0.6666666666666666,0.0,2,0.5,0.75,Design 2,Design 1,"Have an option between Design #1 and Design #2,",,5.0,4.0
1140,2238,3,Player object (1028),buy,2023-03-08 04:22:24.231496+00:00,"{""priceA"": 125, ""sharesA"": 1, ""secs_since_round_starts"": 325, ""market"": ""A""}",95.0,59.0,6.0,dhiqzueo,vmu7c279,FULL STUDY,210.0,s1,1,125,120.0,-1,,1,sell,0,sell,0.4946618842475483,19,0,0,block 4 (G second),21.0,11.0,Male,1.0,1.0,1.0,"[3, 'block 4 (G second)']",0,0,1,0.5,7.0,-0.21666666666666667,0.15,0.0,0.6666666666666666,0.0,2,0.5,0.75,Design 2,Design 1,"Have an option between Design #1 and Design #2,",,5.0,4.0
1141,2719,2,Player object (915),sell,2023-03-08 17:10:02.636015+00:00,"{""priceA"": 105, ""sharesA"": 0, ""secs_since_round_starts"": 72, ""market"": ""A""}",155.0,14.0,1.0,fcp9s0do,vmu7c279,FULL STUDY,165.0,s2,1,105,,1,,1,,0,sell,0.5600744319669811,16,0,1,block 1 (G first),21.0,11.0,Male,1.0,1.0,1.0,"[2, 'block 1 (G first)']",1,0,0,0.5,5.0,-0.41666666666666663,0.5,0.058823529411764705,1.0,0.0,2,0.5,0.75,Design 2,Design 2,"Have an option between Design #1 and Design #2,",5.0,,
1142,2720,2,Player object (915),buy,2023-03-08 17:11:05.662431+00:00,"{""priceA"": 145, ""sharesA"": 1, ""secs_since_round_starts"": 135, ""market"": ""A""}",10.0,25.0,2.0,fcp9s0do,vmu7c279,FULL STUDY,165.0,s2,1,145,105.0,-1,,1,sell,0,sell,0.5294358264188312,16,0,0,block 1 (G first),21.0,11.0,Male,1.0,1.0,1.0,"[2, 'block 1 (G first)']",1,0,0,0.5,5.0,-0.41666666666666663,0.5,0.058823529411764705,1.0,0.0,2,0.5,0.75,Design 2,Design 2,"Have an option between Design #1 and Design #2,",5.0,,
1143,2721,2,Player object (915),sell,2023-03-08 17:11:21.052206+00:00,"{""priceA"": 120, ""sharesA"": 0, ""secs_since_round_starts"": 151, ""market"": ""A""}",130.0,28.0,3.0,fcp9s0do,vmu7c279,FULL STUDY,165.0,s2,1,120,145.0,1,-25.0,1,buy,0,sell,0.4340892272841542,16,0,0,block 1 (G first),21.0,11.0,Male,1.0,1.0,1.0,"[2, 'block 1 (G first)']",1,0,0,0.5,5.0,-0.41666666666666663,0.5,0.058823529411764705,1.0,0.0,2,0.5,0.75,Design 2,Design 2,"Have an option between Design #1 and Design #2,",5.0,,
1144,2722,2,Player object (915),buy,2023-03-08 17:11:24.132746+00:00,"{""priceA"": 115, ""sharesA"": 1, ""secs_since_round_starts"": 154, ""market"": ""A""}",15.0,29.0,4.0,fcp9s0do,vmu7c279,FULL STUDY,165.0,s2,1,115,120.0,-1,,1,sell,0,sell,0.41991811093665,16,0,0,block 1 (G first),21.0,11.0,Male,1.0,1.0,1.0,"[2, 'block 1 (G first)']",1,0,0,0.5,5.0,-0.41666666666666663,0.5,0.058823529411764705,1.0,0.0,2,0.5,0.75,Design 2,Design 2,"Have an option between Design #1 and Design #2,",5.0,,
1145,2723,2,Player object (915),sell,2023-03-08 17:11:30.826377+00:00,"{""priceA"": 125, ""sharesA"": 0, ""secs_since_round_starts"": 161, ""market"": ""A""}",140.0,30.0,5.0,fcp9s0do,vmu7c279,FULL STUDY,165.0,s2,1,125,115.0,1,10.0,1,buy,0,sell,0.4785999259850118,16,0,0,block 1 (G first),21.0,11.0,Male,1.0,1.0,1.0,"[2, 'block 1 (G first)']",1,0,0,0.5,5.0,-0.41666666666666663,0.5,0.058823529411764705,1.0,0.0,2,0.5,0.75,Design 2,Design 2,"Have an option between Design #1 and Design #2,",5.0,,
1146,2725,2,Player object (915),buy,2023-03-08 17:12:14.609603+00:00,"{""priceA"": 140, ""sharesA"": 1, ""secs_since_round_starts"": 204, ""market"": ""A""}",,38.0,6.0,fcp9s0do,vmu7c279,FULL STUDY,165.0,s2,1,140,125.0,-1,,1,sell,0,sell,0.4611129934091434,16,0,0,block 1 (G first),21.0,11.0,Male,1.0,1.0,1.0,"[2, 'block 1 (G first)']",1,0,0,0.5,5.0,-0.41666666666666663,0.5,0.058823529411764705,1.0,0.0,2,0.5,0.75,Design 2,Design 2,"Have an option between Design #1 and Design #2,",5.0,,
1147,2726,2,Player object (915),sell,2023-03-08 17:12:59.205106+00:00,"{""priceA"": 155, ""sharesA"": 0, ""secs_since_round_starts"": 249, ""market"": ""A""}",155.0,46.0,7.0,fcp9s0do,vmu7c279,FULL STUDY,165.0,s2,1,155,140.0,1,15.0,1,buy,0,sell,0.5495494947508355,16,0,1,block 1 (G first),21.0,11.0,Male,1.0,1.0,1.0,"[2, 'block 1 (G first)']",1,0,0,0.5,5.0,-0.41666666666666663,0.5,0.058823529411764705,1.0,0.0,2,0.5,0.75,Design 2,Design 2,"Have an option between Design #1 and Design #2,",5.0,,
1148,2727,2,Player object (915),buy,2023-03-08 17:13:31.422555+00:00,"{""priceA"": 125, ""sharesA"": 1, ""secs_since_round_starts"": 281, ""market"": ""A""}",30.0,52.0,8.0,fcp9s0do,vmu7c279,FULL STUDY,165.0,s2,1,125,155.0,-1,,1,sell,0,sell,0.4439176376077041,16,1,0,block 1 (G first),21.0,11.0,Male,1.0,1.0,1.0,"[2, 'block 1 (G first)']",1,0,0,0.5,5.0,-0.41666666666666663,0.5,0.058823529411764705,1.0,0.0,2,0.5,0.75,Design 2,Design 2,"Have an option between Design #1 and Design #2,",5.0,,
1149,2728,2,Player object (915),sell,2023-03-08 17:13:49.227207+00:00,"{""priceA"": 135, ""sharesA"": 0, ""secs_since_round_starts"": 299, ""market"": ""A""}",165.0,55.0,9.0,fcp9s0do,vmu7c279,FULL STUDY,165.0,s2,1,135,125.0,1,10.0,1,buy,0,sell,0.4873282494519479,16,0,0,block 1 (G first),21.0,11.0,Male,1.0,1.0,1.0,"[2, 'block 1 (G first)']",1,0,0,0.5,5.0,-0.41666666666666663,0.5,0.058823529411764705,1.0,0.0,2,0.5,0.75,Design 2,Design 2,"Have an option between Design #1 and Design #2,",5.0,,
1150,2729,2,Player object (915),buy,2023-03-08 17:13:53.526914+00:00,"{""priceA"": 125, ""sharesA"": 1, ""secs_since_round_starts"": 303, ""market"": ""A""}",40.0,56.0,10.0,fcp9s0do,vmu7c279,FULL STUDY,165.0,s2,1,125,135.0,-1,,1,sell,0,sell,0.4562406760637778,16,0,0,block 1 (G first),21.0,11.0,Male,1.0,1.0,1.0,"[2, 'block 1 (G first)']",1,0,0,0.5,5.0,-0.41666666666666663,0.5,0.058823529411764705,1.0,0.0,2,0.5,0.75,Design 2,Design 2,"Have an option between Design #1 and Design #2,",5.0,,
1151,2730,2,Player object (915),sell,2023-03-08 17:14:16.614571+00:00,"{""priceA"": 125, ""sharesA"": 0, ""secs_since_round_starts"": 326, ""market"": ""A""}",165.0,60.0,11.0,fcp9s0do,vmu7c279,FULL STUDY,165.0,s2,1,125,125.0,1,0.0,1,buy,0,sell,0.5540089061739091,16,0,1,block 1 (G first),21.0,11.0,Male,1.0,1.0,1.0,"[2, 'block 1 (G first)']",1,0,0,0.5,5.0,-0.41666666666666663,0.5,0.058823529411764705,1.0,0.0,2,0.5,0.75,Design 2,Design 2,"Have an option between Design #1 and Design #2,",5.0,,
1152,2734,3,Player object (1035),sell,2023-03-08 17:15:05.906272+00:00,"{""priceA"": 110, ""sharesA"": 0, ""secs_since_round_starts"": 43, ""market"": ""A""}",160.0,9.0,1.0,fcp9s0do,vmu7c279,FULL STUDY,210.0,s2,1,110,,1,,1,,0,sell,0.5389563723055646,19,0,0,block 1 (G first),21.0,11.0,Male,1.0,1.0,1.0,"[3, 'block 1 (G first)']",1,1,0,0.5,5.0,-0.41666666666666663,1.0,0.09090909090909091,,0.0,2,0.5,1.0,Design 2,Design 2,"Have an option between Design #1 and Design #2,",5.0,,
1153,2735,3,Player object (1035),buy,2023-03-08 17:15:12.523149+00:00,"{""priceA"": 95, ""sharesA"": 1, ""secs_since_round_starts"": 49, ""market"": ""A""}",65.0,10.0,2.0,fcp9s0do,vmu7c279,FULL STUDY,210.0,s2,1,95,110.0,-1,,1,sell,0,sell,0.4922087569005138,19,0,0,block 1 (G first),21.0,11.0,Male,1.0,1.0,1.0,"[3, 'block 1 (G first)']",1,1,0,0.5,5.0,-0.41666666666666663,1.0,0.09090909090909091,,0.0,2,0.5,1.0,Design 2,Design 2,"Have an option between Design #1 and Design #2,",5.0,,
1154,2736,3,Player object (1035),sell,2023-03-08 17:15:17.873574+00:00,"{""priceA"": 110, ""sharesA"": 0, ""secs_since_round_starts"": 55, ""market"": ""A""}",175.0,11.0,3.0,fcp9s0do,vmu7c279,FULL STUDY,210.0,s2,1,110,95.0,1,15.0,1,buy,0,sell,0.5295922419004607,19,0,0,block 1 (G first),21.0,11.0,Male,1.0,1.0,1.0,"[3, 'block 1 (G first)']",1,1,0,0.5,5.0,-0.41666666666666663,1.0,0.09090909090909091,,0.0,2,0.5,1.0,Design 2,Design 2,"Have an option between Design #1 and Design #2,",5.0,,
1155,2737,3,Player object (1035),buy,2023-03-08 17:15:39.818933+00:00,"{""priceA"": 110, ""sharesA"": 1, ""secs_since_round_starts"": 77, ""market"": ""A""}",65.0,15.0,4.0,fcp9s0do,vmu7c279,FULL STUDY,210.0,s2,1,110,110.0,-1,,1,sell,0,sell,0.4763410641166328,19,0,0,block 1 (G first),21.0,11.0,Male,1.0,1.0,1.0,"[3, 'block 1 (G first)']",1,1,0,0.5,5.0,-0.41666666666666663,1.0,0.09090909090909091,,0.0,2,0.5,1.0,Design 2,Design 2,"Have an option between Design #1 and Design #2,",5.0,,
1156,2738,3,Player object (1035),sell,2023-03-08 17:15:58.777679+00:00,"{""priceA"": 110, ""sharesA"": 0, ""secs_since_round_starts"": 96, ""market"": ""A""}",175.0,18.0,5.0,fcp9s0do,vmu7c279,FULL STUDY,210.0,s2,1,110,110.0,1,0.0,1,buy,0,sell,0.5343536780010194,19,0,0,block 1 (G first),21.0,11.0,Male,1.0,1.0,1.0,"[3, 'block 1 (G first)']",1,1,0,0.5,5.0,-0.41666666666666663,1.0,0.09090909090909091,,0.0,2,0.5,1.0,Design 2,Design 2,"Have an option between Design #1 and Design #2,",5.0,,
1157,2739,3,Player object (1035),buy,2023-03-08 17:16:15.157093+00:00,"{""priceA"": 100, ""sharesA"": 1, ""secs_since_round_starts"": 112, ""market"": ""A""}",75.0,21.0,6.0,fcp9s0do,vmu7c279,FULL STUDY,210.0,s2,1,100,110.0,-1,,1,sell,0,sell,0.4692484881524699,19,0,0,block 1 (G first),21.0,11.0,Male,1.0,1.0,1.0,"[3, 'block 1 (G first)']",1,1,0,0.5,5.0,-0.41666666666666663,1.0,0.09090909090909091,,0.0,2,0.5,1.0,Design 2,Design 2,"Have an option between Design #1 and Design #2,",5.0,,
1158,2740,3,Player object (1035),sell,2023-03-08 17:16:31.651757+00:00,"{""priceA"": 115, ""sharesA"": 0, ""secs_since_round_starts"": 128, ""market"": ""A""}",190.0,24.0,7.0,fcp9s0do,vmu7c279,FULL STUDY,210.0,s2,1,115,100.0,1,15.0,1,buy,0,sell,0.5319650978870379,19,0,0,block 1 (G first),21.0,11.0,Male,1.0,1.0,1.0,"[3, 'block 1 (G first)']",1,1,0,0.5,5.0,-0.41666666666666663,1.0,0.09090909090909091,,0.0,2,0.5,1.0,Design 2,Design 2,"Have an option between Design #1 and Design #2,",5.0,,
1159,2741,3,Player object (1035),buy,2023-03-08 17:16:41.626877+00:00,"{""priceA"": 115, ""sharesA"": 1, ""secs_since_round_starts"": 138, ""market"": ""A""}",75.0,26.0,8.0,fcp9s0do,vmu7c279,FULL STUDY,210.0,s2,1,115,115.0,-1,,1,sell,0,sell,0.526172546586359,19,0,0,block 1 (G first),21.0,11.0,Male,1.0,1.0,1.0,"[3, 'block 1 (G first)']",1,1,0,0.5,5.0,-0.41666666666666663,1.0,0.09090909090909091,,0.0,2,0.5,1.0,Design 2,Design 2,"Have an option between Design #1 and Design #2,",5.0,,
1160,2742,3,Player object (1035),sell,2023-03-08 17:16:49.503337+00:00,"{""priceA"": 105, ""sharesA"": 0, ""secs_since_round_starts"": 146, ""market"": ""A""}",180.0,27.0,9.0,fcp9s0do,vmu7c279,FULL STUDY,210.0,s2,1,105,115.0,1,-10.0,1,buy,0,sell,0.4832330156747784,19,0,0,block 1 (G first),21.0,11.0,Male,1.0,1.0,1.0,"[3, 'block 1 (G first)']",1,1,0,0.5,5.0,-0.41666666666666663,1.0,0.09090909090909091,,0.0,2,0.5,1.0,Design 2,Design 2,"Have an option between Design #1 and Design #2,",5.0,,
1161,2743,3,Player object (1035),buy,2023-03-08 17:16:51.648323+00:00,"{""priceA"": 110, ""sharesA"": 1, ""secs_since_round_starts"": 148, ""market"": ""A""}",70.0,28.0,10.0,fcp9s0do,vmu7c279,FULL STUDY,210.0,s2,1,110,105.0,-1,,1,sell,0,sell,0.5233413838959273,19,0,0,block 1 (G first),21.0,11.0,Male,1.0,1.0,1.0,"[3, 'block 1 (G first)']",1,1,0,0.5,5.0,-0.41666666666666663,1.0,0.09090909090909091,,0.0,2,0.5,1.0,Design 2,Design 2,"Have an option between Design #1 and Design #2,",5.0,,
1162,2744,3,Player object (1035),sell,2023-03-08 17:16:56.269919+00:00,"{""priceA"": 115, ""sharesA"": 0, ""secs_since_round_starts"": 153, ""market"": ""A""}",185.0,29.0,11.0,fcp9s0do,vmu7c279,FULL STUDY,210.0,s2,1,115,110.0,1,5.0,1,buy,0,sell,0.5511004178331719,19,0,0,block 1 (G first),21.0,11.0,Male,1.0,1.0,1.0,"[3, 'block 1 (G first)']",1,1,0,0.5,5.0,-0.41666666666666663,1.0,0.09090909090909091,,0.0,2,0.5,1.0,Design 2,Design 2,"Have an option between Design #1 and Design #2,",5.0,,
1163,2746,3,Player object (1035),buy,2023-03-08 17:17:30.810035+00:00,"{""priceA"": 110, ""sharesA"": 1, ""secs_since_round_starts"": 188, ""market"": ""A""}",75.0,34.0,12.0,fcp9s0do,vmu7c279,FULL STUDY,210.0,s2,1,110,115.0,-1,,1,sell,0,sell,0.4983651933170437,19,0,0,block 1 (G first),21.0,11.0,Male,1.0,1.0,1.0,"[3, 'block 1 (G first)']",1,1,0,0.5,5.0,-0.41666666666666663,1.0,0.09090909090909091,,0.0,2,0.5,1.0,Design 2,Design 2,"Have an option between Design #1 and Design #2,",5.0,,
1164,2747,3,Player object (1035),sell,2023-03-08 17:17:57.133480+00:00,"{""priceA"": 115, ""sharesA"": 0, ""secs_since_round_starts"": 214, ""market"": ""A""}",190.0,39.0,13.0,fcp9s0do,vmu7c279,FULL STUDY,210.0,s2,1,115,110.0,1,5.0,1,buy,0,sell,0.5221490272476892,19,0,0,block 1 (G first),21.0,11.0,Male,1.0,1.0,1.0,"[3, 'block 1 (G first)']",1,1,0,0.5,5.0,-0.41666666666666663,1.0,0.09090909090909091,,0.0,2,0.5,1.0,Design 2,Design 2,"Have an option between Design #1 and Design #2,",5.0,,
1165,2748,3,Player object (1035),buy,2023-03-08 17:18:08.978331+00:00,"{""priceA"": 95, ""sharesA"": 1, ""secs_since_round_starts"": 226, ""market"": ""A""}",95.0,41.0,14.0,fcp9s0do,vmu7c279,FULL STUDY,210.0,s2,1,95,115.0,-1,,1,sell,0,sell,0.4514823197003955,19,0,0,block 1 (G first),21.0,11.0,Male,1.0,1.0,1.0,"[3, 'block 1 (G first)']",1,1,0,0.5,5.0,-0.41666666666666663,1.0,0.09090909090909091,,0.0,2,0.5,1.0,Design 2,Design 2,"Have an option between Design #1 and Design #2,",5.0,,
1166,2749,3,Player object (1035),sell,2023-03-08 17:18:11.649494+00:00,"{""priceA"": 105, ""sharesA"": 0, ""secs_since_round_starts"": 228, ""market"": ""A""}",200.0,42.0,15.0,fcp9s0do,vmu7c279,FULL STUDY,210.0,s2,1,105,95.0,1,10.0,1,buy,0,sell,0.5010477910686952,19,0,0,block 1 (G first),21.0,11.0,Male,1.0,1.0,1.0,"[3, 'block 1 (G first)']",1,1,0,0.5,5.0,-0.41666666666666663,1.0,0.09090909090909091,,0.0,2,0.5,1.0,Design 2,Design 2,"Have an option between Design #1 and Design #2,",5.0,,
1167,2750,3,Player object (1035),buy,2023-03-08 17:19:41.367494+00:00,"{""priceA"": 115, ""sharesA"": 1, ""secs_since_round_starts"": 318, ""market"": ""A""}",85.0,58.0,16.0,fcp9s0do,vmu7c279,FULL STUDY,210.0,s2,1,115,105.0,-1,,1,sell,0,sell,0.442461876115205,19,1,0,block 1 (G first),21.0,11.0,Male,1.0,1.0,1.0,"[3, 'block 1 (G first)']",1,1,0,0.5,5.0,-0.41666666666666663,1.0,0.09090909090909091,,0.0,2,0.5,1.0,Design 2,Design 2,"Have an option between Design #1 and Design #2,",5.0,,
1168,2751,3,Player object (1035),sell,2023-03-08 17:19:45.440432+00:00,"{""priceA"": 125, ""sharesA"": 0, ""secs_since_round_starts"": 322, ""market"": ""A""}",210.0,59.0,17.0,fcp9s0do,vmu7c279,FULL STUDY,210.0,s2,1,125,115.0,1,10.0,1,buy,0,sell,0.4946618842475483,19,0,0,block 1 (G first),21.0,11.0,Male,1.0,1.0,1.0,"[3, 'block 1 (G first)']",1,1,0,0.5,5.0,-0.41666666666666663,1.0,0.09090909090909091,,0.0,2,0.5,1.0,Design 2,Design 2,"Have an option between Design #1 and Design #2,",5.0,,
1169,2755,4,Player object (1155),sell,2023-03-08 17:20:40.062447+00:00,"{""priceA"": 70, ""sharesA"": 0, ""secs_since_round_starts"": 42, ""market"": ""A""}",120.0,9.0,1.0,fcp9s0do,vmu7c279,FULL STUDY,125.0,s2,1,70,,1,,1,,0,sell,0.5440818519127735,14,0,1,block 1 (G first),21.0,11.0,Male,1.0,1.0,1.0,"[4, 'block 1 (G first)']",0,0,0,1.0,5.0,-0.41666666666666663,0.2857142857142857,0.3125,1.0,0.5,2,1.0,0.75,Design 2,Design 2,"Have an option between Design #1 and Design #2,",5.0,,
1170,2756,4,Player object (1155),buy,2023-03-08 17:21:30.664714+00:00,"{""priceA"": 70, ""sharesA"": 1, ""secs_since_round_starts"": 92, ""market"": ""A""}",50.0,18.0,2.0,fcp9s0do,vmu7c279,FULL STUDY,125.0,s2,1,70,70.0,-1,,1,sell,0,sell,0.4407118028401492,14,1,0,block 1 (G first),21.0,11.0,Male,1.0,1.0,1.0,"[4, 'block 1 (G first)']",0,0,0,1.0,5.0,-0.41666666666666663,0.2857142857142857,0.3125,1.0,0.5,2,1.0,0.75,Design 2,Design 2,"Have an option between Design #1 and Design #2,",5.0,,
1171,2757,4,Player object (1155),sell,2023-03-08 17:22:19.003566+00:00,"{""priceA"": 65, ""sharesA"": 0, ""secs_since_round_starts"": 141, ""market"": ""A""}",115.0,27.0,3.0,fcp9s0do,vmu7c279,FULL STUDY,125.0,s2,1,65,70.0,1,-5.0,1,buy,0,sell,0.5259713378953906,14,0,0,block 1 (G first),21.0,11.0,Male,1.0,1.0,1.0,"[4, 'block 1 (G first)']",0,0,0,1.0,5.0,-0.41666666666666663,0.2857142857142857,0.3125,1.0,0.5,2,1.0,0.75,Design 2,Design 2,"Have an option between Design #1 and Design #2,",5.0,,
1172,2759,4,Player object (1155),buy,2023-03-08 17:23:49.321641+00:00,"{""priceA"": 100, ""sharesA"": 1, ""secs_since_round_starts"": 231, ""market"": ""A""}",15.0,33.0,4.0,fcp9s0do,vmu7c279,FULL STUDY,125.0,s2,1,100,65.0,-1,,1,sell,0,sell,0.5473882863317556,14,0,0,block 1 (G first),21.0,11.0,Male,1.0,1.0,1.0,"[4, 'block 1 (G first)']",0,0,0,1.0,5.0,-0.41666666666666663,0.2857142857142857,0.3125,1.0,0.5,2,1.0,0.75,Design 2,Design 2,"Have an option between Design #1 and Design #2,",5.0,,
1173,2760,4,Player object (1155),sell,2023-03-08 17:23:56.317699+00:00,"{""priceA"": 95, ""sharesA"": 0, ""secs_since_round_starts"": 238, ""market"": ""A""}",110.0,34.0,5.0,fcp9s0do,vmu7c279,FULL STUDY,125.0,s2,1,95,100.0,1,-5.0,1,buy,0,sell,0.4981543075921684,14,0,0,block 1 (G first),21.0,11.0,Male,1.0,1.0,1.0,"[4, 'block 1 (G first)']",0,0,0,1.0,5.0,-0.41666666666666663,0.2857142857142857,0.3125,1.0,0.5,2,1.0,0.75,Design 2,Design 2,"Have an option between Design #1 and Design #2,",5.0,,
1174,2761,4,Player object (1155),buy,2023-03-08 17:24:01.775859+00:00,"{""priceA"": 100, ""sharesA"": 1, ""secs_since_round_starts"": 243, ""market"": ""A""}",10.0,35.0,6.0,fcp9s0do,vmu7c279,FULL STUDY,125.0,s2,1,100,95.0,-1,,1,sell,0,sell,0.5337204628349665,14,0,0,block 1 (G first),21.0,11.0,Male,1.0,1.0,1.0,"[4, 'block 1 (G first)']",0,0,0,1.0,5.0,-0.41666666666666663,0.2857142857142857,0.3125,1.0,0.5,2,1.0,0.75,Design 2,Design 2,"Have an option between Design #1 and Design #2,",5.0,,
1175,2762,4,Player object (1155),sell,2023-03-08 17:24:06.854034+00:00,"{""priceA"": 85, ""sharesA"": 0, ""secs_since_round_starts"": 248, ""market"": ""A""}",95.0,36.0,7.0,fcp9s0do,vmu7c279,FULL STUDY,125.0,s2,1,85,100.0,1,-15.0,1,buy,0,sell,0.4885269486642424,14,0,0,block 1 (G first),21.0,11.0,Male,1.0,1.0,1.0,"[4, 'block 1 (G first)']",0,0,0,1.0,5.0,-0.41666666666666663,0.2857142857142857,0.3125,1.0,0.5,2,1.0,0.75,Design 2,Design 2,"Have an option between Design #1 and Design #2,",5.0,,
1176,2763,4,Player object (1155),buy,2023-03-08 17:24:20.498924+00:00,"{""priceA"": 65, ""sharesA"": 1, ""secs_since_round_starts"": 262, ""market"": ""A""}",30.0,38.0,8.0,fcp9s0do,vmu7c279,FULL STUDY,125.0,s2,1,65,85.0,-1,,1,sell,0,sell,0.4355009867455686,14,1,0,block 1 (G first),21.0,11.0,Male,1.0,1.0,1.0,"[4, 'block 1 (G first)']",0,0,0,1.0,5.0,-0.41666666666666663,0.2857142857142857,0.3125,1.0,0.5,2,1.0,0.75,Design 2,Design 2,"Have an option between Design #1 and Design #2,",5.0,,
1177,2764,4,Player object (1155),sell,2023-03-08 17:24:42.592832+00:00,"{""priceA"": 95, ""sharesA"": 0, ""secs_since_round_starts"": 284, ""market"": ""A""}",125.0,42.0,9.0,fcp9s0do,vmu7c279,FULL STUDY,125.0,s2,1,95,65.0,1,30.0,1,buy,0,sell,0.5388552795609507,14,0,0,block 1 (G first),21.0,11.0,Male,1.0,1.0,1.0,"[4, 'block 1 (G first)']",0,0,0,1.0,5.0,-0.41666666666666663,0.2857142857142857,0.3125,1.0,0.5,2,1.0,0.75,Design 2,Design 2,"Have an option between Design #1 and Design #2,",5.0,,
1178,2765,4,Player object (1155),buy,2023-03-08 17:25:13.141363+00:00,"{""priceA"": 100, ""sharesA"": 1, ""secs_since_round_starts"": 315, ""market"": ""A""}",25.0,48.0,10.0,fcp9s0do,vmu7c279,FULL STUDY,125.0,s2,1,100,95.0,-1,,1,sell,0,sell,0.500105737602651,14,0,0,block 1 (G first),21.0,11.0,Male,1.0,1.0,1.0,"[4, 'block 1 (G first)']",0,0,0,1.0,5.0,-0.41666666666666663,0.2857142857142857,0.3125,1.0,0.5,2,1.0,0.75,Design 2,Design 2,"Have an option between Design #1 and Design #2,",5.0,,
1179,2766,4,Player object (1155),sell,2023-03-08 17:25:23.045474+00:00,"{""priceA"": 120, ""sharesA"": 0, ""secs_since_round_starts"": 325, ""market"": ""A""}",145.0,50.0,11.0,fcp9s0do,vmu7c279,FULL STUDY,125.0,s2,1,120,100.0,1,20.0,1,buy,0,sell,0.5591364702939366,14,0,1,block 1 (G first),21.0,11.0,Male,1.0,1.0,1.0,"[4, 'block 1 (G first)']",0,0,0,1.0,5.0,-0.41666666666666663,0.2857142857142857,0.3125,1.0,0.5,2,1.0,0.75,Design 2,Design 2,"Have an option between Design #1 and Design #2,",5.0,,
1180,2767,4,Player object (1155),buy,2023-03-08 17:25:46.874330+00:00,"{""priceA"": 85, ""sharesA"": 1, ""secs_since_round_starts"": 348, ""market"": ""A""}",60.0,54.0,12.0,fcp9s0do,vmu7c279,FULL STUDY,125.0,s2,1,85,120.0,-1,,1,sell,0,sell,0.4957421237757241,14,0,0,block 1 (G first),21.0,11.0,Male,1.0,1.0,1.0,"[4, 'block 1 (G first)']",0,0,0,1.0,5.0,-0.41666666666666663,0.2857142857142857,0.3125,1.0,0.5,2,1.0,0.75,Design 2,Design 2,"Have an option between Design #1 and Design #2,",5.0,,
1181,2768,4,Player object (1155),sell,2023-03-08 17:25:58.043547+00:00,"{""priceA"": 65, ""sharesA"": 0, ""secs_since_round_starts"": 360, ""market"": ""A""}",125.0,56.0,13.0,fcp9s0do,vmu7c279,FULL STUDY,125.0,s2,1,65,85.0,1,-20.0,1,buy,0,sell,0.4388999887324031,14,0,0,block 1 (G first),21.0,11.0,Male,1.0,1.0,1.0,"[4, 'block 1 (G first)']",0,0,0,1.0,5.0,-0.41666666666666663,0.2857142857142857,0.3125,1.0,0.5,2,1.0,0.75,Design 2,Design 2,"Have an option between Design #1 and Design #2,",5.0,,
1182,2772,5,Player object (1275),sell,2023-03-08 17:27:00.590614+00:00,"{""priceA"": 100, ""sharesA"": 0, ""secs_since_round_starts"": 35, ""market"": ""A""}",150.0,7.0,1.0,fcp9s0do,vmu7c279,FULL STUDY,190.0,s2,1,100,,1,,1,,0,sell,0.5733994727268583,17,0,0,block 1 (G first),21.0,11.0,Male,1.0,1.0,1.0,"[5, 'block 1 (G first)']",0,1,0,0.0,5.0,-0.41666666666666663,0.5555555555555556,0.0,0.5,0.0,5,0.25,1.0,Design 2,Design 2,"Have an option between Design #1 and Design #2,",5.0,,
1183,2773,5,Player object (1275),buy,2023-03-08 17:27:09.357110+00:00,"{""priceA"": 80, ""sharesA"": 1, ""secs_since_round_starts"": 44, ""market"": ""A""}",70.0,9.0,2.0,fcp9s0do,vmu7c279,FULL STUDY,190.0,s2,1,80,100.0,-1,,1,sell,0,sell,0.4765586288879626,17,0,0,block 1 (G first),21.0,11.0,Male,1.0,1.0,1.0,"[5, 'block 1 (G first)']",0,1,0,0.0,5.0,-0.41666666666666663,0.5555555555555556,0.0,0.5,0.0,5,0.25,1.0,Design 2,Design 2,"Have an option between Design #1 and Design #2,",5.0,,
1184,2774,5,Player object (1275),sell,2023-03-08 17:27:27.902337+00:00,"{""priceA"": 100, ""sharesA"": 0, ""secs_since_round_starts"": 63, ""market"": ""A""}",170.0,12.0,3.0,fcp9s0do,vmu7c279,FULL STUDY,190.0,s2,1,100,80.0,1,20.0,1,buy,0,sell,0.5344269279803172,17,0,0,block 1 (G first),21.0,11.0,Male,1.0,1.0,1.0,"[5, 'block 1 (G first)']",0,1,0,0.0,5.0,-0.41666666666666663,0.5555555555555556,0.0,0.5,0.0,5,0.25,1.0,Design 2,Design 2,"Have an option between Design #1 and Design #2,",5.0,,
1185,2775,5,Player object (1275),buy,2023-03-08 17:27:43.599456+00:00,"{""priceA"": 90, ""sharesA"": 1, ""secs_since_round_starts"": 78, ""market"": ""A""}",80.0,15.0,4.0,fcp9s0do,vmu7c279,FULL STUDY,190.0,s2,1,90,100.0,-1,,1,sell,0,sell,0.505231414156075,17,0,0,block 1 (G first),21.0,11.0,Male,1.0,1.0,1.0,"[5, 'block 1 (G first)']",0,1,0,0.0,5.0,-0.41666666666666663,0.5555555555555556,0.0,0.5,0.0,5,0.25,1.0,Design 2,Design 2,"Have an option between Design #1 and Design #2,",5.0,,
1186,2776,5,Player object (1275),sell,2023-03-08 17:28:13.517812+00:00,"{""priceA"": 95, ""sharesA"": 0, ""secs_since_round_starts"": 108, ""market"": ""A""}",175.0,20.0,5.0,fcp9s0do,vmu7c279,FULL STUDY,190.0,s2,1,95,90.0,1,5.0,1,buy,0,sell,0.5232479875730728,17,0,0,block 1 (G first),21.0,11.0,Male,1.0,1.0,1.0,"[5, 'block 1 (G first)']",0,1,0,0.0,5.0,-0.41666666666666663,0.5555555555555556,0.0,0.5,0.0,5,0.25,1.0,Design 2,Design 2,"Have an option between Design #1 and Design #2,",5.0,,
1187,2777,5,Player object (1275),buy,2023-03-08 17:28:34.911083+00:00,"{""priceA"": 105, ""sharesA"": 1, ""secs_since_round_starts"": 130, ""market"": ""A""}",70.0,24.0,6.0,fcp9s0do,vmu7c279,FULL STUDY,190.0,s2,1,105,95.0,-1,,1,sell,0,sell,0.5594334008058068,17,0,0,block 1 (G first),21.0,11.0,Male,1.0,1.0,1.0,"[5, 'block 1 (G first)']",0,1,0,0.0,5.0,-0.41666666666666663,0.5555555555555556,0.0,0.5,0.0,5,0.25,1.0,Design 2,Design 2,"Have an option between Design #1 and Design #2,",5.0,,
1188,2778,5,Player object (1275),sell,2023-03-08 17:28:37.243559+00:00,"{""priceA"": 115, ""sharesA"": 0, ""secs_since_round_starts"": 132, ""market"": ""A""}",185.0,25.0,7.0,fcp9s0do,vmu7c279,FULL STUDY,190.0,s2,1,115,105.0,1,10.0,1,buy,0,sell,0.5757035170695836,17,0,1,block 1 (G first),21.0,11.0,Male,1.0,1.0,1.0,"[5, 'block 1 (G first)']",0,1,0,0.0,5.0,-0.41666666666666663,0.5555555555555556,0.0,0.5,0.0,5,0.25,1.0,Design 2,Design 2,"Have an option between Design #1 and Design #2,",5.0,,
1189,2779,5,Player object (1275),buy,2023-03-08 17:29:06.457884+00:00,"{""priceA"": 70, ""sharesA"": 1, ""secs_since_round_starts"": 161, ""market"": ""A""}",115.0,30.0,8.0,fcp9s0do,vmu7c279,FULL STUDY,190.0,s2,1,70,115.0,-1,,1,sell,0,sell,0.4174526841611717,17,0,0,block 1 (G first),21.0,11.0,Male,1.0,1.0,1.0,"[5, 'block 1 (G first)']",0,1,0,0.0,5.0,-0.41666666666666663,0.5555555555555556,0.0,0.5,0.0,5,0.25,1.0,Design 2,Design 2,"Have an option between Design #1 and Design #2,",5.0,,
1190,2781,5,Player object (1275),sell,2023-03-08 17:29:23.384328+00:00,"{""priceA"": 95, ""sharesA"": 0, ""secs_since_round_starts"": 178, ""market"": ""A""}",210.0,32.0,9.0,fcp9s0do,vmu7c279,FULL STUDY,190.0,s2,1,95,70.0,1,25.0,1,buy,0,sell,0.5188715333997952,17,0,0,block 1 (G first),21.0,11.0,Male,1.0,1.0,1.0,"[5, 'block 1 (G first)']",0,1,0,0.0,5.0,-0.41666666666666663,0.5555555555555556,0.0,0.5,0.0,5,0.25,1.0,Design 2,Design 2,"Have an option between Design #1 and Design #2,",5.0,,
1191,2782,5,Player object (1275),buy,2023-03-08 17:29:50.934202+00:00,"{""priceA"": 95, ""sharesA"": 1, ""secs_since_round_starts"": 206, ""market"": ""A""}",115.0,37.0,10.0,fcp9s0do,vmu7c279,FULL STUDY,190.0,s2,1,95,95.0,-1,,1,sell,0,sell,0.4805886028013266,17,0,0,block 1 (G first),21.0,11.0,Male,1.0,1.0,1.0,"[5, 'block 1 (G first)']",0,1,0,0.0,5.0,-0.41666666666666663,0.5555555555555556,0.0,0.5,0.0,5,0.25,1.0,Design 2,Design 2,"Have an option between Design #1 and Design #2,",5.0,,
1192,2783,5,Player object (1275),sell,2023-03-08 17:30:27.854142+00:00,"{""priceA"": 105, ""sharesA"": 0, ""secs_since_round_starts"": 242, ""market"": ""A""}",220.0,44.0,11.0,fcp9s0do,vmu7c279,FULL STUDY,190.0,s2,1,105,95.0,1,10.0,1,buy,0,sell,0.515125859635568,17,0,0,block 1 (G first),21.0,11.0,Male,1.0,1.0,1.0,"[5, 'block 1 (G first)']",0,1,0,0.0,5.0,-0.41666666666666663,0.5555555555555556,0.0,0.5,0.0,5,0.25,1.0,Design 2,Design 2,"Have an option between Design #1 and Design #2,",5.0,,
1193,2784,5,Player object (1275),buy,2023-03-08 17:30:38.189718+00:00,"{""priceA"": 95, ""sharesA"": 1, ""secs_since_round_starts"": 253, ""market"": ""A""}",125.0,46.0,12.0,fcp9s0do,vmu7c279,FULL STUDY,190.0,s2,1,95,105.0,-1,,1,sell,0,sell,0.4967862103563366,17,0,0,block 1 (G first),21.0,11.0,Male,1.0,1.0,1.0,"[5, 'block 1 (G first)']",0,1,0,0.0,5.0,-0.41666666666666663,0.5555555555555556,0.0,0.5,0.0,5,0.25,1.0,Design 2,Design 2,"Have an option between Design #1 and Design #2,",5.0,,
1194,3762,2,Player object (899),sell,2023-03-09 18:15:54.819581+00:00,"{""priceA"": 70, ""sharesA"": 0, ""secs_since_round_starts"": 136, ""market"": ""A""}",120.0,9.0,2.0,fizyhuoi,vmu7c279,FULL STUDY,145.0,s3,1,70,85.0,1,-15.0,1,,0,sell,0.4254536939069079,16,0,0,block 2 (G first),20.0,11.0,Female,1.0,1.0,1.0,"[2, 'block 2 (G first)']",1,1,0,0.5,7.0,-0.21666666666666667,0.2777777777777778,0.11764705882352941,0.4,0.16666666666666666,4,1.0,0.75,Design 2,Design 2,"Have an option between Design #1 and Design #2,",4.0,3.0,3.0
1195,3763,2,Player object (899),buy,2023-03-09 18:15:58.204468+00:00,"{""priceA"": 75, ""sharesA"": 1, ""secs_since_round_starts"": 140, ""market"": ""A""}",45.0,10.0,3.0,fizyhuoi,vmu7c279,FULL STUDY,145.0,s3,1,75,70.0,-1,,1,sell,0,sell,0.4825575314143953,16,0,0,block 2 (G first),20.0,11.0,Female,1.0,1.0,1.0,"[2, 'block 2 (G first)']",1,1,0,0.5,7.0,-0.21666666666666667,0.2777777777777778,0.11764705882352941,0.4,0.16666666666666666,4,1.0,0.75,Design 2,Design 2,"Have an option between Design #1 and Design #2,",4.0,3.0,3.0
1196,3765,2,Player object (899),sell,2023-03-09 18:16:10.066020+00:00,"{""priceA"": 80, ""sharesA"": 0, ""secs_since_round_starts"": 152, ""market"": ""A""}",125.0,12.0,4.0,fizyhuoi,vmu7c279,FULL STUDY,145.0,s3,1,80,75.0,1,5.0,1,buy,0,sell,0.502087716794639,16,0,0,block 2 (G first),20.0,11.0,Female,1.0,1.0,1.0,"[2, 'block 2 (G first)']",1,1,0,0.5,7.0,-0.21666666666666667,0.2777777777777778,0.11764705882352941,0.4,0.16666666666666666,4,1.0,0.75,Design 2,Design 2,"Have an option between Design #1 and Design #2,",4.0,3.0,3.0
1197,3767,2,Player object (899),buy,2023-03-09 18:16:13.947937+00:00,"{""priceA"": 90, ""sharesA"": 1, ""secs_since_round_starts"": 155, ""market"": ""A""}",35.0,13.0,5.0,fizyhuoi,vmu7c279,FULL STUDY,145.0,s3,1,90,80.0,-1,,1,sell,0,sell,0.5364461838942041,16,0,0,block 2 (G first),20.0,11.0,Female,1.0,1.0,1.0,"[2, 'block 2 (G first)']",1,1,0,0.5,7.0,-0.21666666666666667,0.2777777777777778,0.11764705882352941,0.4,0.16666666666666666,4,1.0,0.75,Design 2,Design 2,"Have an option between Design #1 and Design #2,",4.0,3.0,3.0
1198,3768,2,Player object (899),sell,2023-03-09 18:16:22.017987+00:00,"{""priceA"": 105, ""sharesA"": 0, ""secs_since_round_starts"": 164, ""market"": ""A""}",140.0,14.0,6.0,fizyhuoi,vmu7c279,FULL STUDY,145.0,s3,1,105,90.0,1,15.0,1,buy,0,sell,0.5600744319669811,16,0,1,block 2 (G first),20.0,11.0,Female,1.0,1.0,1.0,"[2, 'block 2 (G first)']",1,1,0,0.5,7.0,-0.21666666666666667,0.2777777777777778,0.11764705882352941,0.4,0.16666666666666666,4,1.0,0.75,Design 2,Design 2,"Have an option between Design #1 and Design #2,",4.0,3.0,3.0
1199,3771,2,Player object (899),buy,2023-03-09 18:16:25.079762+00:00,"{""priceA"": 120, ""sharesA"": 1, ""secs_since_round_starts"": 167, ""market"": ""A""}",20.0,15.0,7.0,fizyhuoi,vmu7c279,FULL STUDY,145.0,s3,1,120,105.0,-1,,1,sell,0,sell,0.5761373211134116,16,0,0,block 2 (G first),20.0,11.0,Female,1.0,1.0,1.0,"[2, 'block 2 (G first)']",1,1,0,0.5,7.0,-0.21666666666666667,0.2777777777777778,0.11764705882352941,0.4,0.16666666666666666,4,1.0,0.75,Design 2,Design 2,"Have an option between Design #1 and Design #2,",4.0,3.0,3.0
1200,3773,2,Player object (899),sell,2023-03-09 18:16:53.928808+00:00,"{""priceA"": 125, ""sharesA"": 0, ""secs_since_round_starts"": 195, ""market"": ""A""}",145.0,20.0,8.0,fizyhuoi,vmu7c279,FULL STUDY,145.0,s3,1,125,120.0,1,5.0,1,buy,0,sell,0.5223275507294591,16,0,0,block 2 (G first),20.0,11.0,Female,1.0,1.0,1.0,"[2, 'block 2 (G first)']",1,1,0,0.5,7.0,-0.21666666666666667,0.2777777777777778,0.11764705882352941,0.4,0.16666666666666666,4,1.0,0.75,Design 2,Design 2,"Have an option between Design #1 and Design #2,",4.0,3.0,3.0
1201,3774,2,Player object (899),buy,2023-03-09 18:17:03.552794+00:00,"{""priceA"": 140, ""sharesA"": 1, ""secs_since_round_starts"": 205, ""market"": ""A""}",5.0,22.0,9.0,fizyhuoi,vmu7c279,FULL STUDY,145.0,s3,1,140,125.0,-1,,1,sell,0,sell,0.5695815034421478,16,0,0,block 2 (G first),20.0,11.0,Female,1.0,1.0,1.0,"[2, 'block 2 (G first)']",1,1,0,0.5,7.0,-0.21666666666666667,0.2777777777777778,0.11764705882352941,0.4,0.16666666666666666,4,1.0,0.75,Design 2,Design 2,"Have an option between Design #1 and Design #2,",4.0,3.0,3.0
1202,3776,2,Player object (899),sell,2023-03-09 18:17:20.868392+00:00,"{""priceA"": 145, ""sharesA"": 0, ""secs_since_round_starts"": 222, ""market"": ""A""}",150.0,25.0,10.0,fizyhuoi,vmu7c279,FULL STUDY,145.0,s3,1,145,140.0,1,5.0,1,buy,0,sell,0.5294358264188312,16,0,0,block 2 (G first),20.0,11.0,Female,1.0,1.0,1.0,"[2, 'block 2 (G first)']",1,1,0,0.5,7.0,-0.21666666666666667,0.2777777777777778,0.11764705882352941,0.4,0.16666666666666666,4,1.0,0.75,Design 2,Design 2,"Have an option between Design #1 and Design #2,",4.0,3.0,3.0
1203,3779,2,Player object (899),buy,2023-03-09 18:17:52.023628+00:00,"{""priceA"": 125, ""sharesA"": 1, ""secs_since_round_starts"": 254, ""market"": ""A""}",25.0,30.0,11.0,fizyhuoi,vmu7c279,FULL STUDY,145.0,s3,1,125,145.0,-1,,1,sell,0,sell,0.4785999259850118,16,0,0,block 2 (G first),20.0,11.0,Female,1.0,1.0,1.0,"[2, 'block 2 (G first)']",1,1,0,0.5,7.0,-0.21666666666666667,0.2777777777777778,0.11764705882352941,0.4,0.16666666666666666,4,1.0,0.75,Design 2,Design 2,"Have an option between Design #1 and Design #2,",4.0,3.0,3.0
1204,3784,2,Player object (899),sell,2023-03-09 18:18:16.921634+00:00,"{""priceA"": 125, ""sharesA"": 0, ""secs_since_round_starts"": 278, ""market"": ""A""}",150.0,34.0,12.0,fizyhuoi,vmu7c279,FULL STUDY,145.0,s3,1,125,125.0,1,0.0,1,buy,0,sell,0.4644502626891607,16,0,0,block 2 (G first),20.0,11.0,Female,1.0,1.0,1.0,"[2, 'block 2 (G first)']",1,1,0,0.5,7.0,-0.21666666666666667,0.2777777777777778,0.11764705882352941,0.4,0.16666666666666666,4,1.0,0.75,Design 2,Design 2,"Have an option between Design #1 and Design #2,",4.0,3.0,3.0
1205,3786,2,Player object (899),buy,2023-03-09 18:18:22.485615+00:00,"{""priceA"": 140, ""sharesA"": 1, ""secs_since_round_starts"": 284, ""market"": ""A""}",10.0,35.0,13.0,fizyhuoi,vmu7c279,FULL STUDY,145.0,s3,1,140,125.0,-1,,1,sell,0,sell,0.5101876173062244,16,0,0,block 2 (G first),20.0,11.0,Female,1.0,1.0,1.0,"[2, 'block 2 (G first)']",1,1,0,0.5,7.0,-0.21666666666666667,0.2777777777777778,0.11764705882352941,0.4,0.16666666666666666,4,1.0,0.75,Design 2,Design 2,"Have an option between Design #1 and Design #2,",4.0,3.0,3.0
1206,3791,2,Player object (899),sell,2023-03-09 18:19:06.898360+00:00,"{""priceA"": 125, ""sharesA"": 0, ""secs_since_round_starts"": 328, ""market"": ""A""}",135.0,43.0,14.0,fizyhuoi,vmu7c279,FULL STUDY,145.0,s3,1,125,140.0,1,-15.0,1,buy,0,sell,0.4218732662739463,16,1,0,block 2 (G first),20.0,11.0,Female,1.0,1.0,1.0,"[2, 'block 2 (G first)']",1,1,0,0.5,7.0,-0.21666666666666667,0.2777777777777778,0.11764705882352941,0.4,0.16666666666666666,4,1.0,0.75,Design 2,Design 2,"Have an option between Design #1 and Design #2,",4.0,3.0,3.0
1207,3792,2,Player object (899),buy,2023-03-09 18:19:14.172860+00:00,"{""priceA"": 130, ""sharesA"": 1, ""secs_since_round_starts"": 336, ""market"": ""A""}",5.0,44.0,15.0,fizyhuoi,vmu7c279,FULL STUDY,145.0,s3,1,130,125.0,-1,,1,sell,0,sell,0.4799987600827208,16,0,0,block 2 (G first),20.0,11.0,Female,1.0,1.0,1.0,"[2, 'block 2 (G first)']",1,1,0,0.5,7.0,-0.21666666666666667,0.2777777777777778,0.11764705882352941,0.4,0.16666666666666666,4,1.0,0.75,Design 2,Design 2,"Have an option between Design #1 and Design #2,",4.0,3.0,3.0
1208,3796,2,Player object (899),sell,2023-03-09 18:19:29.781694+00:00,"{""priceA"": 155, ""sharesA"": 0, ""secs_since_round_starts"": 351, ""market"": ""A""}",160.0,46.0,16.0,fizyhuoi,vmu7c279,FULL STUDY,145.0,s3,1,155,130.0,1,25.0,1,buy,0,sell,0.5495494947508355,16,0,1,block 2 (G first),20.0,11.0,Female,1.0,1.0,1.0,"[2, 'block 2 (G first)']",1,1,0,0.5,7.0,-0.21666666666666667,0.2777777777777778,0.11764705882352941,0.4,0.16666666666666666,4,1.0,0.75,Design 2,Design 2,"Have an option between Design #1 and Design #2,",4.0,3.0,3.0
1209,3801,2,Player object (899),buy,2023-03-09 18:19:57.216992+00:00,"{""priceA"": 140, ""sharesA"": 1, ""secs_since_round_starts"": 379, ""market"": ""A""}",20.0,51.0,18.0,fizyhuoi,vmu7c279,FULL STUDY,145.0,s3,1,140,155.0,-1,,1,sell,0,sell,0.4693918893964308,16,0,0,block 2 (G first),20.0,11.0,Female,1.0,1.0,1.0,"[2, 'block 2 (G first)']",1,1,0,0.5,7.0,-0.21666666666666667,0.2777777777777778,0.11764705882352941,0.4,0.16666666666666666,4,1.0,0.75,Design 2,Design 2,"Have an option between Design #1 and Design #2,",4.0,3.0,3.0
1210,3810,3,Player object (1019),sell,2023-03-09 18:21:53.568673+00:00,"{""priceA"": 110, ""sharesA"": 0, ""secs_since_round_starts"": 58, ""market"": ""A""}",160.0,11.0,1.0,fizyhuoi,vmu7c279,FULL STUDY,230.0,s3,1,110,,1,,1,,0,sell,0.5295922419004607,19,0,0,block 2 (G first),20.0,11.0,Female,1.0,1.0,1.0,"[3, 'block 2 (G first)']",1,0,0,0.5,7.0,-0.21666666666666667,0.5,0.0,1.0,0.0,2,0.5,0.5,Design 2,Design 2,"Have an option between Design #1 and Design #2,",4.0,3.0,3.0
1211,3812,3,Player object (1019),buy,2023-03-09 18:21:58.997750+00:00,"{""priceA"": 120, ""sharesA"": 1, ""secs_since_round_starts"": 63, ""market"": ""A""}",40.0,12.0,2.0,fizyhuoi,vmu7c279,FULL STUDY,230.0,s3,1,120,110.0,-1,,1,sell,0,sell,0.5553867656170776,19,0,0,block 2 (G first),20.0,11.0,Female,1.0,1.0,1.0,"[3, 'block 2 (G first)']",1,0,0,0.5,7.0,-0.21666666666666667,0.5,0.0,1.0,0.0,2,0.5,0.5,Design 2,Design 2,"Have an option between Design #1 and Design #2,",4.0,3.0,3.0
1212,3813,3,Player object (1019),sell,2023-03-09 18:22:05.704620+00:00,"{""priceA"": 130, ""sharesA"": 0, ""secs_since_round_starts"": 70, ""market"": ""A""}",170.0,13.0,3.0,fizyhuoi,vmu7c279,FULL STUDY,230.0,s3,1,130,120.0,1,10.0,1,buy,0,sell,0.5729625045047859,19,0,1,block 2 (G first),20.0,11.0,Female,1.0,1.0,1.0,"[3, 'block 2 (G first)']",1,0,0,0.5,7.0,-0.21666666666666667,0.5,0.0,1.0,0.0,2,0.5,0.5,Design 2,Design 2,"Have an option between Design #1 and Design #2,",4.0,3.0,3.0
1213,3814,3,Player object (1019),buy,2023-03-09 18:22:17.176112+00:00,"{""priceA"": 110, ""sharesA"": 1, ""secs_since_round_starts"": 82, ""market"": ""A""}",60.0,15.0,4.0,fizyhuoi,vmu7c279,FULL STUDY,230.0,s3,1,110,130.0,-1,,1,sell,0,sell,0.4763410641166328,19,0,0,block 2 (G first),20.0,11.0,Female,1.0,1.0,1.0,"[3, 'block 2 (G first)']",1,0,0,0.5,7.0,-0.21666666666666667,0.5,0.0,1.0,0.0,2,0.5,0.5,Design 2,Design 2,"Have an option between Design #1 and Design #2,",4.0,3.0,3.0
1214,3815,3,Player object (1019),sell,2023-03-09 18:22:40.143506+00:00,"{""priceA"": 120, ""sharesA"": 0, ""secs_since_round_starts"": 105, ""market"": ""A""}",180.0,19.0,5.0,fizyhuoi,vmu7c279,FULL STUDY,230.0,s3,1,120,110.0,1,10.0,1,buy,0,sell,0.5586446427659006,19,0,1,block 2 (G first),20.0,11.0,Female,1.0,1.0,1.0,"[3, 'block 2 (G first)']",1,0,0,0.5,7.0,-0.21666666666666667,0.5,0.0,1.0,0.0,2,0.5,0.5,Design 2,Design 2,"Have an option between Design #1 and Design #2,",4.0,3.0,3.0
1215,3816,3,Player object (1019),buy,2023-03-09 18:22:49.991853+00:00,"{""priceA"": 100, ""sharesA"": 1, ""secs_since_round_starts"": 114, ""market"": ""A""}",80.0,21.0,6.0,fizyhuoi,vmu7c279,FULL STUDY,230.0,s3,1,100,120.0,-1,,1,sell,0,sell,0.4692484881524699,19,0,0,block 2 (G first),20.0,11.0,Female,1.0,1.0,1.0,"[3, 'block 2 (G first)']",1,0,0,0.5,7.0,-0.21666666666666667,0.5,0.0,1.0,0.0,2,0.5,0.5,Design 2,Design 2,"Have an option between Design #1 and Design #2,",4.0,3.0,3.0
1216,3818,3,Player object (1019),sell,2023-03-09 18:23:27.815562+00:00,"{""priceA"": 110, ""sharesA"": 0, ""secs_since_round_starts"": 152, ""market"": ""A""}",190.0,28.0,7.0,fizyhuoi,vmu7c279,FULL STUDY,230.0,s3,1,110,100.0,1,10.0,1,buy,0,sell,0.5233413838959273,19,0,0,block 2 (G first),20.0,11.0,Female,1.0,1.0,1.0,"[3, 'block 2 (G first)']",1,0,0,0.5,7.0,-0.21666666666666667,0.5,0.0,1.0,0.0,2,0.5,0.5,Design 2,Design 2,"Have an option between Design #1 and Design #2,",4.0,3.0,3.0
1217,3819,3,Player object (1019),buy,2023-03-09 18:23:32.139440+00:00,"{""priceA"": 115, ""sharesA"": 1, ""secs_since_round_starts"": 157, ""market"": ""A""}",75.0,29.0,8.0,fizyhuoi,vmu7c279,FULL STUDY,230.0,s3,1,115,110.0,-1,,1,sell,0,sell,0.5511004178331719,19,0,0,block 2 (G first),20.0,11.0,Female,1.0,1.0,1.0,"[3, 'block 2 (G first)']",1,0,0,0.5,7.0,-0.21666666666666667,0.5,0.0,1.0,0.0,2,0.5,0.5,Design 2,Design 2,"Have an option between Design #1 and Design #2,",4.0,3.0,3.0
1218,3820,3,Player object (1019),sell,2023-03-09 18:23:40.609888+00:00,"{""priceA"": 120, ""sharesA"": 0, ""secs_since_round_starts"": 165, ""market"": ""A""}",195.0,30.0,9.0,fizyhuoi,vmu7c279,FULL STUDY,230.0,s3,1,120,115.0,1,5.0,1,buy,0,sell,0.570054331362491,19,0,1,block 2 (G first),20.0,11.0,Female,1.0,1.0,1.0,"[3, 'block 2 (G first)']",1,0,0,0.5,7.0,-0.21666666666666667,0.5,0.0,1.0,0.0,2,0.5,0.5,Design 2,Design 2,"Have an option between Design #1 and Design #2,",4.0,3.0,3.0
1219,3825,3,Player object (1019),buy,2023-03-09 18:23:56.769633+00:00,"{""priceA"": 100, ""sharesA"": 1, ""secs_since_round_starts"": 181, ""market"": ""A""}",95.0,33.0,10.0,fizyhuoi,vmu7c279,FULL STUDY,230.0,s3,1,100,120.0,-1,,1,sell,0,sell,0.4476889957041811,19,1,0,block 2 (G first),20.0,11.0,Female,1.0,1.0,1.0,"[3, 'block 2 (G first)']",1,0,0,0.5,7.0,-0.21666666666666667,0.5,0.0,1.0,0.0,2,0.5,0.5,Design 2,Design 2,"Have an option between Design #1 and Design #2,",4.0,3.0,3.0
1220,3829,3,Player object (1019),sell,2023-03-09 18:24:35.425907+00:00,"{""priceA"": 115, ""sharesA"": 0, ""secs_since_round_starts"": 220, ""market"": ""A""}",210.0,39.0,11.0,fizyhuoi,vmu7c279,FULL STUDY,230.0,s3,1,115,100.0,1,15.0,1,buy,0,sell,0.5221490272476892,19,0,0,block 2 (G first),20.0,11.0,Female,1.0,1.0,1.0,"[3, 'block 2 (G first)']",1,0,0,0.5,7.0,-0.21666666666666667,0.5,0.0,1.0,0.0,2,0.5,0.5,Design 2,Design 2,"Have an option between Design #1 and Design #2,",4.0,3.0,3.0
1221,3831,3,Player object (1019),buy,2023-03-09 18:24:50.230473+00:00,"{""priceA"": 105, ""sharesA"": 1, ""secs_since_round_starts"": 235, ""market"": ""A""}",105.0,42.0,12.0,fizyhuoi,vmu7c279,FULL STUDY,230.0,s3,1,105,115.0,-1,,1,sell,0,sell,0.5010477910686952,19,0,0,block 2 (G first),20.0,11.0,Female,1.0,1.0,1.0,"[3, 'block 2 (G first)']",1,0,0,0.5,7.0,-0.21666666666666667,0.5,0.0,1.0,0.0,2,0.5,0.5,Design 2,Design 2,"Have an option between Design #1 and Design #2,",4.0,3.0,3.0
1222,3833,3,Player object (1019),sell,2023-03-09 18:25:01.743419+00:00,"{""priceA"": 135, ""sharesA"": 0, ""secs_since_round_starts"": 246, ""market"": ""A""}",240.0,44.0,13.0,fizyhuoi,vmu7c279,FULL STUDY,230.0,s3,1,135,105.0,1,30.0,1,buy,0,sell,0.5595824488336746,19,0,1,block 2 (G first),20.0,11.0,Female,1.0,1.0,1.0,"[3, 'block 2 (G first)']",1,0,0,0.5,7.0,-0.21666666666666667,0.5,0.0,1.0,0.0,2,0.5,0.5,Design 2,Design 2,"Have an option between Design #1 and Design #2,",4.0,3.0,3.0
1223,3835,3,Player object (1019),buy,2023-03-09 18:25:24.918964+00:00,"{""priceA"": 125, ""sharesA"": 1, ""secs_since_round_starts"": 269, ""market"": ""A""}",115.0,48.0,14.0,fizyhuoi,vmu7c279,FULL STUDY,230.0,s3,1,125,135.0,-1,,1,sell,0,sell,0.4599698795591006,19,0,0,block 2 (G first),20.0,11.0,Female,1.0,1.0,1.0,"[3, 'block 2 (G first)']",1,0,0,0.5,7.0,-0.21666666666666667,0.5,0.0,1.0,0.0,2,0.5,0.5,Design 2,Design 2,"Have an option between Design #1 and Design #2,",4.0,3.0,3.0
1224,3838,3,Player object (1019),sell,2023-03-09 18:25:51.060585+00:00,"{""priceA"": 130, ""sharesA"": 0, ""secs_since_round_starts"": 296, ""market"": ""A""}",245.0,53.0,15.0,fizyhuoi,vmu7c279,FULL STUDY,230.0,s3,1,130,125.0,1,5.0,1,buy,0,sell,0.4905868559773416,19,0,0,block 2 (G first),20.0,11.0,Female,1.0,1.0,1.0,"[3, 'block 2 (G first)']",1,0,0,0.5,7.0,-0.21666666666666667,0.5,0.0,1.0,0.0,2,0.5,0.5,Design 2,Design 2,"Have an option between Design #1 and Design #2,",4.0,3.0,3.0
1225,3841,3,Player object (1019),buy,2023-03-09 18:26:18.555115+00:00,"{""priceA"": 130, ""sharesA"": 1, ""secs_since_round_starts"": 323, ""market"": ""A""}",115.0,57.0,16.0,fizyhuoi,vmu7c279,FULL STUDY,230.0,s3,1,130,130.0,-1,,1,sell,0,sell,0.46726452652799,19,0,0,block 2 (G first),20.0,11.0,Female,1.0,1.0,1.0,"[3, 'block 2 (G first)']",1,0,0,0.5,7.0,-0.21666666666666667,0.5,0.0,1.0,0.0,2,0.5,0.5,Design 2,Design 2,"Have an option between Design #1 and Design #2,",4.0,3.0,3.0
1226,3851,4,Player object (1139),sell,2023-03-09 18:27:51.066837+00:00,"{""priceA"": 90, ""sharesA"": 0, ""secs_since_round_starts"": 71, ""market"": ""A""}",140.0,12.0,1.0,fizyhuoi,vmu7c279,FULL STUDY,145.0,s3,1,90,,1,,1,,0,sell,0.5210961257750505,14,0,0,block 2 (G first),20.0,11.0,Female,1.0,1.0,1.0,"[4, 'block 2 (G first)']",0,1,0,0.5,7.0,-0.21666666666666667,0.5,0.18181818181818182,0.0,0.0,2,1.0,0.5,Design 2,Design 2,"Have an option between Design #1 and Design #2,",4.0,3.0,3.0
1227,3853,4,Player object (1139),buy,2023-03-09 18:28:02.652341+00:00,"{""priceA"": 90, ""sharesA"": 1, ""secs_since_round_starts"": 82, ""market"": ""A""}",50.0,14.0,2.0,fizyhuoi,vmu7c279,FULL STUDY,145.0,s3,1,90,90.0,-1,,1,sell,0,sell,0.5208618681016636,14,0,0,block 2 (G first),20.0,11.0,Female,1.0,1.0,1.0,"[4, 'block 2 (G first)']",0,1,0,0.5,7.0,-0.21666666666666667,0.5,0.18181818181818182,0.0,0.0,2,1.0,0.5,Design 2,Design 2,"Have an option between Design #1 and Design #2,",4.0,3.0,3.0
1228,3854,4,Player object (1139),sell,2023-03-09 18:28:06.986389+00:00,"{""priceA"": 95, ""sharesA"": 0, ""secs_since_round_starts"": 87, ""market"": ""A""}",145.0,15.0,3.0,fizyhuoi,vmu7c279,FULL STUDY,145.0,s3,1,95,90.0,1,5.0,1,buy,0,sell,0.5493972040799432,14,0,0,block 2 (G first),20.0,11.0,Female,1.0,1.0,1.0,"[4, 'block 2 (G first)']",0,1,0,0.5,7.0,-0.21666666666666667,0.5,0.18181818181818182,0.0,0.0,2,1.0,0.5,Design 2,Design 2,"Have an option between Design #1 and Design #2,",4.0,3.0,3.0
1229,3855,4,Player object (1139),buy,2023-03-09 18:28:18.815350+00:00,"{""priceA"": 85, ""sharesA"": 1, ""secs_since_round_starts"": 98, ""market"": ""A""}",60.0,17.0,4.0,fizyhuoi,vmu7c279,FULL STUDY,145.0,s3,1,85,95.0,-1,,1,sell,0,sell,0.4647046911342559,14,0,0,block 2 (G first),20.0,11.0,Female,1.0,1.0,1.0,"[4, 'block 2 (G first)']",0,1,0,0.5,7.0,-0.21666666666666667,0.5,0.18181818181818182,0.0,0.0,2,1.0,0.5,Design 2,Design 2,"Have an option between Design #1 and Design #2,",4.0,3.0,3.0
1230,3856,4,Player object (1139),sell,2023-03-09 18:29:03.914493+00:00,"{""priceA"": 40, ""sharesA"": 0, ""secs_since_round_starts"": 143, ""market"": ""A""}",100.0,25.0,5.0,fizyhuoi,vmu7c279,FULL STUDY,145.0,s3,1,40,85.0,1,-45.0,1,buy,0,sell,0.4316900257072523,14,0,0,block 2 (G first),20.0,11.0,Female,1.0,1.0,1.0,"[4, 'block 2 (G first)']",0,1,0,0.5,7.0,-0.21666666666666667,0.5,0.18181818181818182,0.0,0.0,2,1.0,0.5,Design 2,Design 2,"Have an option between Design #1 and Design #2,",4.0,3.0,3.0
1231,3857,4,Player object (1139),buy,2023-03-09 18:29:06.106951+00:00,"{""priceA"": 55, ""sharesA"": 1, ""secs_since_round_starts"": 146, ""market"": ""A""}",45.0,26.0,6.0,fizyhuoi,vmu7c279,FULL STUDY,145.0,s3,1,55,40.0,-1,,1,sell,0,sell,0.4870054870256314,14,0,0,block 2 (G first),20.0,11.0,Female,1.0,1.0,1.0,"[4, 'block 2 (G first)']",0,1,0,0.5,7.0,-0.21666666666666667,0.5,0.18181818181818182,0.0,0.0,2,1.0,0.5,Design 2,Design 2,"Have an option between Design #1 and Design #2,",4.0,3.0,3.0
1232,3859,4,Player object (1139),sell,2023-03-09 18:29:29.211636+00:00,"{""priceA"": 85, ""sharesA"": 0, ""secs_since_round_starts"": 169, ""market"": ""A""}",130.0,30.0,7.0,fizyhuoi,vmu7c279,FULL STUDY,145.0,s3,1,85,55.0,1,30.0,1,buy,0,sell,0.5151109892827086,14,0,0,block 2 (G first),20.0,11.0,Female,1.0,1.0,1.0,"[4, 'block 2 (G first)']",0,1,0,0.5,7.0,-0.21666666666666667,0.5,0.18181818181818182,0.0,0.0,2,1.0,0.5,Design 2,Design 2,"Have an option between Design #1 and Design #2,",4.0,3.0,3.0
1233,3861,4,Player object (1139),buy,2023-03-09 18:30:06.594947+00:00,"{""priceA"": 85, ""sharesA"": 1, ""secs_since_round_starts"": 206, ""market"": ""A""}",45.0,36.0,8.0,fizyhuoi,vmu7c279,FULL STUDY,145.0,s3,1,85,85.0,-1,,1,sell,0,sell,0.4885269486642424,14,0,0,block 2 (G first),20.0,11.0,Female,1.0,1.0,1.0,"[4, 'block 2 (G first)']",0,1,0,0.5,7.0,-0.21666666666666667,0.5,0.18181818181818182,0.0,0.0,2,1.0,0.5,Design 2,Design 2,"Have an option between Design #1 and Design #2,",4.0,3.0,3.0
1234,3862,4,Player object (1139),sell,2023-03-09 18:30:13.667451+00:00,"{""priceA"": 70, ""sharesA"": 0, ""secs_since_round_starts"": 213, ""market"": ""A""}",115.0,37.0,9.0,fizyhuoi,vmu7c279,FULL STUDY,145.0,s3,1,70,85.0,1,-15.0,1,buy,0,sell,0.4570673777008929,14,0,0,block 2 (G first),20.0,11.0,Female,1.0,1.0,1.0,"[4, 'block 2 (G first)']",0,1,0,0.5,7.0,-0.21666666666666667,0.5,0.18181818181818182,0.0,0.0,2,1.0,0.5,Design 2,Design 2,"Have an option between Design #1 and Design #2,",4.0,3.0,3.0
1235,3863,4,Player object (1139),buy,2023-03-09 18:30:22.914327+00:00,"{""priceA"": 80, ""sharesA"": 1, ""secs_since_round_starts"": 222, ""market"": ""A""}",35.0,39.0,10.0,fizyhuoi,vmu7c279,FULL STUDY,145.0,s3,1,80,70.0,-1,,1,sell,0,sell,0.4897180556691627,14,0,0,block 2 (G first),20.0,11.0,Female,1.0,1.0,1.0,"[4, 'block 2 (G first)']",0,1,0,0.5,7.0,-0.21666666666666667,0.5,0.18181818181818182,0.0,0.0,2,1.0,0.5,Design 2,Design 2,"Have an option between Design #1 and Design #2,",4.0,3.0,3.0
1236,3864,4,Player object (1139),sell,2023-03-09 18:30:40.976179+00:00,"{""priceA"": 95, ""sharesA"": 0, ""secs_since_round_starts"": 241, ""market"": ""A""}",130.0,42.0,11.0,fizyhuoi,vmu7c279,FULL STUDY,145.0,s3,1,95,80.0,1,15.0,1,buy,0,sell,0.5388552795609507,14,0,0,block 2 (G first),20.0,11.0,Female,1.0,1.0,1.0,"[4, 'block 2 (G first)']",0,1,0,0.5,7.0,-0.21666666666666667,0.5,0.18181818181818182,0.0,0.0,2,1.0,0.5,Design 2,Design 2,"Have an option between Design #1 and Design #2,",4.0,3.0,3.0
1237,3865,4,Player object (1139),buy,2023-03-09 18:31:09.372375+00:00,"{""priceA"": 85, ""sharesA"": 1, ""secs_since_round_starts"": 269, ""market"": ""A""}",45.0,47.0,12.0,fizyhuoi,vmu7c279,FULL STUDY,145.0,s3,1,85,95.0,-1,,1,sell,0,sell,0.4501495476988393,14,1,0,block 2 (G first),20.0,11.0,Female,1.0,1.0,1.0,"[4, 'block 2 (G first)']",0,1,0,0.5,7.0,-0.21666666666666667,0.5,0.18181818181818182,0.0,0.0,2,1.0,0.5,Design 2,Design 2,"Have an option between Design #1 and Design #2,",4.0,3.0,3.0
1238,3866,4,Player object (1139),sell,2023-03-09 18:31:11.686803+00:00,"{""priceA"": 100, ""sharesA"": 0, ""secs_since_round_starts"": 271, ""market"": ""A""}",145.0,48.0,13.0,fizyhuoi,vmu7c279,FULL STUDY,145.0,s3,1,100,85.0,1,15.0,1,buy,0,sell,0.500105737602651,14,0,0,block 2 (G first),20.0,11.0,Female,1.0,1.0,1.0,"[4, 'block 2 (G first)']",0,1,0,0.5,7.0,-0.21666666666666667,0.5,0.18181818181818182,0.0,0.0,2,1.0,0.5,Design 2,Design 2,"Have an option between Design #1 and Design #2,",4.0,3.0,3.0
1239,3867,4,Player object (1139),buy,2023-03-09 18:31:34.623141+00:00,"{""priceA"": 90, ""sharesA"": 1, ""secs_since_round_starts"": 294, ""market"": ""A""}",55.0,52.0,14.0,fizyhuoi,vmu7c279,FULL STUDY,145.0,s3,1,90,100.0,-1,,1,sell,0,sell,0.4694909620846048,14,0,0,block 2 (G first),20.0,11.0,Female,1.0,1.0,1.0,"[4, 'block 2 (G first)']",0,1,0,0.5,7.0,-0.21666666666666667,0.5,0.18181818181818182,0.0,0.0,2,1.0,0.5,Design 2,Design 2,"Have an option between Design #1 and Design #2,",4.0,3.0,3.0
1240,3870,4,Player object (1139),sell,2023-03-09 18:31:48.096439+00:00,"{""priceA"": 85, ""sharesA"": 0, ""secs_since_round_starts"": 308, ""market"": ""A""}",140.0,54.0,16.0,fizyhuoi,vmu7c279,FULL STUDY,145.0,s3,1,85,75.0,1,10.0,1,buy,0,sell,0.4957421237757241,14,0,0,block 2 (G first),20.0,11.0,Female,1.0,1.0,1.0,"[4, 'block 2 (G first)']",0,1,0,0.5,7.0,-0.21666666666666667,0.5,0.18181818181818182,0.0,0.0,2,1.0,0.5,Design 2,Design 2,"Have an option between Design #1 and Design #2,",4.0,3.0,3.0
1241,3871,4,Player object (1139),buy,2023-03-09 18:31:52.656260+00:00,"{""priceA"": 70, ""sharesA"": 1, ""secs_since_round_starts"": 312, ""market"": ""A""}",70.0,55.0,17.0,fizyhuoi,vmu7c279,FULL STUDY,145.0,s3,1,70,85.0,-1,,1,sell,0,sell,0.4620518023886796,14,0,0,block 2 (G first),20.0,11.0,Female,1.0,1.0,1.0,"[4, 'block 2 (G first)']",0,1,0,0.5,7.0,-0.21666666666666667,0.5,0.18181818181818182,0.0,0.0,2,1.0,0.5,Design 2,Design 2,"Have an option between Design #1 and Design #2,",4.0,3.0,3.0
1242,3877,5,Player object (1259),sell,2023-03-09 18:33:26.432377+00:00,"{""priceA"": 100, ""sharesA"": 0, ""secs_since_round_starts"": 61, ""market"": ""A""}",150.0,12.0,2.0,fizyhuoi,vmu7c279,FULL STUDY,195.0,s3,1,100,90.0,1,10.0,1,,0,sell,0.5344269279803172,17,0,0,block 2 (G first),20.0,11.0,Female,1.0,1.0,1.0,"[5, 'block 2 (G first)']",0,0,0,0.5,7.0,-0.21666666666666667,0.6666666666666666,0.041666666666666664,1.0,0.0,4,0.5,0.75,Design 2,Design 2,"Have an option between Design #1 and Design #2,",4.0,3.0,3.0
1243,3878,5,Player object (1259),buy,2023-03-09 18:33:32.595735+00:00,"{""priceA"": 85, ""sharesA"": 1, ""secs_since_round_starts"": 68, ""market"": ""A""}",65.0,13.0,3.0,fizyhuoi,vmu7c279,FULL STUDY,195.0,s3,1,85,100.0,-1,,1,sell,0,sell,0.4890232705715233,17,0,0,block 2 (G first),20.0,11.0,Female,1.0,1.0,1.0,"[5, 'block 2 (G first)']",0,0,0,0.5,7.0,-0.21666666666666667,0.6666666666666666,0.041666666666666664,1.0,0.0,4,0.5,0.75,Design 2,Design 2,"Have an option between Design #1 and Design #2,",4.0,3.0,3.0
1244,3879,5,Player object (1259),sell,2023-03-09 18:33:49.545023+00:00,"{""priceA"": 85, ""sharesA"": 0, ""secs_since_round_starts"": 85, ""market"": ""A""}",150.0,16.0,4.0,fizyhuoi,vmu7c279,FULL STUDY,195.0,s3,1,85,85.0,1,0.0,1,buy,0,sell,0.4686291671454359,17,0,0,block 2 (G first),20.0,11.0,Female,1.0,1.0,1.0,"[5, 'block 2 (G first)']",0,0,0,0.5,7.0,-0.21666666666666667,0.6666666666666666,0.041666666666666664,1.0,0.0,4,0.5,0.75,Design 2,Design 2,"Have an option between Design #1 and Design #2,",4.0,3.0,3.0
1245,3880,5,Player object (1259),buy,2023-03-09 18:33:54.463873+00:00,"{""priceA"": 80, ""sharesA"": 1, ""secs_since_round_starts"": 89, ""market"": ""A""}",70.0,17.0,5.0,fizyhuoi,vmu7c279,FULL STUDY,195.0,s3,1,80,85.0,-1,,1,sell,0,sell,0.4433955626702647,17,0,0,block 2 (G first),20.0,11.0,Female,1.0,1.0,1.0,"[5, 'block 2 (G first)']",0,0,0,0.5,7.0,-0.21666666666666667,0.6666666666666666,0.041666666666666664,1.0,0.0,4,0.5,0.75,Design 2,Design 2,"Have an option between Design #1 and Design #2,",4.0,3.0,3.0
1246,3881,5,Player object (1259),sell,2023-03-09 18:34:10.580429+00:00,"{""priceA"": 95, ""sharesA"": 0, ""secs_since_round_starts"": 106, ""market"": ""A""}",165.0,20.0,6.0,fizyhuoi,vmu7c279,FULL STUDY,195.0,s3,1,95,80.0,1,15.0,1,buy,0,sell,0.5232479875730728,17,0,0,block 2 (G first),20.0,11.0,Female,1.0,1.0,1.0,"[5, 'block 2 (G first)']",0,0,0,0.5,7.0,-0.21666666666666667,0.6666666666666666,0.041666666666666664,1.0,0.0,4,0.5,0.75,Design 2,Design 2,"Have an option between Design #1 and Design #2,",4.0,3.0,3.0
1247,3882,5,Player object (1259),buy,2023-03-09 18:34:27.212422+00:00,"{""priceA"": 95, ""sharesA"": 1, ""secs_since_round_starts"": 122, ""market"": ""A""}",70.0,23.0,7.0,fizyhuoi,vmu7c279,FULL STUDY,195.0,s3,1,95,95.0,-1,,1,sell,0,sell,0.5355078155027276,17,0,0,block 2 (G first),20.0,11.0,Female,1.0,1.0,1.0,"[5, 'block 2 (G first)']",0,0,0,0.5,7.0,-0.21666666666666667,0.6666666666666666,0.041666666666666664,1.0,0.0,4,0.5,0.75,Design 2,Design 2,"Have an option between Design #1 and Design #2,",4.0,3.0,3.0
1248,3883,5,Player object (1259),sell,2023-03-09 18:34:34.012371+00:00,"{""priceA"": 105, ""sharesA"": 0, ""secs_since_round_starts"": 129, ""market"": ""A""}",175.0,24.0,8.0,fizyhuoi,vmu7c279,FULL STUDY,195.0,s3,1,105,95.0,1,10.0,1,buy,0,sell,0.5594334008058068,17,0,0,block 2 (G first),20.0,11.0,Female,1.0,1.0,1.0,"[5, 'block 2 (G first)']",0,0,0,0.5,7.0,-0.21666666666666667,0.6666666666666666,0.041666666666666664,1.0,0.0,4,0.5,0.75,Design 2,Design 2,"Have an option between Design #1 and Design #2,",4.0,3.0,3.0
1249,3884,5,Player object (1259),buy,2023-03-09 18:34:45.807376+00:00,"{""priceA"": 105, ""sharesA"": 1, ""secs_since_round_starts"": 141, ""market"": ""A""}",70.0,26.0,9.0,fizyhuoi,vmu7c279,FULL STUDY,195.0,s3,1,105,105.0,-1,,1,sell,0,sell,0.5182690684964619,17,0,0,block 2 (G first),20.0,11.0,Female,1.0,1.0,1.0,"[5, 'block 2 (G first)']",0,0,0,0.5,7.0,-0.21666666666666667,0.6666666666666666,0.041666666666666664,1.0,0.0,4,0.5,0.75,Design 2,Design 2,"Have an option between Design #1 and Design #2,",4.0,3.0,3.0
1250,3888,5,Player object (1259),sell,2023-03-09 18:35:20.354452+00:00,"{""priceA"": 110, ""sharesA"": 0, ""secs_since_round_starts"": 175, ""market"": ""A""}",180.0,33.0,11.0,fizyhuoi,vmu7c279,FULL STUDY,195.0,s3,1,110,80.0,1,30.0,1,buy,0,sell,0.5480287979668599,17,0,1,block 2 (G first),20.0,11.0,Female,1.0,1.0,1.0,"[5, 'block 2 (G first)']",0,0,0,0.5,7.0,-0.21666666666666667,0.6666666666666666,0.041666666666666664,1.0,0.0,4,0.5,0.75,Design 2,Design 2,"Have an option between Design #1 and Design #2,",4.0,3.0,3.0
1251,3889,5,Player object (1259),buy,2023-03-09 18:35:48.143020+00:00,"{""priceA"": 80, ""sharesA"": 1, ""secs_since_round_starts"": 203, ""market"": ""A""}",100.0,38.0,12.0,fizyhuoi,vmu7c279,FULL STUDY,195.0,s3,1,80,110.0,-1,,1,sell,0,sell,0.4515999245786187,17,1,0,block 2 (G first),20.0,11.0,Female,1.0,1.0,1.0,"[5, 'block 2 (G first)']",0,0,0,0.5,7.0,-0.21666666666666667,0.6666666666666666,0.041666666666666664,1.0,0.0,4,0.5,0.75,Design 2,Design 2,"Have an option between Design #1 and Design #2,",4.0,3.0,3.0
1252,3890,5,Player object (1259),sell,2023-03-09 18:36:11.560227+00:00,"{""priceA"": 100, ""sharesA"": 0, ""secs_since_round_starts"": 227, ""market"": ""A""}",200.0,42.0,13.0,fizyhuoi,vmu7c279,FULL STUDY,195.0,s3,1,100,80.0,1,20.0,1,buy,0,sell,0.5529358605422235,17,0,1,block 2 (G first),20.0,11.0,Female,1.0,1.0,1.0,"[5, 'block 2 (G first)']",0,0,0,0.5,7.0,-0.21666666666666667,0.6666666666666666,0.041666666666666664,1.0,0.0,4,0.5,0.75,Design 2,Design 2,"Have an option between Design #1 and Design #2,",4.0,3.0,3.0
1253,3891,5,Player object (1259),buy,2023-03-09 18:36:16.453479+00:00,"{""priceA"": 110, ""sharesA"": 1, ""secs_since_round_starts"": 232, ""market"": ""A""}",90.0,43.0,14.0,fizyhuoi,vmu7c279,FULL STUDY,195.0,s3,1,110,100.0,-1,,1,sell,0,sell,0.571300234525265,17,0,0,block 2 (G first),20.0,11.0,Female,1.0,1.0,1.0,"[5, 'block 2 (G first)']",0,0,0,0.5,7.0,-0.21666666666666667,0.6666666666666666,0.041666666666666664,1.0,0.0,4,0.5,0.75,Design 2,Design 2,"Have an option between Design #1 and Design #2,",4.0,3.0,3.0
1254,3892,5,Player object (1259),sell,2023-03-09 18:36:21.876878+00:00,"{""priceA"": 105, ""sharesA"": 0, ""secs_since_round_starts"": 237, ""market"": ""A""}",195.0,44.0,15.0,fizyhuoi,vmu7c279,FULL STUDY,195.0,s3,1,105,110.0,1,-5.0,1,buy,0,sell,0.515125859635568,17,0,0,block 2 (G first),20.0,11.0,Female,1.0,1.0,1.0,"[5, 'block 2 (G first)']",0,0,0,0.5,7.0,-0.21666666666666667,0.6666666666666666,0.041666666666666664,1.0,0.0,4,0.5,0.75,Design 2,Design 2,"Have an option between Design #1 and Design #2,",4.0,3.0,3.0
1255,3893,5,Player object (1259),buy,2023-03-09 18:36:37.134180+00:00,"{""priceA"": 90, ""sharesA"": 1, ""secs_since_round_starts"": 252, ""market"": ""A""}",105.0,47.0,16.0,fizyhuoi,vmu7c279,FULL STUDY,195.0,s3,1,90,105.0,-1,,1,sell,0,sell,0.4627742743797309,17,0,0,block 2 (G first),20.0,11.0,Female,1.0,1.0,1.0,"[5, 'block 2 (G first)']",0,0,0,0.5,7.0,-0.21666666666666667,0.6666666666666666,0.041666666666666664,1.0,0.0,4,0.5,0.75,Design 2,Design 2,"Have an option between Design #1 and Design #2,",4.0,3.0,3.0
1256,3894,5,Player object (1259),sell,2023-03-09 18:37:15.611899+00:00,"{""priceA"": 95, ""sharesA"": 0, ""secs_since_round_starts"": 291, ""market"": ""A""}",200.0,54.0,17.0,fizyhuoi,vmu7c279,FULL STUDY,195.0,s3,1,95,90.0,1,5.0,1,buy,0,sell,0.5299980248683189,17,0,0,block 2 (G first),20.0,11.0,Female,1.0,1.0,1.0,"[5, 'block 2 (G first)']",0,0,0,0.5,7.0,-0.21666666666666667,0.6666666666666666,0.041666666666666664,1.0,0.0,4,0.5,0.75,Design 2,Design 2,"Have an option between Design #1 and Design #2,",4.0,3.0,3.0
1257,3895,5,Player object (1259),buy,2023-03-09 18:37:22.555961+00:00,"{""priceA"": 80, ""sharesA"": 1, ""secs_since_round_starts"": 298, ""market"": ""A""}",120.0,55.0,18.0,fizyhuoi,vmu7c279,FULL STUDY,195.0,s3,1,80,95.0,-1,,1,sell,0,sell,0.4859141076178286,17,0,0,block 2 (G first),20.0,11.0,Female,1.0,1.0,1.0,"[5, 'block 2 (G first)']",0,0,0,0.5,7.0,-0.21666666666666667,0.6666666666666666,0.041666666666666664,1.0,0.0,4,0.5,0.75,Design 2,Design 2,"Have an option between Design #1 and Design #2,",4.0,3.0,3.0
1258,3896,5,Player object (1259),sell,2023-03-09 18:37:27.208503+00:00,"{""priceA"": 95, ""sharesA"": 0, ""secs_since_round_starts"": 302, ""market"": ""A""}",215.0,56.0,19.0,fizyhuoi,vmu7c279,FULL STUDY,195.0,s3,1,95,80.0,1,15.0,1,buy,0,sell,0.5252108989343294,17,0,0,block 2 (G first),20.0,11.0,Female,1.0,1.0,1.0,"[5, 'block 2 (G first)']",0,0,0,0.5,7.0,-0.21666666666666667,0.6666666666666666,0.041666666666666664,1.0,0.0,4,0.5,0.75,Design 2,Design 2,"Have an option between Design #1 and Design #2,",4.0,3.0,3.0
1259,3897,5,Player object (1259),buy,2023-03-09 18:37:32.887858+00:00,"{""priceA"": 85, ""sharesA"": 1, ""secs_since_round_starts"": 308, ""market"": ""A""}",130.0,57.0,20.0,fizyhuoi,vmu7c279,FULL STUDY,195.0,s3,1,85,95.0,-1,,1,sell,0,sell,0.4825596920859898,17,0,0,block 2 (G first),20.0,11.0,Female,1.0,1.0,1.0,"[5, 'block 2 (G first)']",0,0,0,0.5,7.0,-0.21666666666666667,0.6666666666666666,0.041666666666666664,1.0,0.0,4,0.5,0.75,Design 2,Design 2,"Have an option between Design #1 and Design #2,",4.0,3.0,3.0
1260,3660,2,Player object (936),sell,2023-03-09 05:36:25.544799+00:00,"{""priceA"": 70, ""sharesA"": 0, ""secs_since_round_starts"": 172, ""market"": ""A""}",120.0,25.0,1.0,g4ux0ytr,vmu7c279,FULL STUDY,125.0,s4,1,70,,1,,1,,0,sell,0.5,0,0,0,block 4 (G second),21.0,12.0,Male,1.0,1.0,1.0,"[2, 'block 4 (G second)']",0,1,1,0.0,3.0,-0.7,0.5,0.07407407407407407,,0.2,3,1.0,0.75,Design 1,Design 1,Only trade on Design #1,1.0,,
1261,3661,2,Player object (936),buy,2023-03-09 05:36:42.728279+00:00,"{""priceA"": 80, ""sharesA"": 1, ""secs_since_round_starts"": 189, ""market"": ""A""}",40.0,28.0,2.0,g4ux0ytr,vmu7c279,FULL STUDY,125.0,s4,1,80,70.0,-1,,1,sell,0,sell,0.5,0,0,0,block 4 (G second),21.0,12.0,Male,1.0,1.0,1.0,"[2, 'block 4 (G second)']",0,1,1,0.0,3.0,-0.7,0.5,0.07407407407407407,,0.2,3,1.0,0.75,Design 1,Design 1,Only trade on Design #1,1.0,,
1262,3662,2,Player object (936),sell,2023-03-09 05:36:49.401453+00:00,"{""priceA"": 85, ""sharesA"": 0, ""secs_since_round_starts"": 196, ""market"": ""A""}",125.0,29.0,3.0,g4ux0ytr,vmu7c279,FULL STUDY,125.0,s4,1,85,80.0,1,5.0,1,buy,0,sell,0.5,0,0,0,block 4 (G second),21.0,12.0,Male,1.0,1.0,1.0,"[2, 'block 4 (G second)']",0,1,1,0.0,3.0,-0.7,0.5,0.07407407407407407,,0.2,3,1.0,0.75,Design 1,Design 1,Only trade on Design #1,1.0,,
1263,3664,2,Player object (936),buy,2023-03-09 05:37:23.142124+00:00,"{""priceA"": 90, ""sharesA"": 1, ""secs_since_round_starts"": 229, ""market"": ""A""}",35.0,33.0,4.0,g4ux0ytr,vmu7c279,FULL STUDY,125.0,s4,1,90,85.0,-1,,1,sell,0,sell,0.5,0,0,0,block 4 (G second),21.0,12.0,Male,1.0,1.0,1.0,"[2, 'block 4 (G second)']",0,1,1,0.0,3.0,-0.7,0.5,0.07407407407407407,,0.2,3,1.0,0.75,Design 1,Design 1,Only trade on Design #1,1.0,,
1264,3665,2,Player object (936),sell,2023-03-09 05:38:14.334729+00:00,"{""priceA"": 70, ""sharesA"": 0, ""secs_since_round_starts"": 281, ""market"": ""A""}",105.0,42.0,5.0,g4ux0ytr,vmu7c279,FULL STUDY,125.0,s4,1,70,90.0,1,-20.0,1,buy,0,sell,0.5,0,0,1,block 4 (G second),21.0,12.0,Male,1.0,1.0,1.0,"[2, 'block 4 (G second)']",0,1,1,0.0,3.0,-0.7,0.5,0.07407407407407407,,0.2,3,1.0,0.75,Design 1,Design 1,Only trade on Design #1,1.0,,
1265,3666,2,Player object (936),buy,2023-03-09 05:38:22.795426+00:00,"{""priceA"": 45, ""sharesA"": 1, ""secs_since_round_starts"": 289, ""market"": ""A""}",60.0,44.0,6.0,g4ux0ytr,vmu7c279,FULL STUDY,125.0,s4,1,45,70.0,-1,,1,sell,0,sell,0.5,0,0,0,block 4 (G second),21.0,12.0,Male,1.0,1.0,1.0,"[2, 'block 4 (G second)']",0,1,1,0.0,3.0,-0.7,0.5,0.07407407407407407,,0.2,3,1.0,0.75,Design 1,Design 1,Only trade on Design #1,1.0,,
1266,3667,2,Player object (936),sell,2023-03-09 05:38:45.800286+00:00,"{""priceA"": 50, ""sharesA"": 0, ""secs_since_round_starts"": 312, ""market"": ""A""}",110.0,48.0,7.0,g4ux0ytr,vmu7c279,FULL STUDY,125.0,s4,1,50,45.0,1,5.0,1,buy,0,sell,0.5,0,0,0,block 4 (G second),21.0,12.0,Male,1.0,1.0,1.0,"[2, 'block 4 (G second)']",0,1,1,0.0,3.0,-0.7,0.5,0.07407407407407407,,0.2,3,1.0,0.75,Design 1,Design 1,Only trade on Design #1,1.0,,
1267,3668,2,Player object (936),buy,2023-03-09 05:38:56.458545+00:00,"{""priceA"": 60, ""sharesA"": 1, ""secs_since_round_starts"": 323, ""market"": ""A""}",50.0,50.0,8.0,g4ux0ytr,vmu7c279,FULL STUDY,125.0,s4,1,60,50.0,-1,,1,sell,0,sell,0.5,0,0,0,block 4 (G second),21.0,12.0,Male,1.0,1.0,1.0,"[2, 'block 4 (G second)']",0,1,1,0.0,3.0,-0.7,0.5,0.07407407407407407,,0.2,3,1.0,0.75,Design 1,Design 1,Only trade on Design #1,1.0,,
1268,3669,2,Player object (936),sell,2023-03-09 05:39:02.701358+00:00,"{""priceA"": 75, ""sharesA"": 0, ""secs_since_round_starts"": 329, ""market"": ""A""}",125.0,51.0,9.0,g4ux0ytr,vmu7c279,FULL STUDY,125.0,s4,1,75,60.0,1,15.0,1,buy,0,sell,0.5,0,0,0,block 4 (G second),21.0,12.0,Male,1.0,1.0,1.0,"[2, 'block 4 (G second)']",0,1,1,0.0,3.0,-0.7,0.5,0.07407407407407407,,0.2,3,1.0,0.75,Design 1,Design 1,Only trade on Design #1,1.0,,
1269,3675,3,Player object (1056),sell,2023-03-09 05:40:29.297373+00:00,"{""priceA"": 110, ""sharesA"": 0, ""secs_since_round_starts"": 29, ""market"": ""A""}",160.0,6.0,1.0,g4ux0ytr,vmu7c279,FULL STUDY,220.0,s4,1,110,,1,,1,,0,sell,0.5,0,0,0,block 4 (G second),21.0,12.0,Male,1.0,1.0,1.0,"[3, 'block 4 (G second)']",0,0,1,0.0,3.0,-0.7,0.4166666666666667,0.0,0.5,0.0,3,1.0,0.75,Design 1,Design 1,Only trade on Design #1,1.0,,
1270,3676,3,Player object (1056),buy,2023-03-09 05:41:38.892944+00:00,"{""priceA"": 150, ""sharesA"": 1, ""secs_since_round_starts"": 99, ""market"": ""A""}",10.0,19.0,2.0,g4ux0ytr,vmu7c279,FULL STUDY,220.0,s4,1,150,110.0,-1,,1,sell,0,sell,0.5,0,0,0,block 4 (G second),21.0,12.0,Male,1.0,1.0,1.0,"[3, 'block 4 (G second)']",0,0,1,0.0,3.0,-0.7,0.4166666666666667,0.0,0.5,0.0,3,1.0,0.75,Design 1,Design 1,Only trade on Design #1,1.0,,
1271,3677,3,Player object (1056),sell,2023-03-09 05:42:39.662680+00:00,"{""priceA"": 175, ""sharesA"": 0, ""secs_since_round_starts"": 160, ""market"": ""A""}",185.0,30.0,3.0,g4ux0ytr,vmu7c279,FULL STUDY,220.0,s4,1,175,150.0,1,25.0,1,buy,0,sell,0.5,0,0,0,block 4 (G second),21.0,12.0,Male,1.0,1.0,1.0,"[3, 'block 4 (G second)']",0,0,1,0.0,3.0,-0.7,0.4166666666666667,0.0,0.5,0.0,3,1.0,0.75,Design 1,Design 1,Only trade on Design #1,1.0,,
1272,3679,3,Player object (1056),buy,2023-03-09 05:43:10.633134+00:00,"{""priceA"": 140, ""sharesA"": 1, ""secs_since_round_starts"": 191, ""market"": ""A""}",45.0,33.0,4.0,g4ux0ytr,vmu7c279,FULL STUDY,220.0,s4,1,140,175.0,-1,,1,sell,0,sell,0.5,0,1,0,block 4 (G second),21.0,12.0,Male,1.0,1.0,1.0,"[3, 'block 4 (G second)']",0,0,1,0.0,3.0,-0.7,0.4166666666666667,0.0,0.5,0.0,3,1.0,0.75,Design 1,Design 1,Only trade on Design #1,1.0,,
1273,3680,3,Player object (1056),sell,2023-03-09 05:43:22.912898+00:00,"{""priceA"": 155, ""sharesA"": 0, ""secs_since_round_starts"": 203, ""market"": ""A""}",200.0,36.0,5.0,g4ux0ytr,vmu7c279,FULL STUDY,220.0,s4,1,155,140.0,1,15.0,1,buy,0,sell,0.5,0,0,1,block 4 (G second),21.0,12.0,Male,1.0,1.0,1.0,"[3, 'block 4 (G second)']",0,0,1,0.0,3.0,-0.7,0.4166666666666667,0.0,0.5,0.0,3,1.0,0.75,Design 1,Design 1,Only trade on Design #1,1.0,,
1274,3681,3,Player object (1056),buy,2023-03-09 05:43:33.105767+00:00,"{""priceA"": 145, ""sharesA"": 1, ""secs_since_round_starts"": 213, ""market"": ""A""}",55.0,37.0,6.0,g4ux0ytr,vmu7c279,FULL STUDY,220.0,s4,1,145,155.0,-1,,1,sell,0,sell,0.5,0,0,0,block 4 (G second),21.0,12.0,Male,1.0,1.0,1.0,"[3, 'block 4 (G second)']",0,0,1,0.0,3.0,-0.7,0.4166666666666667,0.0,0.5,0.0,3,1.0,0.75,Design 1,Design 1,Only trade on Design #1,1.0,,
1275,3682,3,Player object (1056),sell,2023-03-09 05:44:12.706215+00:00,"{""priceA"": 150, ""sharesA"": 0, ""secs_since_round_starts"": 253, ""market"": ""A""}",205.0,45.0,7.0,g4ux0ytr,vmu7c279,FULL STUDY,220.0,s4,1,150,145.0,1,5.0,1,buy,0,sell,0.5,0,0,0,block 4 (G second),21.0,12.0,Male,1.0,1.0,1.0,"[3, 'block 4 (G second)']",0,0,1,0.0,3.0,-0.7,0.4166666666666667,0.0,0.5,0.0,3,1.0,0.75,Design 1,Design 1,Only trade on Design #1,1.0,,
1276,3683,3,Player object (1056),buy,2023-03-09 05:44:26.251200+00:00,"{""priceA"": 140, ""sharesA"": 1, ""secs_since_round_starts"": 266, ""market"": ""A""}",65.0,47.0,8.0,g4ux0ytr,vmu7c279,FULL STUDY,220.0,s4,1,140,150.0,-1,,1,sell,0,sell,0.5,0,0,0,block 4 (G second),21.0,12.0,Male,1.0,1.0,1.0,"[3, 'block 4 (G second)']",0,0,1,0.0,3.0,-0.7,0.4166666666666667,0.0,0.5,0.0,3,1.0,0.75,Design 1,Design 1,Only trade on Design #1,1.0,,
1277,3684,3,Player object (1056),sell,2023-03-09 05:44:29.943722+00:00,"{""priceA"": 150, ""sharesA"": 0, ""secs_since_round_starts"": 270, ""market"": ""A""}",215.0,48.0,9.0,g4ux0ytr,vmu7c279,FULL STUDY,220.0,s4,1,150,140.0,1,10.0,1,buy,0,sell,0.5,0,0,0,block 4 (G second),21.0,12.0,Male,1.0,1.0,1.0,"[3, 'block 4 (G second)']",0,0,1,0.0,3.0,-0.7,0.4166666666666667,0.0,0.5,0.0,3,1.0,0.75,Design 1,Design 1,Only trade on Design #1,1.0,,
1278,3685,3,Player object (1056),buy,2023-03-09 05:45:13.443058+00:00,"{""priceA"": 175, ""sharesA"": 1, ""secs_since_round_starts"": 314, ""market"": ""A""}",40.0,56.0,10.0,g4ux0ytr,vmu7c279,FULL STUDY,220.0,s4,1,175,150.0,-1,,1,sell,0,sell,0.5,0,1,0,block 4 (G second),21.0,12.0,Male,1.0,1.0,1.0,"[3, 'block 4 (G second)']",0,0,1,0.0,3.0,-0.7,0.4166666666666667,0.0,0.5,0.0,3,1.0,0.75,Design 1,Design 1,Only trade on Design #1,1.0,,
1279,3689,4,Player object (1176),sell,2023-03-09 05:46:13.610753+00:00,"{""priceA"": 125, ""sharesA"": 0, ""secs_since_round_starts"": 31, ""market"": ""A""}",175.0,6.0,1.0,g4ux0ytr,vmu7c279,FULL STUDY,190.0,s4,1,125,,1,,1,,0,sell,0.5,0,0,0,block 4 (G second),21.0,12.0,Male,1.0,1.0,1.0,"[4, 'block 4 (G second)']",1,1,1,0.0,3.0,-0.7,0.6666666666666666,0.05,0.5,0.0,3,1.0,1.0,Design 1,Design 1,Only trade on Design #1,1.0,,
1280,3690,4,Player object (1176),buy,2023-03-09 05:46:38.697038+00:00,"{""priceA"": 120, ""sharesA"": 1, ""secs_since_round_starts"": 56, ""market"": ""A""}",55.0,11.0,2.0,g4ux0ytr,vmu7c279,FULL STUDY,190.0,s4,1,120,125.0,-1,,1,sell,0,sell,0.5,0,0,0,block 4 (G second),21.0,12.0,Male,1.0,1.0,1.0,"[4, 'block 4 (G second)']",1,1,1,0.0,3.0,-0.7,0.6666666666666666,0.05,0.5,0.0,3,1.0,1.0,Design 1,Design 1,Only trade on Design #1,1.0,,
1281,3691,4,Player object (1176),sell,2023-03-09 05:48:11.702129+00:00,"{""priceA"": 60, ""sharesA"": 0, ""secs_since_round_starts"": 148, ""market"": ""A""}",115.0,28.0,3.0,g4ux0ytr,vmu7c279,FULL STUDY,190.0,s4,1,60,120.0,1,-60.0,1,buy,0,sell,0.5,0,0,0,block 4 (G second),21.0,12.0,Male,1.0,1.0,1.0,"[4, 'block 4 (G second)']",1,1,1,0.0,3.0,-0.7,0.6666666666666666,0.05,0.5,0.0,3,1.0,1.0,Design 1,Design 1,Only trade on Design #1,1.0,,
1282,3693,4,Player object (1176),buy,2023-03-09 05:48:50.885918+00:00,"{""priceA"": 75, ""sharesA"": 1, ""secs_since_round_starts"": 188, ""market"": ""A""}",40.0,34.0,4.0,g4ux0ytr,vmu7c279,FULL STUDY,190.0,s4,1,75,60.0,-1,,1,sell,0,sell,0.5,0,0,0,block 4 (G second),21.0,12.0,Male,1.0,1.0,1.0,"[4, 'block 4 (G second)']",1,1,1,0.0,3.0,-0.7,0.6666666666666666,0.05,0.5,0.0,3,1.0,1.0,Design 1,Design 1,Only trade on Design #1,1.0,,
1283,3694,4,Player object (1176),sell,2023-03-09 05:48:55.167767+00:00,"{""priceA"": 85, ""sharesA"": 0, ""secs_since_round_starts"": 192, ""market"": ""A""}",125.0,35.0,5.0,g4ux0ytr,vmu7c279,FULL STUDY,190.0,s4,1,85,75.0,1,10.0,1,buy,0,sell,0.5,0,0,1,block 4 (G second),21.0,12.0,Male,1.0,1.0,1.0,"[4, 'block 4 (G second)']",1,1,1,0.0,3.0,-0.7,0.6666666666666666,0.05,0.5,0.0,3,1.0,1.0,Design 1,Design 1,Only trade on Design #1,1.0,,
1284,3695,4,Player object (1176),buy,2023-03-09 05:49:25.454922+00:00,"{""priceA"": 90, ""sharesA"": 1, ""secs_since_round_starts"": 222, ""market"": ""A""}",35.0,40.0,6.0,g4ux0ytr,vmu7c279,FULL STUDY,190.0,s4,1,90,85.0,-1,,1,sell,0,sell,0.5,0,0,0,block 4 (G second),21.0,12.0,Male,1.0,1.0,1.0,"[4, 'block 4 (G second)']",1,1,1,0.0,3.0,-0.7,0.6666666666666666,0.05,0.5,0.0,3,1.0,1.0,Design 1,Design 1,Only trade on Design #1,1.0,,
1285,3696,4,Player object (1176),sell,2023-03-09 05:49:40.220784+00:00,"{""priceA"": 105, ""sharesA"": 0, ""secs_since_round_starts"": 237, ""market"": ""A""}",140.0,43.0,7.0,g4ux0ytr,vmu7c279,FULL STUDY,190.0,s4,1,105,90.0,1,15.0,1,buy,0,sell,0.5,0,0,0,block 4 (G second),21.0,12.0,Male,1.0,1.0,1.0,"[4, 'block 4 (G second)']",1,1,1,0.0,3.0,-0.7,0.6666666666666666,0.05,0.5,0.0,3,1.0,1.0,Design 1,Design 1,Only trade on Design #1,1.0,,
1286,3697,4,Player object (1176),buy,2023-03-09 05:49:51.232156+00:00,"{""priceA"": 110, ""sharesA"": 1, ""secs_since_round_starts"": 248, ""market"": ""A""}",30.0,45.0,8.0,g4ux0ytr,vmu7c279,FULL STUDY,190.0,s4,1,110,105.0,-1,,1,sell,0,sell,0.5,0,0,0,block 4 (G second),21.0,12.0,Male,1.0,1.0,1.0,"[4, 'block 4 (G second)']",1,1,1,0.0,3.0,-0.7,0.6666666666666666,0.05,0.5,0.0,3,1.0,1.0,Design 1,Design 1,Only trade on Design #1,1.0,,
1287,3698,4,Player object (1176),sell,2023-03-09 05:50:21.017316+00:00,"{""priceA"": 140, ""sharesA"": 0, ""secs_since_round_starts"": 278, ""market"": ""A""}",170.0,50.0,9.0,g4ux0ytr,vmu7c279,FULL STUDY,190.0,s4,1,140,110.0,1,30.0,1,buy,0,sell,0.5,0,0,0,block 4 (G second),21.0,12.0,Male,1.0,1.0,1.0,"[4, 'block 4 (G second)']",1,1,1,0.0,3.0,-0.7,0.6666666666666666,0.05,0.5,0.0,3,1.0,1.0,Design 1,Design 1,Only trade on Design #1,1.0,,
1288,3699,4,Player object (1176),buy,2023-03-09 05:50:27.695333+00:00,"{""priceA"": 125, ""sharesA"": 1, ""secs_since_round_starts"": 285, ""market"": ""A""}",45.0,52.0,10.0,g4ux0ytr,vmu7c279,FULL STUDY,190.0,s4,1,125,140.0,-1,,1,sell,0,sell,0.5,0,0,0,block 4 (G second),21.0,12.0,Male,1.0,1.0,1.0,"[4, 'block 4 (G second)']",1,1,1,0.0,3.0,-0.7,0.6666666666666666,0.05,0.5,0.0,3,1.0,1.0,Design 1,Design 1,Only trade on Design #1,1.0,,
1289,3700,4,Player object (1176),sell,2023-03-09 05:50:41.684451+00:00,"{""priceA"": 130, ""sharesA"": 0, ""secs_since_round_starts"": 299, ""market"": ""A""}",175.0,54.0,11.0,g4ux0ytr,vmu7c279,FULL STUDY,190.0,s4,1,130,125.0,1,5.0,1,buy,0,sell,0.5,0,0,0,block 4 (G second),21.0,12.0,Male,1.0,1.0,1.0,"[4, 'block 4 (G second)']",1,1,1,0.0,3.0,-0.7,0.6666666666666666,0.05,0.5,0.0,3,1.0,1.0,Design 1,Design 1,Only trade on Design #1,1.0,,
1290,3701,4,Player object (1176),buy,2023-03-09 05:50:50.014791+00:00,"{""priceA"": 120, ""sharesA"": 1, ""secs_since_round_starts"": 307, ""market"": ""A""}",55.0,56.0,12.0,g4ux0ytr,vmu7c279,FULL STUDY,190.0,s4,1,120,130.0,-1,,1,sell,0,sell,0.5,0,0,0,block 4 (G second),21.0,12.0,Male,1.0,1.0,1.0,"[4, 'block 4 (G second)']",1,1,1,0.0,3.0,-0.7,0.6666666666666666,0.05,0.5,0.0,3,1.0,1.0,Design 1,Design 1,Only trade on Design #1,1.0,,
1291,3702,4,Player object (1176),sell,2023-03-09 05:50:55.187482+00:00,"{""priceA"": 135, ""sharesA"": 0, ""secs_since_round_starts"": 312, ""market"": ""A""}",190.0,57.0,13.0,g4ux0ytr,vmu7c279,FULL STUDY,190.0,s4,1,135,120.0,1,15.0,1,buy,0,sell,0.5,0,0,0,block 4 (G second),21.0,12.0,Male,1.0,1.0,1.0,"[4, 'block 4 (G second)']",1,1,1,0.0,3.0,-0.7,0.6666666666666666,0.05,0.5,0.0,3,1.0,1.0,Design 1,Design 1,Only trade on Design #1,1.0,,
1292,3706,5,Player object (1296),sell,2023-03-09 05:53:36.433554+00:00,"{""priceA"": 135, ""sharesA"": 0, ""secs_since_round_starts"": 51, ""market"": ""A""}",185.0,10.0,1.0,g4ux0ytr,vmu7c279,FULL STUDY,165.0,s4,1,135,,1,,1,,0,sell,0.5,0,0,0,block 4 (G second),21.0,12.0,Male,1.0,1.0,1.0,"[5, 'block 4 (G second)']",1,0,1,0.0,3.0,-0.7,0.2222222222222222,0.030303030303030304,0.0,0.0,4,0.75,0.5,Design 1,Design 1,Only trade on Design #1,1.0,,
1293,3707,5,Player object (1296),buy,2023-03-09 05:54:15.992828+00:00,"{""priceA"": 125, ""sharesA"": 1, ""secs_since_round_starts"": 91, ""market"": ""A""}",60.0,17.0,2.0,g4ux0ytr,vmu7c279,FULL STUDY,165.0,s4,1,125,135.0,-1,,1,sell,0,sell,0.5,0,0,0,block 4 (G second),21.0,12.0,Male,1.0,1.0,1.0,"[5, 'block 4 (G second)']",1,0,1,0.0,3.0,-0.7,0.2222222222222222,0.030303030303030304,0.0,0.0,4,0.75,0.5,Design 1,Design 1,Only trade on Design #1,1.0,,
1294,3708,5,Player object (1296),sell,2023-03-09 05:54:49.074879+00:00,"{""priceA"": 150, ""sharesA"": 0, ""secs_since_round_starts"": 124, ""market"": ""A""}",210.0,23.0,3.0,g4ux0ytr,vmu7c279,FULL STUDY,165.0,s4,1,150,125.0,1,25.0,1,buy,0,sell,0.5,0,0,0,block 4 (G second),21.0,12.0,Male,1.0,1.0,1.0,"[5, 'block 4 (G second)']",1,0,1,0.0,3.0,-0.7,0.2222222222222222,0.030303030303030304,0.0,0.0,4,0.75,0.5,Design 1,Design 1,Only trade on Design #1,1.0,,
1295,3709,5,Player object (1296),buy,2023-03-09 05:55:04.115149+00:00,"{""priceA"": 140, ""sharesA"": 1, ""secs_since_round_starts"": 139, ""market"": ""A""}",70.0,26.0,4.0,g4ux0ytr,vmu7c279,FULL STUDY,165.0,s4,1,140,150.0,-1,,1,sell,0,sell,0.5,0,0,0,block 4 (G second),21.0,12.0,Male,1.0,1.0,1.0,"[5, 'block 4 (G second)']",1,0,1,0.0,3.0,-0.7,0.2222222222222222,0.030303030303030304,0.0,0.0,4,0.75,0.5,Design 1,Design 1,Only trade on Design #1,1.0,,
1296,3711,5,Player object (1296),sell,2023-03-09 05:58:12.375497+00:00,"{""priceA"": 95, ""sharesA"": 0, ""secs_since_round_starts"": 327, ""market"": ""A""}",165.0,60.0,5.0,g4ux0ytr,vmu7c279,FULL STUDY,165.0,s4,1,95,140.0,1,-45.0,1,buy,0,sell,0.5,0,0,0,block 4 (G second),21.0,12.0,Male,1.0,1.0,1.0,"[5, 'block 4 (G second)']",1,0,1,0.0,3.0,-0.7,0.2222222222222222,0.030303030303030304,0.0,0.0,4,0.75,0.5,Design 1,Design 1,Only trade on Design #1,1.0,,
1297,938,2,Player object (868),sell,2023-03-04 19:51:29.658546+00:00,"{""priceA"": 100, ""sharesA"": 0, ""secs_since_round_starts"": 72, ""market"": ""A""}",150.0,7.0,1.0,galec1ga,vmu7c279,FULL STUDY,230.0,s2,1,100,,1,,1,,0,sell,0.4669924949471701,16,0,0,block 1 (G first),20.0,11.0,Male,1.0,1.0,1.0,"[2, 'block 1 (G first)']",1,0,0,0.0,6.0,-0.31666666666666665,0.3333333333333333,0.0,0.5,,4,1.0,0.5,Design 1,Design 2,"Have an option between Design #1 and Design #2,",3.0,,
1298,939,2,Player object (868),buy,2023-03-04 19:51:38.203691+00:00,"{""priceA"": 85, ""sharesA"": 1, ""secs_since_round_starts"": 81, ""market"": ""A""}",65.0,8.0,2.0,galec1ga,vmu7c279,FULL STUDY,230.0,s2,1,85,100.0,-1,,1,sell,0,sell,0.4422758127435268,16,1,0,block 1 (G first),20.0,11.0,Male,1.0,1.0,1.0,"[2, 'block 1 (G first)']",1,0,0,0.0,6.0,-0.31666666666666665,0.3333333333333333,0.0,0.5,,4,1.0,0.5,Design 1,Design 2,"Have an option between Design #1 and Design #2,",3.0,,
1299,941,2,Player object (868),sell,2023-03-04 19:52:09.563679+00:00,"{""priceA"": 105, ""sharesA"": 0, ""secs_since_round_starts"": 112, ""market"": ""A""}",170.0,14.0,3.0,galec1ga,vmu7c279,FULL STUDY,230.0,s2,1,105,85.0,1,20.0,1,buy,0,sell,0.5600744319669811,16,0,1,block 1 (G first),20.0,11.0,Male,1.0,1.0,1.0,"[2, 'block 1 (G first)']",1,0,0,0.0,6.0,-0.31666666666666665,0.3333333333333333,0.0,0.5,,4,1.0,0.5,Design 1,Design 2,"Have an option between Design #1 and Design #2,",3.0,,
1300,945,2,Player object (868),buy,2023-03-04 19:53:29.012979+00:00,"{""priceA"": 120, ""sharesA"": 1, ""secs_since_round_starts"": 192, ""market"": ""A""}",50.0,28.0,4.0,galec1ga,vmu7c279,FULL STUDY,230.0,s2,1,120,105.0,-1,,1,sell,0,sell,0.4340892272841542,16,0,0,block 1 (G first),20.0,11.0,Male,1.0,1.0,1.0,"[2, 'block 1 (G first)']",1,0,0,0.0,6.0,-0.31666666666666665,0.3333333333333333,0.0,0.5,,4,1.0,0.5,Design 1,Design 2,"Have an option between Design #1 and Design #2,",3.0,,
1301,949,2,Player object (868),sell,2023-03-04 19:54:09.879423+00:00,"{""priceA"": 130, ""sharesA"": 0, ""secs_since_round_starts"": 233, ""market"": ""A""}",180.0,33.0,5.0,galec1ga,vmu7c279,FULL STUDY,230.0,s2,1,130,120.0,1,10.0,1,buy,0,sell,0.499206602391208,16,0,0,block 1 (G first),20.0,11.0,Male,1.0,1.0,1.0,"[2, 'block 1 (G first)']",1,0,0,0.0,6.0,-0.31666666666666665,0.3333333333333333,0.0,0.5,,4,1.0,0.5,Design 1,Design 2,"Have an option between Design #1 and Design #2,",3.0,,
1302,951,2,Player object (868),buy,2023-03-04 19:54:41.100805+00:00,"{""priceA"": 125, ""sharesA"": 1, ""secs_since_round_starts"": 264, ""market"": ""A""}",55.0,39.0,6.0,galec1ga,vmu7c279,FULL STUDY,230.0,s2,1,125,130.0,-1,,1,sell,0,sell,0.4382592777609274,16,1,0,block 1 (G first),20.0,11.0,Male,1.0,1.0,1.0,"[2, 'block 1 (G first)']",1,0,0,0.0,6.0,-0.31666666666666665,0.3333333333333333,0.0,0.5,,4,1.0,0.5,Design 1,Design 2,"Have an option between Design #1 and Design #2,",3.0,,
1303,952,2,Player object (868),sell,2023-03-04 19:54:52.595642+00:00,"{""priceA"": 135, ""sharesA"": 0, ""secs_since_round_starts"": 275, ""market"": ""A""}",190.0,41.0,7.0,galec1ga,vmu7c279,FULL STUDY,230.0,s2,1,135,125.0,1,10.0,1,buy,0,sell,0.4592429496222846,16,0,0,block 1 (G first),20.0,11.0,Male,1.0,1.0,1.0,"[2, 'block 1 (G first)']",1,0,0,0.0,6.0,-0.31666666666666665,0.3333333333333333,0.0,0.5,,4,1.0,0.5,Design 1,Design 2,"Have an option between Design #1 and Design #2,",3.0,,
1304,954,2,Player object (868),buy,2023-03-04 19:55:03.369952+00:00,"{""priceA"": 125, ""sharesA"": 1, ""secs_since_round_starts"": 286, ""market"": ""A""}",65.0,43.0,8.0,galec1ga,vmu7c279,FULL STUDY,230.0,s2,1,125,135.0,-1,,1,sell,0,sell,0.4218732662739463,16,1,0,block 1 (G first),20.0,11.0,Male,1.0,1.0,1.0,"[2, 'block 1 (G first)']",1,0,0,0.0,6.0,-0.31666666666666665,0.3333333333333333,0.0,0.5,,4,1.0,0.5,Design 1,Design 2,"Have an option between Design #1 and Design #2,",3.0,,
1305,956,2,Player object (868),sell,2023-03-04 19:55:24.391308+00:00,"{""priceA"": 140, ""sharesA"": 0, ""secs_since_round_starts"": 307, ""market"": ""A""}",205.0,47.0,9.0,galec1ga,vmu7c279,FULL STUDY,230.0,s2,1,140,125.0,1,15.0,1,buy,0,sell,0.4996814899229063,16,0,0,block 1 (G first),20.0,11.0,Male,1.0,1.0,1.0,"[2, 'block 1 (G first)']",1,0,0,0.0,6.0,-0.31666666666666665,0.3333333333333333,0.0,0.5,,4,1.0,0.5,Design 1,Design 2,"Have an option between Design #1 and Design #2,",3.0,,
1306,957,2,Player object (868),buy,2023-03-04 19:55:58.530452+00:00,"{""priceA"": 135, ""sharesA"": 1, ""secs_since_round_starts"": 341, ""market"": ""A""}",70.0,53.0,10.0,galec1ga,vmu7c279,FULL STUDY,230.0,s2,1,135,140.0,-1,,1,sell,0,sell,0.4956940487416096,16,0,0,block 1 (G first),20.0,11.0,Male,1.0,1.0,1.0,"[2, 'block 1 (G first)']",1,0,0,0.0,6.0,-0.31666666666666665,0.3333333333333333,0.0,0.5,,4,1.0,0.5,Design 1,Design 2,"Have an option between Design #1 and Design #2,",3.0,,
1307,958,2,Player object (868),sell,2023-03-04 19:56:05.443042+00:00,"{""priceA"": 145, ""sharesA"": 0, ""secs_since_round_starts"": 348, ""market"": ""A""}",215.0,54.0,11.0,galec1ga,vmu7c279,FULL STUDY,230.0,s2,1,145,135.0,1,10.0,1,buy,0,sell,0.5320134037503595,16,0,0,block 1 (G first),20.0,11.0,Male,1.0,1.0,1.0,"[2, 'block 1 (G first)']",1,0,0,0.0,6.0,-0.31666666666666665,0.3333333333333333,0.0,0.5,,4,1.0,0.5,Design 1,Design 2,"Have an option between Design #1 and Design #2,",3.0,,
1308,960,2,Player object (868),buy,2023-03-04 19:56:19.826581+00:00,"{""priceA"": 110, ""sharesA"": 1, ""secs_since_round_starts"": 363, ""market"": ""A""}",105.0,57.0,12.0,galec1ga,vmu7c279,FULL STUDY,230.0,s2,1,110,145.0,-1,,1,sell,0,sell,0.4349378880511929,16,1,0,block 1 (G first),20.0,11.0,Male,1.0,1.0,1.0,"[2, 'block 1 (G first)']",1,0,0,0.0,6.0,-0.31666666666666665,0.3333333333333333,0.0,0.5,,4,1.0,0.5,Design 1,Design 2,"Have an option between Design #1 and Design #2,",3.0,,
1309,962,2,Player object (868),sell,2023-03-04 19:56:36.332807+00:00,"{""priceA"": 125, ""sharesA"": 0, ""secs_since_round_starts"": 379, ""market"": ""A""}",230.0,60.0,13.0,galec1ga,vmu7c279,FULL STUDY,230.0,s2,1,125,110.0,1,15.0,1,buy,0,sell,0.5540089061739091,16,0,1,block 1 (G first),20.0,11.0,Male,1.0,1.0,1.0,"[2, 'block 1 (G first)']",1,0,0,0.0,6.0,-0.31666666666666665,0.3333333333333333,0.0,0.5,,4,1.0,0.5,Design 1,Design 2,"Have an option between Design #1 and Design #2,",3.0,,
1310,969,3,Player object (988),sell,2023-03-04 19:57:59.241087+00:00,"{""priceA"": 120, ""sharesA"": 0, ""secs_since_round_starts"": 75, ""market"": ""A""}",170.0,12.0,1.0,galec1ga,vmu7c279,FULL STUDY,280.0,s2,1,120,,1,,1,,0,sell,0.5553867656170776,19,0,0,block 1 (G first),20.0,11.0,Male,1.0,1.0,1.0,"[3, 'block 1 (G first)']",1,1,0,0.5,6.0,-0.31666666666666665,0.2916666666666667,0.0,0.0,0.0,2,0.5,0.5,Design 1,Design 2,"Have an option between Design #1 and Design #2,",3.0,,
1311,970,3,Player object (988),buy,2023-03-04 19:58:21.248178+00:00,"{""priceA"": 100, ""sharesA"": 1, ""secs_since_round_starts"": 97, ""market"": ""A""}",70.0,16.0,2.0,galec1ga,vmu7c279,FULL STUDY,280.0,s2,1,100,120.0,-1,,1,sell,0,sell,0.4486815727575955,19,1,0,block 1 (G first),20.0,11.0,Male,1.0,1.0,1.0,"[3, 'block 1 (G first)']",1,1,0,0.5,6.0,-0.31666666666666665,0.2916666666666667,0.0,0.0,0.0,2,0.5,0.5,Design 1,Design 2,"Have an option between Design #1 and Design #2,",3.0,,
1312,973,3,Player object (988),sell,2023-03-04 19:59:35.143398+00:00,"{""priceA"": 115, ""sharesA"": 0, ""secs_since_round_starts"": 171, ""market"": ""A""}",185.0,29.0,3.0,galec1ga,vmu7c279,FULL STUDY,280.0,s2,1,115,100.0,1,15.0,1,buy,0,sell,0.5511004178331719,19,0,0,block 1 (G first),20.0,11.0,Male,1.0,1.0,1.0,"[3, 'block 1 (G first)']",1,1,0,0.5,6.0,-0.31666666666666665,0.2916666666666667,0.0,0.0,0.0,2,0.5,0.5,Design 1,Design 2,"Have an option between Design #1 and Design #2,",3.0,,
1313,976,3,Player object (988),buy,2023-03-04 20:00:03.817623+00:00,"{""priceA"": 100, ""sharesA"": 1, ""secs_since_round_starts"": 200, ""market"": ""A""}",85.0,33.0,4.0,galec1ga,vmu7c279,FULL STUDY,280.0,s2,1,100,115.0,-1,,1,sell,0,sell,0.4476889957041811,19,1,0,block 1 (G first),20.0,11.0,Male,1.0,1.0,1.0,"[3, 'block 1 (G first)']",1,1,0,0.5,6.0,-0.31666666666666665,0.2916666666666667,0.0,0.0,0.0,2,0.5,0.5,Design 1,Design 2,"Have an option between Design #1 and Design #2,",3.0,,
1314,978,3,Player object (988),sell,2023-03-04 20:00:09.476100+00:00,"{""priceA"": 110, ""sharesA"": 0, ""secs_since_round_starts"": 206, ""market"": ""A""}",195.0,34.0,5.0,galec1ga,vmu7c279,FULL STUDY,280.0,s2,1,110,100.0,1,10.0,1,buy,0,sell,0.4983651933170437,19,0,0,block 1 (G first),20.0,11.0,Male,1.0,1.0,1.0,"[3, 'block 1 (G first)']",1,1,0,0.5,6.0,-0.31666666666666665,0.2916666666666667,0.0,0.0,0.0,2,0.5,0.5,Design 1,Design 2,"Have an option between Design #1 and Design #2,",3.0,,
1315,980,3,Player object (988),buy,2023-03-04 20:00:24.939010+00:00,"{""priceA"": 95, ""sharesA"": 1, ""secs_since_round_starts"": 221, ""market"": ""A""}",100.0,37.0,6.0,galec1ga,vmu7c279,FULL STUDY,280.0,s2,1,95,110.0,-1,,1,sell,0,sell,0.4240076400585448,19,1,0,block 1 (G first),20.0,11.0,Male,1.0,1.0,1.0,"[3, 'block 1 (G first)']",1,1,0,0.5,6.0,-0.31666666666666665,0.2916666666666667,0.0,0.0,0.0,2,0.5,0.5,Design 1,Design 2,"Have an option between Design #1 and Design #2,",3.0,,
1316,982,3,Player object (988),sell,2023-03-04 20:00:36.991478+00:00,"{""priceA"": 115, ""sharesA"": 0, ""secs_since_round_starts"": 233, ""market"": ""A""}",215.0,39.0,7.0,galec1ga,vmu7c279,FULL STUDY,280.0,s2,1,115,95.0,1,20.0,1,buy,0,sell,0.5221490272476892,19,0,0,block 1 (G first),20.0,11.0,Male,1.0,1.0,1.0,"[3, 'block 1 (G first)']",1,1,0,0.5,6.0,-0.31666666666666665,0.2916666666666667,0.0,0.0,0.0,2,0.5,0.5,Design 1,Design 2,"Have an option between Design #1 and Design #2,",3.0,,
1317,983,3,Player object (988),buy,2023-03-04 20:00:42.416320+00:00,"{""priceA"": 100, ""sharesA"": 1, ""secs_since_round_starts"": 239, ""market"": ""A""}",115.0,40.0,8.0,galec1ga,vmu7c279,FULL STUDY,280.0,s2,1,100,115.0,-1,,1,sell,0,sell,0.4804175727303482,19,0,0,block 1 (G first),20.0,11.0,Male,1.0,1.0,1.0,"[3, 'block 1 (G first)']",1,1,0,0.5,6.0,-0.31666666666666665,0.2916666666666667,0.0,0.0,0.0,2,0.5,0.5,Design 1,Design 2,"Have an option between Design #1 and Design #2,",3.0,,
1318,984,3,Player object (988),sell,2023-03-04 20:00:59.366354+00:00,"{""priceA"": 120, ""sharesA"": 0, ""secs_since_round_starts"": 256, ""market"": ""A""}",235.0,43.0,9.0,galec1ga,vmu7c279,FULL STUDY,280.0,s2,1,120,100.0,1,20.0,1,buy,0,sell,0.5357259670782416,19,0,0,block 1 (G first),20.0,11.0,Male,1.0,1.0,1.0,"[3, 'block 1 (G first)']",1,1,0,0.5,6.0,-0.31666666666666665,0.2916666666666667,0.0,0.0,0.0,2,0.5,0.5,Design 1,Design 2,"Have an option between Design #1 and Design #2,",3.0,,
1319,987,3,Player object (988),buy,2023-03-04 20:01:30.590318+00:00,"{""priceA"": 110, ""sharesA"": 1, ""secs_since_round_starts"": 287, ""market"": ""A""}",125.0,49.0,10.0,galec1ga,vmu7c279,FULL STUDY,280.0,s2,1,110,120.0,-1,,1,sell,0,sell,0.4374794566672981,19,1,0,block 1 (G first),20.0,11.0,Male,1.0,1.0,1.0,"[3, 'block 1 (G first)']",1,1,0,0.5,6.0,-0.31666666666666665,0.2916666666666667,0.0,0.0,0.0,2,0.5,0.5,Design 1,Design 2,"Have an option between Design #1 and Design #2,",3.0,,
1320,989,3,Player object (988),sell,2023-03-04 20:01:57.531687+00:00,"{""priceA"": 145, ""sharesA"": 0, ""secs_since_round_starts"": 314, ""market"": ""A""}",270.0,54.0,11.0,galec1ga,vmu7c279,FULL STUDY,280.0,s2,1,145,110.0,1,35.0,1,buy,0,sell,0.52846438705912,19,0,0,block 1 (G first),20.0,11.0,Male,1.0,1.0,1.0,"[3, 'block 1 (G first)']",1,1,0,0.5,6.0,-0.31666666666666665,0.2916666666666667,0.0,0.0,0.0,2,0.5,0.5,Design 1,Design 2,"Have an option between Design #1 and Design #2,",3.0,,
1321,993,3,Player object (988),buy,2023-03-04 20:02:21.239675+00:00,"{""priceA"": 115, ""sharesA"": 1, ""secs_since_round_starts"": 337, ""market"": ""A""}",155.0,58.0,12.0,galec1ga,vmu7c279,FULL STUDY,280.0,s2,1,115,145.0,-1,,1,sell,0,sell,0.442461876115205,19,1,0,block 1 (G first),20.0,11.0,Male,1.0,1.0,1.0,"[3, 'block 1 (G first)']",1,1,0,0.5,6.0,-0.31666666666666665,0.2916666666666667,0.0,0.0,0.0,2,0.5,0.5,Design 1,Design 2,"Have an option between Design #1 and Design #2,",3.0,,
1322,994,3,Player object (988),sell,2023-03-04 20:02:26.255260+00:00,"{""priceA"": 125, ""sharesA"": 0, ""secs_since_round_starts"": 342, ""market"": ""A""}",280.0,59.0,13.0,galec1ga,vmu7c279,FULL STUDY,280.0,s2,1,125,115.0,1,10.0,1,buy,0,sell,0.4946618842475483,19,0,0,block 1 (G first),20.0,11.0,Male,1.0,1.0,1.0,"[3, 'block 1 (G first)']",1,1,0,0.5,6.0,-0.31666666666666665,0.2916666666666667,0.0,0.0,0.0,2,0.5,0.5,Design 1,Design 2,"Have an option between Design #1 and Design #2,",3.0,,
1323,1002,4,Player object (1108),sell,2023-03-04 20:05:51.644965+00:00,"{""priceA"": 95, ""sharesA"": 0, ""secs_since_round_starts"": 191, ""market"": ""A""}",145.0,34.0,1.0,galec1ga,vmu7c279,FULL STUDY,175.0,s2,1,95,,1,,1,,0,sell,0.4981543075921684,14,0,0,block 1 (G first),20.0,11.0,Male,1.0,1.0,1.0,"[4, 'block 1 (G first)']",0,0,0,0.5,6.0,-0.31666666666666665,0.2,0.030303030303030304,0.0,0.0,2,1.0,0.75,Design 1,Design 2,"Have an option between Design #1 and Design #2,",3.0,,
1324,1003,4,Player object (1108),buy,2023-03-04 20:06:06.032056+00:00,"{""priceA"": 70, ""sharesA"": 1, ""secs_since_round_starts"": 205, ""market"": ""A""}",75.0,37.0,2.0,galec1ga,vmu7c279,FULL STUDY,175.0,s2,1,70,95.0,-1,,1,sell,0,sell,0.4570673777008929,14,0,0,block 1 (G first),20.0,11.0,Male,1.0,1.0,1.0,"[4, 'block 1 (G first)']",0,0,0,0.5,6.0,-0.31666666666666665,0.2,0.030303030303030304,0.0,0.0,2,1.0,0.75,Design 1,Design 2,"Have an option between Design #1 and Design #2,",3.0,,
1325,1006,4,Player object (1108),sell,2023-03-04 20:06:37.684809+00:00,"{""priceA"": 95, ""sharesA"": 0, ""secs_since_round_starts"": 237, ""market"": ""A""}",170.0,42.0,3.0,galec1ga,vmu7c279,FULL STUDY,175.0,s2,1,95,70.0,1,25.0,1,buy,0,sell,0.5388552795609507,14,0,0,block 1 (G first),20.0,11.0,Male,1.0,1.0,1.0,"[4, 'block 1 (G first)']",0,0,0,0.5,6.0,-0.31666666666666665,0.2,0.030303030303030304,0.0,0.0,2,1.0,0.75,Design 1,Design 2,"Have an option between Design #1 and Design #2,",3.0,,
1326,1010,4,Player object (1108),buy,2023-03-04 20:07:46.586124+00:00,"{""priceA"": 70, ""sharesA"": 1, ""secs_since_round_starts"": 306, ""market"": ""A""}",100.0,55.0,4.0,galec1ga,vmu7c279,FULL STUDY,175.0,s2,1,70,95.0,-1,,1,sell,0,sell,0.4620518023886796,14,0,0,block 1 (G first),20.0,11.0,Male,1.0,1.0,1.0,"[4, 'block 1 (G first)']",0,0,0,0.5,6.0,-0.31666666666666665,0.2,0.030303030303030304,0.0,0.0,2,1.0,0.75,Design 1,Design 2,"Have an option between Design #1 and Design #2,",3.0,,
1327,1019,5,Player object (1228),sell,2023-03-04 20:10:12.713527+00:00,"{""priceA"": 105, ""sharesA"": 0, ""secs_since_round_starts"": 111, ""market"": ""A""}",155.0,21.0,1.0,galec1ga,vmu7c279,FULL STUDY,200.0,s2,1,105,,1,,1,,0,sell,0.5510362930796925,17,0,1,block 1 (G first),20.0,11.0,Male,1.0,1.0,1.0,"[5, 'block 1 (G first)']",0,1,0,1.0,6.0,-0.31666666666666665,0.21428571428571427,0.0,0.6666666666666666,0.0,4,0.5,0.75,Design 1,Design 2,"Have an option between Design #1 and Design #2,",3.0,,
1328,1022,5,Player object (1228),buy,2023-03-04 20:10:53.330484+00:00,"{""priceA"": 85, ""sharesA"": 1, ""secs_since_round_starts"": 152, ""market"": ""A""}",70.0,28.0,2.0,galec1ga,vmu7c279,FULL STUDY,200.0,s2,1,85,105.0,-1,,1,sell,0,sell,0.4496194529460131,17,1,0,block 1 (G first),20.0,11.0,Male,1.0,1.0,1.0,"[5, 'block 1 (G first)']",0,1,0,1.0,6.0,-0.31666666666666665,0.21428571428571427,0.0,0.6666666666666666,0.0,4,0.5,0.75,Design 1,Design 2,"Have an option between Design #1 and Design #2,",3.0,,
1329,1026,5,Player object (1228),sell,2023-03-04 20:11:25.697561+00:00,"{""priceA"": 110, ""sharesA"": 0, ""secs_since_round_starts"": 184, ""market"": ""A""}",180.0,33.0,3.0,galec1ga,vmu7c279,FULL STUDY,200.0,s2,1,110,85.0,1,25.0,1,buy,0,sell,0.5480287979668599,17,0,1,block 1 (G first),20.0,11.0,Male,1.0,1.0,1.0,"[5, 'block 1 (G first)']",0,1,0,1.0,6.0,-0.31666666666666665,0.21428571428571427,0.0,0.6666666666666666,0.0,4,0.5,0.75,Design 1,Design 2,"Have an option between Design #1 and Design #2,",3.0,,
1330,1027,5,Player object (1228),buy,2023-03-04 20:11:54.252762+00:00,"{""priceA"": 80, ""sharesA"": 1, ""secs_since_round_starts"": 212, ""market"": ""A""}",100.0,38.0,4.0,galec1ga,vmu7c279,FULL STUDY,200.0,s2,1,80,110.0,-1,,1,sell,0,sell,0.4515999245786187,17,1,0,block 1 (G first),20.0,11.0,Male,1.0,1.0,1.0,"[5, 'block 1 (G first)']",0,1,0,1.0,6.0,-0.31666666666666665,0.21428571428571427,0.0,0.6666666666666666,0.0,4,0.5,0.75,Design 1,Design 2,"Have an option between Design #1 and Design #2,",3.0,,
1331,1030,5,Player object (1228),sell,2023-03-04 20:12:22.510929+00:00,"{""priceA"": 110, ""sharesA"": 0, ""secs_since_round_starts"": 241, ""market"": ""A""}",210.0,43.0,5.0,galec1ga,vmu7c279,FULL STUDY,200.0,s2,1,110,80.0,1,30.0,1,buy,0,sell,0.571300234525265,17,0,0,block 1 (G first),20.0,11.0,Male,1.0,1.0,1.0,"[5, 'block 1 (G first)']",0,1,0,1.0,6.0,-0.31666666666666665,0.21428571428571427,0.0,0.6666666666666666,0.0,4,0.5,0.75,Design 1,Design 2,"Have an option between Design #1 and Design #2,",3.0,,
1332,1031,5,Player object (1228),buy,2023-03-04 20:12:47.096829+00:00,"{""priceA"": 75, ""sharesA"": 1, ""secs_since_round_starts"": 265, ""market"": ""A""}",135.0,48.0,6.0,galec1ga,vmu7c279,FULL STUDY,200.0,s2,1,75,110.0,-1,,1,sell,0,sell,0.4393932183506925,17,1,0,block 1 (G first),20.0,11.0,Male,1.0,1.0,1.0,"[5, 'block 1 (G first)']",0,1,0,1.0,6.0,-0.31666666666666665,0.21428571428571427,0.0,0.6666666666666666,0.0,4,0.5,0.75,Design 1,Design 2,"Have an option between Design #1 and Design #2,",3.0,,
1333,521,2,Player object (855),sell,2023-02-26 19:13:24.493429+00:00,"{""priceA"": 125, ""sharesA"": 0, ""secs_since_round_starts"": 96, ""market"": ""A""}",175.0,18.0,1.0,gcs54w3b,vmu7c279,FULL STUDY,240.0,s2,1,125,,1,,1,,0,sell,0.5678304910935957,16,0,0,block 3 (G second),20.0,12.0,Male,1.0,0.0,0.0,"[2, 'block 3 (G second)']",0,0,1,0.5,5.0,-0.5,0.2631578947368421,0.0,0.0,0.0,2,0.5,0.25,Design 1,Design 1,"Have an option between Design #1 and Design #2,",4.0,,
1334,522,2,Player object (855),buy,2023-02-26 19:14:31.263460+00:00,"{""priceA"": 125, ""sharesA"": 1, ""secs_since_round_starts"": 162, ""market"": ""A""}",50.0,30.0,2.0,gcs54w3b,vmu7c279,FULL STUDY,240.0,s2,1,125,125.0,-1,,1,sell,0,sell,0.4785999259850118,16,0,0,block 3 (G second),20.0,12.0,Male,1.0,0.0,0.0,"[2, 'block 3 (G second)']",0,0,1,0.5,5.0,-0.5,0.2631578947368421,0.0,0.0,0.0,2,0.5,0.25,Design 1,Design 1,"Have an option between Design #1 and Design #2,",4.0,,
1335,524,2,Player object (855),sell,2023-02-26 19:15:08.113207+00:00,"{""priceA"": 140, ""sharesA"": 0, ""secs_since_round_starts"": 199, ""market"": ""A""}",190.0,35.0,3.0,gcs54w3b,vmu7c279,FULL STUDY,240.0,s2,1,140,125.0,1,15.0,1,buy,0,sell,0.5101876173062244,16,0,0,block 3 (G second),20.0,12.0,Male,1.0,0.0,0.0,"[2, 'block 3 (G second)']",0,0,1,0.5,5.0,-0.5,0.2631578947368421,0.0,0.0,0.0,2,0.5,0.25,Design 1,Design 1,"Have an option between Design #1 and Design #2,",4.0,,
1336,525,2,Player object (855),buy,2023-02-26 19:15:29.681328+00:00,"{""priceA"": 125, ""sharesA"": 1, ""secs_since_round_starts"": 221, ""market"": ""A""}",65.0,39.0,4.0,gcs54w3b,vmu7c279,FULL STUDY,240.0,s2,1,125,140.0,-1,,1,sell,0,sell,0.4382592777609274,16,1,0,block 3 (G second),20.0,12.0,Male,1.0,0.0,0.0,"[2, 'block 3 (G second)']",0,0,1,0.5,5.0,-0.5,0.2631578947368421,0.0,0.0,0.0,2,0.5,0.25,Design 1,Design 1,"Have an option between Design #1 and Design #2,",4.0,,
1337,526,2,Player object (855),sell,2023-02-26 19:15:35.425358+00:00,"{""priceA"": 140, ""sharesA"": 0, ""secs_since_round_starts"": 227, ""market"": ""A""}",205.0,40.0,5.0,gcs54w3b,vmu7c279,FULL STUDY,240.0,s2,1,140,125.0,1,15.0,1,buy,0,sell,0.4916787423410894,16,0,0,block 3 (G second),20.0,12.0,Male,1.0,0.0,0.0,"[2, 'block 3 (G second)']",0,0,1,0.5,5.0,-0.5,0.2631578947368421,0.0,0.0,0.0,2,0.5,0.25,Design 1,Design 1,"Have an option between Design #1 and Design #2,",4.0,,
1338,527,2,Player object (855),buy,2023-02-26 19:15:51.781688+00:00,"{""priceA"": 125, ""sharesA"": 1, ""secs_since_round_starts"": 243, ""market"": ""A""}",80.0,43.0,6.0,gcs54w3b,vmu7c279,FULL STUDY,240.0,s2,1,125,140.0,-1,,1,sell,0,sell,0.4218732662739463,16,1,0,block 3 (G second),20.0,12.0,Male,1.0,0.0,0.0,"[2, 'block 3 (G second)']",0,0,1,0.5,5.0,-0.5,0.2631578947368421,0.0,0.0,0.0,2,0.5,0.25,Design 1,Design 1,"Have an option between Design #1 and Design #2,",4.0,,
1339,528,2,Player object (855),sell,2023-02-26 19:16:03.644130+00:00,"{""priceA"": 140, ""sharesA"": 0, ""secs_since_round_starts"": 255, ""market"": ""A""}",220.0,45.0,7.0,gcs54w3b,vmu7c279,FULL STUDY,240.0,s2,1,140,125.0,1,15.0,1,buy,0,sell,0.5210834711709403,16,0,0,block 3 (G second),20.0,12.0,Male,1.0,0.0,0.0,"[2, 'block 3 (G second)']",0,0,1,0.5,5.0,-0.5,0.2631578947368421,0.0,0.0,0.0,2,0.5,0.25,Design 1,Design 1,"Have an option between Design #1 and Design #2,",4.0,,
1340,529,2,Player object (855),buy,2023-02-26 19:16:41.372847+00:00,"{""priceA"": 125, ""sharesA"": 1, ""secs_since_round_starts"": 293, ""market"": ""A""}",95.0,52.0,8.0,gcs54w3b,vmu7c279,FULL STUDY,240.0,s2,1,125,140.0,-1,,1,sell,0,sell,0.4439176376077041,16,1,0,block 3 (G second),20.0,12.0,Male,1.0,0.0,0.0,"[2, 'block 3 (G second)']",0,0,1,0.5,5.0,-0.5,0.2631578947368421,0.0,0.0,0.0,2,0.5,0.25,Design 1,Design 1,"Have an option between Design #1 and Design #2,",4.0,,
1341,530,2,Player object (855),sell,2023-02-26 19:16:59.611804+00:00,"{""priceA"": 135, ""sharesA"": 0, ""secs_since_round_starts"": 311, ""market"": ""A""}",230.0,55.0,9.0,gcs54w3b,vmu7c279,FULL STUDY,240.0,s2,1,135,125.0,1,10.0,1,buy,0,sell,0.4873282494519479,16,0,0,block 3 (G second),20.0,12.0,Male,1.0,0.0,0.0,"[2, 'block 3 (G second)']",0,0,1,0.5,5.0,-0.5,0.2631578947368421,0.0,0.0,0.0,2,0.5,0.25,Design 1,Design 1,"Have an option between Design #1 and Design #2,",4.0,,
1342,531,2,Player object (855),buy,2023-02-26 19:17:14.034646+00:00,"{""priceA"": 115, ""sharesA"": 1, ""secs_since_round_starts"": 325, ""market"": ""A""}",115.0,58.0,10.0,gcs54w3b,vmu7c279,FULL STUDY,240.0,s2,1,115,135.0,-1,,1,sell,0,sell,0.4893175166503174,16,0,0,block 3 (G second),20.0,12.0,Male,1.0,0.0,0.0,"[2, 'block 3 (G second)']",0,0,1,0.5,5.0,-0.5,0.2631578947368421,0.0,0.0,0.0,2,0.5,0.25,Design 1,Design 1,"Have an option between Design #1 and Design #2,",4.0,,
1343,534,3,Player object (975),sell,2023-02-26 19:18:28.677609+00:00,"{""priceA"": 110, ""sharesA"": 0, ""secs_since_round_starts"": 55, ""market"": ""A""}",160.0,11.0,1.0,gcs54w3b,vmu7c279,FULL STUDY,220.0,s2,1,110,,1,,1,,0,sell,0.5295922419004607,19,0,0,block 3 (G second),20.0,12.0,Male,1.0,0.0,0.0,"[3, 'block 3 (G second)']",0,1,1,0.5,5.0,-0.5,0.25,0.0,1.0,0.0,4,1.0,0.5,Design 1,Design 1,"Have an option between Design #1 and Design #2,",4.0,,
1344,535,3,Player object (975),buy,2023-02-26 19:19:04.074851+00:00,"{""priceA"": 105, ""sharesA"": 1, ""secs_since_round_starts"": 91, ""market"": ""A""}",55.0,17.0,2.0,gcs54w3b,vmu7c279,FULL STUDY,220.0,s2,1,105,110.0,-1,,1,sell,0,sell,0.4990675303551922,19,0,0,block 3 (G second),20.0,12.0,Male,1.0,0.0,0.0,"[3, 'block 3 (G second)']",0,1,1,0.5,5.0,-0.5,0.25,0.0,1.0,0.0,4,1.0,0.5,Design 1,Design 1,"Have an option between Design #1 and Design #2,",4.0,,
1345,536,3,Player object (975),sell,2023-02-26 19:19:13.504143+00:00,"{""priceA"": 120, ""sharesA"": 0, ""secs_since_round_starts"": 100, ""market"": ""A""}",175.0,19.0,3.0,gcs54w3b,vmu7c279,FULL STUDY,220.0,s2,1,120,105.0,1,15.0,1,buy,0,sell,0.5586446427659006,19,0,1,block 3 (G second),20.0,12.0,Male,1.0,0.0,0.0,"[3, 'block 3 (G second)']",0,1,1,0.5,5.0,-0.5,0.25,0.0,1.0,0.0,4,1.0,0.5,Design 1,Design 1,"Have an option between Design #1 and Design #2,",4.0,,
1346,537,3,Player object (975),buy,2023-02-26 19:19:23.559874+00:00,"{""priceA"": 100, ""sharesA"": 1, ""secs_since_round_starts"": 110, ""market"": ""A""}",75.0,21.0,4.0,gcs54w3b,vmu7c279,FULL STUDY,220.0,s2,1,100,120.0,-1,,1,sell,0,sell,0.4692484881524699,19,0,0,block 3 (G second),20.0,12.0,Male,1.0,0.0,0.0,"[3, 'block 3 (G second)']",0,1,1,0.5,5.0,-0.5,0.25,0.0,1.0,0.0,4,1.0,0.5,Design 1,Design 1,"Have an option between Design #1 and Design #2,",4.0,,
1347,538,3,Player object (975),sell,2023-02-26 19:20:12.844289+00:00,"{""priceA"": 120, ""sharesA"": 0, ""secs_since_round_starts"": 159, ""market"": ""A""}",195.0,30.0,5.0,gcs54w3b,vmu7c279,FULL STUDY,220.0,s2,1,120,100.0,1,20.0,1,buy,0,sell,0.570054331362491,19,0,1,block 3 (G second),20.0,12.0,Male,1.0,0.0,0.0,"[3, 'block 3 (G second)']",0,1,1,0.5,5.0,-0.5,0.25,0.0,1.0,0.0,4,1.0,0.5,Design 1,Design 1,"Have an option between Design #1 and Design #2,",4.0,,
1348,540,3,Player object (975),buy,2023-02-26 19:21:22.969656+00:00,"{""priceA"": 95, ""sharesA"": 1, ""secs_since_round_starts"": 229, ""market"": ""A""}",100.0,37.0,6.0,gcs54w3b,vmu7c279,FULL STUDY,220.0,s2,1,95,120.0,-1,,1,sell,0,sell,0.4240076400585448,19,1,0,block 3 (G second),20.0,12.0,Male,1.0,0.0,0.0,"[3, 'block 3 (G second)']",0,1,1,0.5,5.0,-0.5,0.25,0.0,1.0,0.0,4,1.0,0.5,Design 1,Design 1,"Have an option between Design #1 and Design #2,",4.0,,
1349,541,3,Player object (975),sell,2023-02-26 19:21:57.895501+00:00,"{""priceA"": 120, ""sharesA"": 0, ""secs_since_round_starts"": 264, ""market"": ""A""}",220.0,43.0,7.0,gcs54w3b,vmu7c279,FULL STUDY,220.0,s2,1,120,95.0,1,25.0,1,buy,0,sell,0.5357259670782416,19,0,0,block 3 (G second),20.0,12.0,Male,1.0,0.0,0.0,"[3, 'block 3 (G second)']",0,1,1,0.5,5.0,-0.5,0.25,0.0,1.0,0.0,4,1.0,0.5,Design 1,Design 1,"Have an option between Design #1 and Design #2,",4.0,,
1350,545,4,Player object (1095),sell,2023-02-26 19:24:05.427832+00:00,"{""priceA"": 40, ""sharesA"": 0, ""secs_since_round_starts"": 27, ""market"": ""A""}",90.0,6.0,1.0,gcs54w3b,vmu7c279,FULL STUDY,195.0,s2,1,40,,1,,1,,0,sell,0.4060600996068529,14,0,0,block 3 (G second),20.0,12.0,Male,1.0,0.0,0.0,"[4, 'block 3 (G second)']",1,0,1,0.5,5.0,-0.5,0.3333333333333333,0.058823529411764705,0.3333333333333333,0.0,2,1.0,1.0,Design 1,Design 1,"Have an option between Design #1 and Design #2,",4.0,,
1351,546,4,Player object (1095),buy,2023-02-26 19:24:06.519875+00:00,"{""priceA"": 45, ""sharesA"": 1, ""secs_since_round_starts"": 28, ""market"": ""A""}",45.0,7.0,2.0,gcs54w3b,vmu7c279,FULL STUDY,195.0,s2,1,45,40.0,-1,,1,sell,0,sell,0.4686531252667821,14,0,0,block 3 (G second),20.0,12.0,Male,1.0,0.0,0.0,"[4, 'block 3 (G second)']",1,0,1,0.5,5.0,-0.5,0.3333333333333333,0.058823529411764705,0.3333333333333333,0.0,2,1.0,1.0,Design 1,Design 1,"Have an option between Design #1 and Design #2,",4.0,,
1352,547,4,Player object (1095),sell,2023-02-26 19:24:29.381180+00:00,"{""priceA"": 95, ""sharesA"": 0, ""secs_since_round_starts"": 51, ""market"": ""A""}",140.0,11.0,3.0,gcs54w3b,vmu7c279,FULL STUDY,195.0,s2,1,95,45.0,1,50.0,1,buy,0,sell,0.5796571916404338,14,0,0,block 3 (G second),20.0,12.0,Male,1.0,0.0,0.0,"[4, 'block 3 (G second)']",1,0,1,0.5,5.0,-0.5,0.3333333333333333,0.058823529411764705,0.3333333333333333,0.0,2,1.0,1.0,Design 1,Design 1,"Have an option between Design #1 and Design #2,",4.0,,
1353,548,4,Player object (1095),buy,2023-02-26 19:25:18.552799+00:00,"{""priceA"": 70, ""sharesA"": 1, ""secs_since_round_starts"": 100, ""market"": ""A""}",70.0,20.0,4.0,gcs54w3b,vmu7c279,FULL STUDY,195.0,s2,1,70,95.0,-1,,1,sell,0,sell,0.4604462199730844,14,0,0,block 3 (G second),20.0,12.0,Male,1.0,0.0,0.0,"[4, 'block 3 (G second)']",1,0,1,0.5,5.0,-0.5,0.3333333333333333,0.058823529411764705,0.3333333333333333,0.0,2,1.0,1.0,Design 1,Design 1,"Have an option between Design #1 and Design #2,",4.0,,
1354,549,4,Player object (1095),sell,2023-02-26 19:26:07.930927+00:00,"{""priceA"": 90, ""sharesA"": 0, ""secs_since_round_starts"": 149, ""market"": ""A""}",160.0,29.0,5.0,gcs54w3b,vmu7c279,FULL STUDY,195.0,s2,1,90,70.0,1,20.0,1,buy,0,sell,0.5712793841154561,14,0,0,block 3 (G second),20.0,12.0,Male,1.0,0.0,0.0,"[4, 'block 3 (G second)']",1,0,1,0.5,5.0,-0.5,0.3333333333333333,0.058823529411764705,0.3333333333333333,0.0,2,1.0,1.0,Design 1,Design 1,"Have an option between Design #1 and Design #2,",4.0,,
1355,551,4,Player object (1095),buy,2023-02-26 19:26:58.149666+00:00,"{""priceA"": 65, ""sharesA"": 1, ""secs_since_round_starts"": 200, ""market"": ""A""}",95.0,38.0,6.0,gcs54w3b,vmu7c279,FULL STUDY,195.0,s2,1,65,90.0,-1,,1,sell,0,sell,0.4355009867455686,14,1,0,block 3 (G second),20.0,12.0,Male,1.0,0.0,0.0,"[4, 'block 3 (G second)']",1,0,1,0.5,5.0,-0.5,0.3333333333333333,0.058823529411764705,0.3333333333333333,0.0,2,1.0,1.0,Design 1,Design 1,"Have an option between Design #1 and Design #2,",4.0,,
1356,552,4,Player object (1095),sell,2023-02-26 19:27:26.310385+00:00,"{""priceA"": 100, ""sharesA"": 0, ""secs_since_round_starts"": 228, ""market"": ""A""}",195.0,43.0,7.0,gcs54w3b,vmu7c279,FULL STUDY,195.0,s2,1,100,65.0,1,35.0,1,buy,0,sell,0.5617190733230237,14,0,1,block 3 (G second),20.0,12.0,Male,1.0,0.0,0.0,"[4, 'block 3 (G second)']",1,0,1,0.5,5.0,-0.5,0.3333333333333333,0.058823529411764705,0.3333333333333333,0.0,2,1.0,1.0,Design 1,Design 1,"Have an option between Design #1 and Design #2,",4.0,,
1357,553,4,Player object (1095),buy,2023-02-26 19:27:48.509160+00:00,"{""priceA"": 85, ""sharesA"": 1, ""secs_since_round_starts"": 250, ""market"": ""A""}",110.0,47.0,8.0,gcs54w3b,vmu7c279,FULL STUDY,195.0,s2,1,85,100.0,-1,,1,sell,0,sell,0.4501495476988393,14,1,0,block 3 (G second),20.0,12.0,Male,1.0,0.0,0.0,"[4, 'block 3 (G second)']",1,0,1,0.5,5.0,-0.5,0.3333333333333333,0.058823529411764705,0.3333333333333333,0.0,2,1.0,1.0,Design 1,Design 1,"Have an option between Design #1 and Design #2,",4.0,,
1358,554,4,Player object (1095),sell,2023-02-26 19:27:53.995704+00:00,"{""priceA"": 100, ""sharesA"": 0, ""secs_since_round_starts"": 256, ""market"": ""A""}",210.0,48.0,9.0,gcs54w3b,vmu7c279,FULL STUDY,195.0,s2,1,100,85.0,1,15.0,1,buy,0,sell,0.500105737602651,14,0,0,block 3 (G second),20.0,12.0,Male,1.0,0.0,0.0,"[4, 'block 3 (G second)']",1,0,1,0.5,5.0,-0.5,0.3333333333333333,0.058823529411764705,0.3333333333333333,0.0,2,1.0,1.0,Design 1,Design 1,"Have an option between Design #1 and Design #2,",4.0,,
1359,555,4,Player object (1095),buy,2023-02-26 19:28:18.355169+00:00,"{""priceA"": 90, ""sharesA"": 1, ""secs_since_round_starts"": 280, ""market"": ""A""}",120.0,52.0,10.0,gcs54w3b,vmu7c279,FULL STUDY,195.0,s2,1,90,100.0,-1,,1,sell,0,sell,0.4694909620846048,14,0,0,block 3 (G second),20.0,12.0,Male,1.0,0.0,0.0,"[4, 'block 3 (G second)']",1,0,1,0.5,5.0,-0.5,0.3333333333333333,0.058823529411764705,0.3333333333333333,0.0,2,1.0,1.0,Design 1,Design 1,"Have an option between Design #1 and Design #2,",4.0,,
1360,558,5,Player object (1215),sell,2023-02-26 19:31:44.096632+00:00,"{""priceA"": 115, ""sharesA"": 0, ""secs_since_round_starts"": 129, ""market"": ""A""}",165.0,25.0,1.0,gcs54w3b,vmu7c279,FULL STUDY,225.0,s2,1,115,,1,,1,,0,sell,0.5757035170695836,17,0,1,block 3 (G second),20.0,12.0,Male,1.0,0.0,0.0,"[5, 'block 3 (G second)']",1,1,1,0.5,5.0,-0.5,0.26666666666666666,0.0,0.75,0.0,4,0.5,0.75,Design 1,Design 1,"Have an option between Design #1 and Design #2,",4.0,,
1361,559,5,Player object (1215),buy,2023-02-26 19:32:05.626597+00:00,"{""priceA"": 80, ""sharesA"": 1, ""secs_since_round_starts"": 151, ""market"": ""A""}",85.0,29.0,2.0,gcs54w3b,vmu7c279,FULL STUDY,225.0,s2,1,80,115.0,-1,,1,sell,0,sell,0.4304345659865384,17,0,0,block 3 (G second),20.0,12.0,Male,1.0,0.0,0.0,"[5, 'block 3 (G second)']",1,1,1,0.5,5.0,-0.5,0.26666666666666666,0.0,0.75,0.0,4,0.5,0.75,Design 1,Design 1,"Have an option between Design #1 and Design #2,",4.0,,
1362,561,5,Player object (1215),sell,2023-02-26 19:32:26.596490+00:00,"{""priceA"": 110, ""sharesA"": 0, ""secs_since_round_starts"": 172, ""market"": ""A""}",195.0,33.0,3.0,gcs54w3b,vmu7c279,FULL STUDY,225.0,s2,1,110,80.0,1,30.0,1,buy,0,sell,0.5480287979668599,17,0,1,block 3 (G second),20.0,12.0,Male,1.0,0.0,0.0,"[5, 'block 3 (G second)']",1,1,1,0.5,5.0,-0.5,0.26666666666666666,0.0,0.75,0.0,4,0.5,0.75,Design 1,Design 1,"Have an option between Design #1 and Design #2,",4.0,,
1363,562,5,Player object (1215),buy,2023-02-26 19:32:53.797394+00:00,"{""priceA"": 80, ""sharesA"": 1, ""secs_since_round_starts"": 199, ""market"": ""A""}",115.0,38.0,4.0,gcs54w3b,vmu7c279,FULL STUDY,225.0,s2,1,80,110.0,-1,,1,sell,0,sell,0.4515999245786187,17,1,0,block 3 (G second),20.0,12.0,Male,1.0,0.0,0.0,"[5, 'block 3 (G second)']",1,1,1,0.5,5.0,-0.5,0.26666666666666666,0.0,0.75,0.0,4,0.5,0.75,Design 1,Design 1,"Have an option between Design #1 and Design #2,",4.0,,
1364,563,5,Player object (1215),sell,2023-02-26 19:33:16.738496+00:00,"{""priceA"": 100, ""sharesA"": 0, ""secs_since_round_starts"": 222, ""market"": ""A""}",215.0,42.0,5.0,gcs54w3b,vmu7c279,FULL STUDY,225.0,s2,1,100,80.0,1,20.0,1,buy,0,sell,0.5529358605422235,17,0,1,block 3 (G second),20.0,12.0,Male,1.0,0.0,0.0,"[5, 'block 3 (G second)']",1,1,1,0.5,5.0,-0.5,0.26666666666666666,0.0,0.75,0.0,4,0.5,0.75,Design 1,Design 1,"Have an option between Design #1 and Design #2,",4.0,,
1365,564,5,Player object (1215),buy,2023-02-26 19:33:49.081022+00:00,"{""priceA"": 75, ""sharesA"": 1, ""secs_since_round_starts"": 254, ""market"": ""A""}",140.0,48.0,6.0,gcs54w3b,vmu7c279,FULL STUDY,225.0,s2,1,75,100.0,-1,,1,sell,0,sell,0.4393932183506925,17,1,0,block 3 (G second),20.0,12.0,Male,1.0,0.0,0.0,"[5, 'block 3 (G second)']",1,1,1,0.5,5.0,-0.5,0.26666666666666666,0.0,0.75,0.0,4,0.5,0.75,Design 1,Design 1,"Have an option between Design #1 and Design #2,",4.0,,
1366,565,5,Player object (1215),sell,2023-02-26 19:34:32.876519+00:00,"{""priceA"": 95, ""sharesA"": 0, ""secs_since_round_starts"": 298, ""market"": ""A""}",235.0,56.0,7.0,gcs54w3b,vmu7c279,FULL STUDY,225.0,s2,1,95,75.0,1,20.0,1,buy,0,sell,0.5252108989343294,17,0,0,block 3 (G second),20.0,12.0,Male,1.0,0.0,0.0,"[5, 'block 3 (G second)']",1,1,1,0.5,5.0,-0.5,0.26666666666666666,0.0,0.75,0.0,4,0.5,0.75,Design 1,Design 1,"Have an option between Design #1 and Design #2,",4.0,,
1367,566,5,Player object (1215),buy,2023-02-26 19:34:47.491008+00:00,"{""priceA"": 75, ""sharesA"": 1, ""secs_since_round_starts"": 313, ""market"": ""A""}",160.0,58.0,8.0,gcs54w3b,vmu7c279,FULL STUDY,225.0,s2,1,75,95.0,-1,,1,sell,0,sell,0.4529558772574278,17,0,0,block 3 (G second),20.0,12.0,Male,1.0,0.0,0.0,"[5, 'block 3 (G second)']",1,1,1,0.5,5.0,-0.5,0.26666666666666666,0.0,0.75,0.0,4,0.5,0.75,Design 1,Design 1,"Have an option between Design #1 and Design #2,",4.0,,
1368,2405,2,Player object (910),sell,2023-03-08 05:09:03.304144+00:00,"{""priceA"": 120, ""sharesA"": 0, ""secs_since_round_starts"": 77, ""market"": ""A""}",170.0,15.0,1.0,gnzz7gc4,vmu7c279,FULL STUDY,200.0,s2,1,120,,1,,1,,0,sell,0.5761373211134116,16,0,0,block 4 (G second),22.0,11.0,Male,1.0,0.0,0.0,"[2, 'block 4 (G second)']",0,1,1,0.0,5.0,-0.41666666666666663,0.2727272727272727,0.0,0.3333333333333333,0.0,3,0.75,0.25,Design 2,Design 2,"Have an option between Design #1 and Design #2,",3.0,,
1369,2408,2,Player object (910),buy,2023-03-08 05:10:11.685840+00:00,"{""priceA"": 125, ""sharesA"": 1, ""secs_since_round_starts"": 146, ""market"": ""A""}",45.0,27.0,2.0,gnzz7gc4,vmu7c279,FULL STUDY,200.0,s2,1,125,120.0,-1,,1,sell,0,sell,0.4549942201992644,16,1,0,block 4 (G second),22.0,11.0,Male,1.0,0.0,0.0,"[2, 'block 4 (G second)']",0,1,1,0.0,5.0,-0.41666666666666663,0.2727272727272727,0.0,0.3333333333333333,0.0,3,0.75,0.25,Design 2,Design 2,"Have an option between Design #1 and Design #2,",3.0,,
1370,2413,2,Player object (910),sell,2023-03-08 05:11:06.644936+00:00,"{""priceA"": 150, ""sharesA"": 0, ""secs_since_round_starts"": 201, ""market"": ""A""}",195.0,36.0,3.0,gnzz7gc4,vmu7c279,FULL STUDY,200.0,s2,1,150,125.0,1,25.0,1,buy,0,sell,0.542045663089369,16,0,0,block 4 (G second),22.0,11.0,Male,1.0,0.0,0.0,"[2, 'block 4 (G second)']",0,1,1,0.0,5.0,-0.41666666666666663,0.2727272727272727,0.0,0.3333333333333333,0.0,3,0.75,0.25,Design 2,Design 2,"Have an option between Design #1 and Design #2,",3.0,,
1371,2414,2,Player object (910),buy,2023-03-08 05:11:28.308843+00:00,"{""priceA"": 140, ""sharesA"": 1, ""secs_since_round_starts"": 222, ""market"": ""A""}",55.0,40.0,4.0,gnzz7gc4,vmu7c279,FULL STUDY,200.0,s2,1,140,150.0,-1,,1,sell,0,sell,0.4916787423410894,16,0,0,block 4 (G second),22.0,11.0,Male,1.0,0.0,0.0,"[2, 'block 4 (G second)']",0,1,1,0.0,5.0,-0.41666666666666663,0.2727272727272727,0.0,0.3333333333333333,0.0,3,0.75,0.25,Design 2,Design 2,"Have an option between Design #1 and Design #2,",3.0,,
1372,2418,2,Player object (910),sell,2023-03-08 05:11:59.171507+00:00,"{""priceA"": 155, ""sharesA"": 0, ""secs_since_round_starts"": 253, ""market"": ""A""}",210.0,46.0,5.0,gnzz7gc4,vmu7c279,FULL STUDY,200.0,s2,1,155,140.0,1,15.0,1,buy,0,sell,0.5495494947508355,16,0,1,block 4 (G second),22.0,11.0,Male,1.0,0.0,0.0,"[2, 'block 4 (G second)']",0,1,1,0.0,5.0,-0.41666666666666663,0.2727272727272727,0.0,0.3333333333333333,0.0,3,0.75,0.25,Design 2,Design 2,"Have an option between Design #1 and Design #2,",3.0,,
1373,2421,2,Player object (910),buy,2023-03-08 05:12:36.827637+00:00,"{""priceA"": 135, ""sharesA"": 1, ""secs_since_round_starts"": 291, ""market"": ""A""}",75.0,53.0,6.0,gnzz7gc4,vmu7c279,FULL STUDY,200.0,s2,1,135,155.0,-1,,1,sell,0,sell,0.4956940487416096,16,0,0,block 4 (G second),22.0,11.0,Male,1.0,0.0,0.0,"[2, 'block 4 (G second)']",0,1,1,0.0,5.0,-0.41666666666666663,0.2727272727272727,0.0,0.3333333333333333,0.0,3,0.75,0.25,Design 2,Design 2,"Have an option between Design #1 and Design #2,",3.0,,
1374,2427,3,Player object (1030),sell,2023-03-08 05:14:24.855480+00:00,"{""priceA"": 120, ""sharesA"": 0, ""secs_since_round_starts"": 61, ""market"": ""A""}",170.0,12.0,1.0,gnzz7gc4,vmu7c279,FULL STUDY,200.0,s2,1,120,,1,,1,,0,sell,0.5553867656170776,19,0,0,block 4 (G second),22.0,11.0,Male,1.0,0.0,0.0,"[3, 'block 4 (G second)']",0,0,1,0.0,5.0,-0.41666666666666663,0.07142857142857142,0.0,0.0,0.0,3,0.75,0.25,Design 2,Design 2,"Have an option between Design #1 and Design #2,",3.0,,
1375,2430,3,Player object (1030),buy,2023-03-08 05:14:50.475325+00:00,"{""priceA"": 105, ""sharesA"": 1, ""secs_since_round_starts"": 87, ""market"": ""A""}",65.0,17.0,2.0,gnzz7gc4,vmu7c279,FULL STUDY,200.0,s2,1,105,120.0,-1,,1,sell,0,sell,0.4990675303551922,19,0,0,block 4 (G second),22.0,11.0,Male,1.0,0.0,0.0,"[3, 'block 4 (G second)']",0,0,1,0.0,5.0,-0.41666666666666663,0.07142857142857142,0.0,0.0,0.0,3,0.75,0.25,Design 2,Design 2,"Have an option between Design #1 and Design #2,",3.0,,
1376,2438,3,Player object (1030),sell,2023-03-08 05:18:19.320095+00:00,"{""priceA"": 145, ""sharesA"": 0, ""secs_since_round_starts"": 296, ""market"": ""A""}",210.0,54.0,3.0,gnzz7gc4,vmu7c279,FULL STUDY,200.0,s2,1,145,105.0,1,40.0,1,buy,0,sell,0.52846438705912,19,0,0,block 4 (G second),22.0,11.0,Male,1.0,0.0,0.0,"[3, 'block 4 (G second)']",0,0,1,0.0,5.0,-0.41666666666666663,0.07142857142857142,0.0,0.0,0.0,3,0.75,0.25,Design 2,Design 2,"Have an option between Design #1 and Design #2,",3.0,,
1377,2439,3,Player object (1030),buy,2023-03-08 05:18:47.429425+00:00,"{""priceA"": 125, ""sharesA"": 1, ""secs_since_round_starts"": 324, ""market"": ""A""}",85.0,59.0,4.0,gnzz7gc4,vmu7c279,FULL STUDY,200.0,s2,1,125,145.0,-1,,1,sell,0,sell,0.4946618842475483,19,0,0,block 4 (G second),22.0,11.0,Male,1.0,0.0,0.0,"[3, 'block 4 (G second)']",0,0,1,0.0,5.0,-0.41666666666666663,0.07142857142857142,0.0,0.0,0.0,3,0.75,0.25,Design 2,Design 2,"Have an option between Design #1 and Design #2,",3.0,,
1378,2443,4,Player object (1150),sell,2023-03-08 05:19:57.826124+00:00,"{""priceA"": 80, ""sharesA"": 0, ""secs_since_round_starts"": 53, ""market"": ""A""}",130.0,10.0,1.0,gnzz7gc4,vmu7c279,FULL STUDY,170.0,s2,1,80,,1,,1,,0,sell,0.5652817482669988,14,0,0,block 4 (G second),22.0,11.0,Male,1.0,0.0,0.0,"[4, 'block 4 (G second)']",1,1,1,0.0,5.0,-0.41666666666666663,0.25,0.05263157894736842,1.0,0.0,3,0.75,0.0,Design 2,Design 2,"Have an option between Design #1 and Design #2,",3.0,,
1379,2444,4,Player object (1150),buy,2023-03-08 05:20:40.704886+00:00,"{""priceA"": 70, ""sharesA"": 1, ""secs_since_round_starts"": 96, ""market"": ""A""}",60.0,18.0,2.0,gnzz7gc4,vmu7c279,FULL STUDY,170.0,s2,1,70,80.0,-1,,1,sell,0,sell,0.4407118028401492,14,1,0,block 4 (G second),22.0,11.0,Male,1.0,0.0,0.0,"[4, 'block 4 (G second)']",1,1,1,0.0,5.0,-0.41666666666666663,0.25,0.05263157894736842,1.0,0.0,3,0.75,0.0,Design 2,Design 2,"Have an option between Design #1 and Design #2,",3.0,,
1380,2445,4,Player object (1150),sell,2023-03-08 05:21:34.114835+00:00,"{""priceA"": 80, ""sharesA"": 0, ""secs_since_round_starts"": 149, ""market"": ""A""}",140.0,28.0,3.0,gnzz7gc4,vmu7c279,FULL STUDY,170.0,s2,1,80,70.0,1,10.0,1,buy,0,sell,0.5529051331090981,14,0,1,block 4 (G second),22.0,11.0,Male,1.0,0.0,0.0,"[4, 'block 4 (G second)']",1,1,1,0.0,5.0,-0.41666666666666663,0.25,0.05263157894736842,1.0,0.0,3,0.75,0.0,Design 2,Design 2,"Have an option between Design #1 and Design #2,",3.0,,
1381,2447,4,Player object (1150),buy,2023-03-08 05:22:39.428808+00:00,"{""priceA"": 70, ""sharesA"": 1, ""secs_since_round_starts"": 215, ""market"": ""A""}",70.0,37.0,4.0,gnzz7gc4,vmu7c279,FULL STUDY,170.0,s2,1,70,80.0,-1,,1,sell,0,sell,0.4570673777008929,14,0,0,block 4 (G second),22.0,11.0,Male,1.0,0.0,0.0,"[4, 'block 4 (G second)']",1,1,1,0.0,5.0,-0.41666666666666663,0.25,0.05263157894736842,1.0,0.0,3,0.75,0.0,Design 2,Design 2,"Have an option between Design #1 and Design #2,",3.0,,
1382,2448,4,Player object (1150),sell,2023-03-08 05:23:11.980931+00:00,"{""priceA"": 100, ""sharesA"": 0, ""secs_since_round_starts"": 247, ""market"": ""A""}",170.0,43.0,5.0,gnzz7gc4,vmu7c279,FULL STUDY,170.0,s2,1,100,70.0,1,30.0,1,buy,0,sell,0.5617190733230237,14,0,1,block 4 (G second),22.0,11.0,Male,1.0,0.0,0.0,"[4, 'block 4 (G second)']",1,1,1,0.0,5.0,-0.41666666666666663,0.25,0.05263157894736842,1.0,0.0,3,0.75,0.0,Design 2,Design 2,"Have an option between Design #1 and Design #2,",3.0,,
1383,2449,4,Player object (1150),buy,2023-03-08 05:24:07.699898+00:00,"{""priceA"": 75, ""sharesA"": 1, ""secs_since_round_starts"": 303, ""market"": ""A""}",95.0,53.0,6.0,gnzz7gc4,vmu7c279,FULL STUDY,170.0,s2,1,75,100.0,-1,,1,sell,0,sell,0.4439854633835125,14,1,0,block 4 (G second),22.0,11.0,Male,1.0,0.0,0.0,"[4, 'block 4 (G second)']",1,1,1,0.0,5.0,-0.41666666666666663,0.25,0.05263157894736842,1.0,0.0,3,0.75,0.0,Design 2,Design 2,"Have an option between Design #1 and Design #2,",3.0,,
1384,2453,5,Player object (1270),sell,2023-03-08 05:27:15.902329+00:00,"{""priceA"": 105, ""sharesA"": 0, ""secs_since_round_starts"": 140, ""market"": ""A""}",155.0,26.0,1.0,gnzz7gc4,vmu7c279,FULL STUDY,185.0,s2,1,105,,1,,1,,0,sell,0.5182690684964619,17,0,0,block 4 (G second),22.0,11.0,Male,1.0,0.0,0.0,"[5, 'block 4 (G second)']",1,0,1,0.0,5.0,-0.41666666666666663,0.08,0.0,0.0,0.0,2,1.0,0.0,Design 2,Design 2,"Have an option between Design #1 and Design #2,",3.0,,
1385,2454,5,Player object (1270),buy,2023-03-08 05:27:26.014353+00:00,"{""priceA"": 85, ""sharesA"": 1, ""secs_since_round_starts"": 150, ""market"": ""A""}",70.0,28.0,2.0,gnzz7gc4,vmu7c279,FULL STUDY,185.0,s2,1,85,105.0,-1,,1,sell,0,sell,0.4496194529460131,17,1,0,block 4 (G second),22.0,11.0,Male,1.0,0.0,0.0,"[5, 'block 4 (G second)']",1,0,1,0.0,5.0,-0.41666666666666663,0.08,0.0,0.0,0.0,2,1.0,0.0,Design 2,Design 2,"Have an option between Design #1 and Design #2,",3.0,,
1386,2456,5,Player object (1270),sell,2023-03-08 05:28:04.298962+00:00,"{""priceA"": 120, ""sharesA"": 0, ""secs_since_round_starts"": 189, ""market"": ""A""}",190.0,34.0,3.0,gnzz7gc4,vmu7c279,FULL STUDY,185.0,s2,1,120,85.0,1,35.0,1,buy,0,sell,0.5679672812132522,17,0,0,block 4 (G second),22.0,11.0,Male,1.0,0.0,0.0,"[5, 'block 4 (G second)']",1,0,1,0.0,5.0,-0.41666666666666663,0.08,0.0,0.0,0.0,2,1.0,0.0,Design 2,Design 2,"Have an option between Design #1 and Design #2,",3.0,,
1387,2457,5,Player object (1270),buy,2023-03-08 05:28:30.872571+00:00,"{""priceA"": 70, ""sharesA"": 1, ""secs_since_round_starts"": 215, ""market"": ""A""}",120.0,39.0,4.0,gnzz7gc4,vmu7c279,FULL STUDY,185.0,s2,1,70,120.0,-1,,1,sell,0,sell,0.4317803147869401,17,0,0,block 4 (G second),22.0,11.0,Male,1.0,0.0,0.0,"[5, 'block 4 (G second)']",1,0,1,0.0,5.0,-0.41666666666666663,0.08,0.0,0.0,0.0,2,1.0,0.0,Design 2,Design 2,"Have an option between Design #1 and Design #2,",3.0,,
1388,3186,2,Player object (923),sell,2023-03-09 01:18:28.843701+00:00,"{""priceA"": 85, ""sharesA"": 0, ""secs_since_round_starts"": 111, ""market"": ""A""}",135.0,8.0,1.0,gy1a20qq,vmu7c279,FULL STUDY,180.0,s3,1,85,,1,,1,,0,sell,0.4422758127435268,16,1,0,block 2 (G first),20.0,12.0,Female,1.0,0.0,0.0,"[2, 'block 2 (G first)']",1,1,0,0.5,7.0,-0.30000000000000004,0.38461538461538464,0.16666666666666666,0.0,0.25,4,1.0,0.5,Design 1,Design 2,"Have an option between Design #1 and Design #2,",4.0,3.0,4.0
1389,3187,2,Player object (923),buy,2023-03-09 01:18:34.273319+00:00,"{""priceA"": 70, ""sharesA"": 1, ""secs_since_round_starts"": 117, ""market"": ""A""}",65.0,9.0,2.0,gy1a20qq,vmu7c279,FULL STUDY,180.0,s3,1,70,85.0,-1,,1,sell,0,sell,0.4254536939069079,16,0,0,block 2 (G first),20.0,12.0,Female,1.0,0.0,0.0,"[2, 'block 2 (G first)']",1,1,0,0.5,7.0,-0.30000000000000004,0.38461538461538464,0.16666666666666666,0.0,0.25,4,1.0,0.5,Design 1,Design 2,"Have an option between Design #1 and Design #2,",4.0,3.0,4.0
1390,3188,2,Player object (923),sell,2023-03-09 01:18:45.204481+00:00,"{""priceA"": 65, ""sharesA"": 0, ""secs_since_round_starts"": 128, ""market"": ""A""}",130.0,11.0,3.0,gy1a20qq,vmu7c279,FULL STUDY,180.0,s3,1,65,70.0,1,-5.0,1,buy,0,sell,0.4529543903039196,16,0,0,block 2 (G first),20.0,12.0,Female,1.0,0.0,0.0,"[2, 'block 2 (G first)']",1,1,0,0.5,7.0,-0.30000000000000004,0.38461538461538464,0.16666666666666666,0.0,0.25,4,1.0,0.5,Design 1,Design 2,"Have an option between Design #1 and Design #2,",4.0,3.0,4.0
1391,3189,2,Player object (923),buy,2023-03-09 01:19:01.659775+00:00,"{""priceA"": 105, ""sharesA"": 1, ""secs_since_round_starts"": 144, ""market"": ""A""}",25.0,14.0,4.0,gy1a20qq,vmu7c279,FULL STUDY,180.0,s3,1,105,65.0,-1,,1,sell,0,sell,0.5600744319669811,16,0,1,block 2 (G first),20.0,12.0,Female,1.0,0.0,0.0,"[2, 'block 2 (G first)']",1,1,0,0.5,7.0,-0.30000000000000004,0.38461538461538464,0.16666666666666666,0.0,0.25,4,1.0,0.5,Design 1,Design 2,"Have an option between Design #1 and Design #2,",4.0,3.0,4.0
1392,3191,2,Player object (923),sell,2023-03-09 01:19:05.235874+00:00,"{""priceA"": 120, ""sharesA"": 0, ""secs_since_round_starts"": 148, ""market"": ""A""}",145.0,15.0,5.0,gy1a20qq,vmu7c279,FULL STUDY,180.0,s3,1,120,105.0,1,15.0,1,buy,0,sell,0.5761373211134116,16,0,0,block 2 (G first),20.0,12.0,Female,1.0,0.0,0.0,"[2, 'block 2 (G first)']",1,1,0,0.5,7.0,-0.30000000000000004,0.38461538461538464,0.16666666666666666,0.0,0.25,4,1.0,0.5,Design 1,Design 2,"Have an option between Design #1 and Design #2,",4.0,3.0,4.0
1393,3192,2,Player object (923),buy,2023-03-09 01:19:11.517093+00:00,"{""priceA"": 105, ""sharesA"": 1, ""secs_since_round_starts"": 154, ""market"": ""A""}",40.0,16.0,6.0,gy1a20qq,vmu7c279,FULL STUDY,180.0,s3,1,105,120.0,-1,,1,sell,0,sell,0.5185790363913291,16,0,0,block 2 (G first),20.0,12.0,Female,1.0,0.0,0.0,"[2, 'block 2 (G first)']",1,1,0,0.5,7.0,-0.30000000000000004,0.38461538461538464,0.16666666666666666,0.0,0.25,4,1.0,0.5,Design 1,Design 2,"Have an option between Design #1 and Design #2,",4.0,3.0,4.0
1394,3194,2,Player object (923),sell,2023-03-09 01:19:16.526979+00:00,"{""priceA"": 110, ""sharesA"": 0, ""secs_since_round_starts"": 159, ""market"": ""A""}",150.0,17.0,7.0,gy1a20qq,vmu7c279,FULL STUDY,180.0,s3,1,110,105.0,1,5.0,1,buy,0,sell,0.5478276073026133,16,0,0,block 2 (G first),20.0,12.0,Female,1.0,0.0,0.0,"[2, 'block 2 (G first)']",1,1,0,0.5,7.0,-0.30000000000000004,0.38461538461538464,0.16666666666666666,0.0,0.25,4,1.0,0.5,Design 1,Design 2,"Have an option between Design #1 and Design #2,",4.0,3.0,4.0
1395,3197,2,Player object (923),buy,2023-03-09 01:20:12.301744+00:00,"{""priceA"": 125, ""sharesA"": 1, ""secs_since_round_starts"": 215, ""market"": ""A""}",25.0,27.0,8.0,gy1a20qq,vmu7c279,FULL STUDY,180.0,s3,1,125,110.0,-1,,1,sell,0,sell,0.4549942201992644,16,1,0,block 2 (G first),20.0,12.0,Female,1.0,0.0,0.0,"[2, 'block 2 (G first)']",1,1,0,0.5,7.0,-0.30000000000000004,0.38461538461538464,0.16666666666666666,0.0,0.25,4,1.0,0.5,Design 1,Design 2,"Have an option between Design #1 and Design #2,",4.0,3.0,4.0
1396,3206,2,Player object (923),sell,2023-03-09 01:21:27.770757+00:00,"{""priceA"": 140, ""sharesA"": 0, ""secs_since_round_starts"": 290, ""market"": ""A""}",165.0,35.0,9.0,gy1a20qq,vmu7c279,FULL STUDY,180.0,s3,1,140,125.0,1,15.0,1,buy,0,sell,0.5101876173062244,16,0,0,block 2 (G first),20.0,12.0,Female,1.0,0.0,0.0,"[2, 'block 2 (G first)']",1,1,0,0.5,7.0,-0.30000000000000004,0.38461538461538464,0.16666666666666666,0.0,0.25,4,1.0,0.5,Design 1,Design 2,"Have an option between Design #1 and Design #2,",4.0,3.0,4.0
1397,3207,2,Player object (923),buy,2023-03-09 01:21:50.877198+00:00,"{""priceA"": 125, ""sharesA"": 1, ""secs_since_round_starts"": 313, ""market"": ""A""}",40.0,39.0,10.0,gy1a20qq,vmu7c279,FULL STUDY,180.0,s3,1,125,140.0,-1,,1,sell,0,sell,0.4382592777609274,16,1,0,block 2 (G first),20.0,12.0,Female,1.0,0.0,0.0,"[2, 'block 2 (G first)']",1,1,0,0.5,7.0,-0.30000000000000004,0.38461538461538464,0.16666666666666666,0.0,0.25,4,1.0,0.5,Design 1,Design 2,"Have an option between Design #1 and Design #2,",4.0,3.0,4.0
1398,3210,2,Player object (923),sell,2023-03-09 01:22:01.354004+00:00,"{""priceA"": 140, ""sharesA"": 0, ""secs_since_round_starts"": 324, ""market"": ""A""}",180.0,40.0,11.0,gy1a20qq,vmu7c279,FULL STUDY,180.0,s3,1,140,125.0,1,15.0,1,buy,0,sell,0.4916787423410894,16,0,0,block 2 (G first),20.0,12.0,Female,1.0,0.0,0.0,"[2, 'block 2 (G first)']",1,1,0,0.5,7.0,-0.30000000000000004,0.38461538461538464,0.16666666666666666,0.0,0.25,4,1.0,0.5,Design 1,Design 2,"Have an option between Design #1 and Design #2,",4.0,3.0,4.0
1399,3211,2,Player object (923),buy,2023-03-09 01:22:16.885436+00:00,"{""priceA"": 125, ""sharesA"": 1, ""secs_since_round_starts"": 339, ""market"": ""A""}",55.0,43.0,12.0,gy1a20qq,vmu7c279,FULL STUDY,180.0,s3,1,125,140.0,-1,,1,sell,0,sell,0.4218732662739463,16,1,0,block 2 (G first),20.0,12.0,Female,1.0,0.0,0.0,"[2, 'block 2 (G first)']",1,1,0,0.5,7.0,-0.30000000000000004,0.38461538461538464,0.16666666666666666,0.0,0.25,4,1.0,0.5,Design 1,Design 2,"Have an option between Design #1 and Design #2,",4.0,3.0,4.0
1400,3213,2,Player object (923),sell,2023-03-09 01:22:28.307617+00:00,"{""priceA"": 140, ""sharesA"": 0, ""secs_since_round_starts"": 351, ""market"": ""A""}",195.0,45.0,13.0,gy1a20qq,vmu7c279,FULL STUDY,180.0,s3,1,140,125.0,1,15.0,1,buy,0,sell,0.5210834711709403,16,0,0,block 2 (G first),20.0,12.0,Female,1.0,0.0,0.0,"[2, 'block 2 (G first)']",1,1,0,0.5,7.0,-0.30000000000000004,0.38461538461538464,0.16666666666666666,0.0,0.25,4,1.0,0.5,Design 1,Design 2,"Have an option between Design #1 and Design #2,",4.0,3.0,4.0
1401,3216,2,Player object (923),buy,2023-03-09 01:23:01.309089+00:00,"{""priceA"": 140, ""sharesA"": 1, ""secs_since_round_starts"": 384, ""market"": ""A""}",55.0,51.0,14.0,gy1a20qq,vmu7c279,FULL STUDY,180.0,s3,1,140,140.0,-1,,1,sell,0,sell,0.4693918893964308,16,0,0,block 2 (G first),20.0,12.0,Female,1.0,0.0,0.0,"[2, 'block 2 (G first)']",1,1,0,0.5,7.0,-0.30000000000000004,0.38461538461538464,0.16666666666666666,0.0,0.25,4,1.0,0.5,Design 1,Design 2,"Have an option between Design #1 and Design #2,",4.0,3.0,4.0
1402,3227,3,Player object (1043),sell,2023-03-09 01:25:20.962863+00:00,"{""priceA"": 120, ""sharesA"": 0, ""secs_since_round_starts"": 68, ""market"": ""A""}",170.0,12.0,4.0,gy1a20qq,vmu7c279,FULL STUDY,255.0,s3,1,120,110.0,1,10.0,1,,0,sell,0.5553867656170776,19,0,0,block 2 (G first),20.0,12.0,Female,1.0,0.0,0.0,"[3, 'block 2 (G first)']",1,0,0,0.0,7.0,-0.30000000000000004,0.5,0.0,1.0,0.0,4,1.0,0.5,Design 1,Design 2,"Have an option between Design #1 and Design #2,",4.0,3.0,4.0
1403,3228,3,Player object (1043),buy,2023-03-09 01:25:37.746279+00:00,"{""priceA"": 110, ""sharesA"": 1, ""secs_since_round_starts"": 85, ""market"": ""A""}",60.0,15.0,5.0,gy1a20qq,vmu7c279,FULL STUDY,255.0,s3,1,110,120.0,-1,,1,sell,0,sell,0.4763410641166328,19,0,0,block 2 (G first),20.0,12.0,Female,1.0,0.0,0.0,"[3, 'block 2 (G first)']",1,0,0,0.0,7.0,-0.30000000000000004,0.5,0.0,1.0,0.0,4,1.0,0.5,Design 1,Design 2,"Have an option between Design #1 and Design #2,",4.0,3.0,4.0
1404,3229,3,Player object (1043),sell,2023-03-09 01:26:01.093648+00:00,"{""priceA"": 120, ""sharesA"": 0, ""secs_since_round_starts"": 109, ""market"": ""A""}",180.0,19.0,6.0,gy1a20qq,vmu7c279,FULL STUDY,255.0,s3,1,120,110.0,1,10.0,1,buy,0,sell,0.5586446427659006,19,0,1,block 2 (G first),20.0,12.0,Female,1.0,0.0,0.0,"[3, 'block 2 (G first)']",1,0,0,0.0,7.0,-0.30000000000000004,0.5,0.0,1.0,0.0,4,1.0,0.5,Design 1,Design 2,"Have an option between Design #1 and Design #2,",4.0,3.0,4.0
1405,3230,3,Player object (1043),buy,2023-03-09 01:26:10.495701+00:00,"{""priceA"": 100, ""sharesA"": 1, ""secs_since_round_starts"": 118, ""market"": ""A""}",80.0,21.0,7.0,gy1a20qq,vmu7c279,FULL STUDY,255.0,s3,1,100,120.0,-1,,1,sell,0,sell,0.4692484881524699,19,0,0,block 2 (G first),20.0,12.0,Female,1.0,0.0,0.0,"[3, 'block 2 (G first)']",1,0,0,0.0,7.0,-0.30000000000000004,0.5,0.0,1.0,0.0,4,1.0,0.5,Design 1,Design 2,"Have an option between Design #1 and Design #2,",4.0,3.0,4.0
1406,3231,3,Player object (1043),sell,2023-03-09 01:26:26.916070+00:00,"{""priceA"": 115, ""sharesA"": 0, ""secs_since_round_starts"": 134, ""market"": ""A""}",195.0,24.0,8.0,gy1a20qq,vmu7c279,FULL STUDY,255.0,s3,1,115,100.0,1,15.0,1,buy,0,sell,0.5319650978870379,19,0,0,block 2 (G first),20.0,12.0,Female,1.0,0.0,0.0,"[3, 'block 2 (G first)']",1,0,0,0.0,7.0,-0.30000000000000004,0.5,0.0,1.0,0.0,4,1.0,0.5,Design 1,Design 2,"Have an option between Design #1 and Design #2,",4.0,3.0,4.0
1407,3232,3,Player object (1043),buy,2023-03-09 01:26:44.659265+00:00,"{""priceA"": 105, ""sharesA"": 1, ""secs_since_round_starts"": 152, ""market"": ""A""}",90.0,27.0,9.0,gy1a20qq,vmu7c279,FULL STUDY,255.0,s3,1,105,115.0,-1,,1,sell,0,sell,0.4832330156747784,19,0,0,block 2 (G first),20.0,12.0,Female,1.0,0.0,0.0,"[3, 'block 2 (G first)']",1,0,0,0.0,7.0,-0.30000000000000004,0.5,0.0,1.0,0.0,4,1.0,0.5,Design 1,Design 2,"Have an option between Design #1 and Design #2,",4.0,3.0,4.0
1408,3233,3,Player object (1043),sell,2023-03-09 01:26:54.593930+00:00,"{""priceA"": 115, ""sharesA"": 0, ""secs_since_round_starts"": 162, ""market"": ""A""}",205.0,29.0,10.0,gy1a20qq,vmu7c279,FULL STUDY,255.0,s3,1,115,105.0,1,10.0,1,buy,0,sell,0.5511004178331719,19,0,0,block 2 (G first),20.0,12.0,Female,1.0,0.0,0.0,"[3, 'block 2 (G first)']",1,0,0,0.0,7.0,-0.30000000000000004,0.5,0.0,1.0,0.0,4,1.0,0.5,Design 1,Design 2,"Have an option between Design #1 and Design #2,",4.0,3.0,4.0
1409,3236,3,Player object (1043),buy,2023-03-09 01:27:29.324660+00:00,"{""priceA"": 100, ""sharesA"": 1, ""secs_since_round_starts"": 197, ""market"": ""A""}",105.0,33.0,11.0,gy1a20qq,vmu7c279,FULL STUDY,255.0,s3,1,100,115.0,-1,,1,sell,0,sell,0.4476889957041811,19,1,0,block 2 (G first),20.0,12.0,Female,1.0,0.0,0.0,"[3, 'block 2 (G first)']",1,0,0,0.0,7.0,-0.30000000000000004,0.5,0.0,1.0,0.0,4,1.0,0.5,Design 1,Design 2,"Have an option between Design #1 and Design #2,",4.0,3.0,4.0
1410,3237,3,Player object (1043),sell,2023-03-09 01:28:02.315558+00:00,"{""priceA"": 115, ""sharesA"": 0, ""secs_since_round_starts"": 230, ""market"": ""A""}",220.0,39.0,12.0,gy1a20qq,vmu7c279,FULL STUDY,255.0,s3,1,115,100.0,1,15.0,1,buy,0,sell,0.5221490272476892,19,0,0,block 2 (G first),20.0,12.0,Female,1.0,0.0,0.0,"[3, 'block 2 (G first)']",1,0,0,0.0,7.0,-0.30000000000000004,0.5,0.0,1.0,0.0,4,1.0,0.5,Design 1,Design 2,"Have an option between Design #1 and Design #2,",4.0,3.0,4.0
1411,3238,3,Player object (1043),buy,2023-03-09 01:28:08.996870+00:00,"{""priceA"": 100, ""sharesA"": 1, ""secs_since_round_starts"": 236, ""market"": ""A""}",120.0,40.0,13.0,gy1a20qq,vmu7c279,FULL STUDY,255.0,s3,1,100,115.0,-1,,1,sell,0,sell,0.4804175727303482,19,0,0,block 2 (G first),20.0,12.0,Female,1.0,0.0,0.0,"[3, 'block 2 (G first)']",1,0,0,0.0,7.0,-0.30000000000000004,0.5,0.0,1.0,0.0,4,1.0,0.5,Design 1,Design 2,"Have an option between Design #1 and Design #2,",4.0,3.0,4.0
1412,3239,3,Player object (1043),sell,2023-03-09 01:28:23.901380+00:00,"{""priceA"": 120, ""sharesA"": 0, ""secs_since_round_starts"": 251, ""market"": ""A""}",240.0,43.0,14.0,gy1a20qq,vmu7c279,FULL STUDY,255.0,s3,1,120,100.0,1,20.0,1,buy,0,sell,0.5357259670782416,19,0,0,block 2 (G first),20.0,12.0,Female,1.0,0.0,0.0,"[3, 'block 2 (G first)']",1,0,0,0.0,7.0,-0.30000000000000004,0.5,0.0,1.0,0.0,4,1.0,0.5,Design 1,Design 2,"Have an option between Design #1 and Design #2,",4.0,3.0,4.0
1413,3240,3,Player object (1043),buy,2023-03-09 01:28:57.209022+00:00,"{""priceA"": 110, ""sharesA"": 1, ""secs_since_round_starts"": 285, ""market"": ""A""}",130.0,49.0,15.0,gy1a20qq,vmu7c279,FULL STUDY,255.0,s3,1,110,120.0,-1,,1,sell,0,sell,0.4374794566672981,19,1,0,block 2 (G first),20.0,12.0,Female,1.0,0.0,0.0,"[3, 'block 2 (G first)']",1,0,0,0.0,7.0,-0.30000000000000004,0.5,0.0,1.0,0.0,4,1.0,0.5,Design 1,Design 2,"Have an option between Design #1 and Design #2,",4.0,3.0,4.0
1414,3242,3,Player object (1043),sell,2023-03-09 01:29:07.583049+00:00,"{""priceA"": 125, ""sharesA"": 0, ""secs_since_round_starts"": 295, ""market"": ""A""}",255.0,50.0,16.0,gy1a20qq,vmu7c279,FULL STUDY,255.0,s3,1,125,110.0,1,15.0,1,buy,0,sell,0.4911246412164243,19,0,0,block 2 (G first),20.0,12.0,Female,1.0,0.0,0.0,"[3, 'block 2 (G first)']",1,0,0,0.0,7.0,-0.30000000000000004,0.5,0.0,1.0,0.0,4,1.0,0.5,Design 1,Design 2,"Have an option between Design #1 and Design #2,",4.0,3.0,4.0
1415,3243,3,Player object (1043),buy,2023-03-09 01:29:50.434445+00:00,"{""priceA"": 115, ""sharesA"": 1, ""secs_since_round_starts"": 338, ""market"": ""A""}",140.0,58.0,17.0,gy1a20qq,vmu7c279,FULL STUDY,255.0,s3,1,115,125.0,-1,,1,sell,0,sell,0.442461876115205,19,1,0,block 2 (G first),20.0,12.0,Female,1.0,0.0,0.0,"[3, 'block 2 (G first)']",1,0,0,0.0,7.0,-0.30000000000000004,0.5,0.0,1.0,0.0,4,1.0,0.5,Design 1,Design 2,"Have an option between Design #1 and Design #2,",4.0,3.0,4.0
1416,3247,4,Player object (1163),sell,2023-03-09 01:31:12.246611+00:00,"{""priceA"": 80, ""sharesA"": 0, ""secs_since_round_starts"": 57, ""market"": ""A""}",130.0,10.0,1.0,gy1a20qq,vmu7c279,FULL STUDY,140.0,s3,1,80,,1,,1,,0,sell,0.5652817482669988,14,0,0,block 2 (G first),20.0,12.0,Female,1.0,0.0,0.0,"[4, 'block 2 (G first)']",0,1,0,0.5,7.0,-0.30000000000000004,0.4,0.08,,0.16666666666666666,2,1.0,0.5,Design 1,Design 2,"Have an option between Design #1 and Design #2,",4.0,3.0,4.0
1417,3248,4,Player object (1163),buy,2023-03-09 01:31:22.380666+00:00,"{""priceA"": 90, ""sharesA"": 1, ""secs_since_round_starts"": 67, ""market"": ""A""}",40.0,12.0,2.0,gy1a20qq,vmu7c279,FULL STUDY,140.0,s3,1,90,80.0,-1,,1,sell,0,sell,0.5210961257750505,14,0,0,block 2 (G first),20.0,12.0,Female,1.0,0.0,0.0,"[4, 'block 2 (G first)']",0,1,0,0.5,7.0,-0.30000000000000004,0.4,0.08,,0.16666666666666666,2,1.0,0.5,Design 1,Design 2,"Have an option between Design #1 and Design #2,",4.0,3.0,4.0
1418,3249,4,Player object (1163),sell,2023-03-09 01:32:52.389790+00:00,"{""priceA"": 80, ""sharesA"": 0, ""secs_since_round_starts"": 157, ""market"": ""A""}",120.0,28.0,3.0,gy1a20qq,vmu7c279,FULL STUDY,140.0,s3,1,80,90.0,1,-10.0,1,buy,0,sell,0.5529051331090981,14,0,1,block 2 (G first),20.0,12.0,Female,1.0,0.0,0.0,"[4, 'block 2 (G first)']",0,1,0,0.5,7.0,-0.30000000000000004,0.4,0.08,,0.16666666666666666,2,1.0,0.5,Design 1,Design 2,"Have an option between Design #1 and Design #2,",4.0,3.0,4.0
1419,3251,4,Player object (1163),buy,2023-03-09 01:33:44.023252+00:00,"{""priceA"": 70, ""sharesA"": 1, ""secs_since_round_starts"": 209, ""market"": ""A""}",50.0,37.0,4.0,gy1a20qq,vmu7c279,FULL STUDY,140.0,s3,1,70,80.0,-1,,1,sell,0,sell,0.4570673777008929,14,0,0,block 2 (G first),20.0,12.0,Female,1.0,0.0,0.0,"[4, 'block 2 (G first)']",0,1,0,0.5,7.0,-0.30000000000000004,0.4,0.08,,0.16666666666666666,2,1.0,0.5,Design 1,Design 2,"Have an option between Design #1 and Design #2,",4.0,3.0,4.0
1420,3252,4,Player object (1163),sell,2023-03-09 01:34:02.931234+00:00,"{""priceA"": 75, ""sharesA"": 0, ""secs_since_round_starts"": 228, ""market"": ""A""}",125.0,40.0,5.0,gy1a20qq,vmu7c279,FULL STUDY,140.0,s3,1,75,70.0,1,5.0,1,buy,0,sell,0.4578892350765483,14,0,0,block 2 (G first),20.0,12.0,Female,1.0,0.0,0.0,"[4, 'block 2 (G first)']",0,1,0,0.5,7.0,-0.30000000000000004,0.4,0.08,,0.16666666666666666,2,1.0,0.5,Design 1,Design 2,"Have an option between Design #1 and Design #2,",4.0,3.0,4.0
1421,3253,4,Player object (1163),buy,2023-03-09 01:34:39.675409+00:00,"{""priceA"": 85, ""sharesA"": 1, ""secs_since_round_starts"": 264, ""market"": ""A""}",40.0,47.0,6.0,gy1a20qq,vmu7c279,FULL STUDY,140.0,s3,1,85,75.0,-1,,1,sell,0,sell,0.4501495476988393,14,1,0,block 2 (G first),20.0,12.0,Female,1.0,0.0,0.0,"[4, 'block 2 (G first)']",0,1,0,0.5,7.0,-0.30000000000000004,0.4,0.08,,0.16666666666666666,2,1.0,0.5,Design 1,Design 2,"Have an option between Design #1 and Design #2,",4.0,3.0,4.0
1422,3254,4,Player object (1163),sell,2023-03-09 01:34:44.401375+00:00,"{""priceA"": 100, ""sharesA"": 0, ""secs_since_round_starts"": 269, ""market"": ""A""}",140.0,48.0,7.0,gy1a20qq,vmu7c279,FULL STUDY,140.0,s3,1,100,85.0,1,15.0,1,buy,0,sell,0.500105737602651,14,0,0,block 2 (G first),20.0,12.0,Female,1.0,0.0,0.0,"[4, 'block 2 (G first)']",0,1,0,0.5,7.0,-0.30000000000000004,0.4,0.08,,0.16666666666666666,2,1.0,0.5,Design 1,Design 2,"Have an option between Design #1 and Design #2,",4.0,3.0,4.0
1423,3255,4,Player object (1163),buy,2023-03-09 01:35:11.177724+00:00,"{""priceA"": 75, ""sharesA"": 1, ""secs_since_round_starts"": 296, ""market"": ""A""}",65.0,53.0,8.0,gy1a20qq,vmu7c279,FULL STUDY,140.0,s3,1,75,100.0,-1,,1,sell,0,sell,0.4439854633835125,14,1,0,block 2 (G first),20.0,12.0,Female,1.0,0.0,0.0,"[4, 'block 2 (G first)']",0,1,0,0.5,7.0,-0.30000000000000004,0.4,0.08,,0.16666666666666666,2,1.0,0.5,Design 1,Design 2,"Have an option between Design #1 and Design #2,",4.0,3.0,4.0
1424,3259,5,Player object (1283),sell,2023-03-09 01:36:38.031176+00:00,"{""priceA"": 100, ""sharesA"": 0, ""secs_since_round_starts"": 32, ""market"": ""A""}",150.0,7.0,1.0,gy1a20qq,vmu7c279,FULL STUDY,205.0,s3,1,100,,1,,1,,0,sell,0.5733994727268583,17,0,0,block 2 (G first),20.0,12.0,Female,1.0,0.0,0.0,"[5, 'block 2 (G first)']",0,0,0,0.5,7.0,-0.30000000000000004,0.5,0.0,1.0,0.0,4,0.5,0.5,Design 1,Design 2,"Have an option between Design #1 and Design #2,",4.0,3.0,4.0
1425,3260,5,Player object (1283),buy,2023-03-09 01:37:41.001419+00:00,"{""priceA"": 70, ""sharesA"": 1, ""secs_since_round_starts"": 95, ""market"": ""A""}",80.0,18.0,2.0,gy1a20qq,vmu7c279,FULL STUDY,205.0,s3,1,70,100.0,-1,,1,sell,0,sell,0.42621223683237,17,1,0,block 2 (G first),20.0,12.0,Female,1.0,0.0,0.0,"[5, 'block 2 (G first)']",0,0,0,0.5,7.0,-0.30000000000000004,0.5,0.0,1.0,0.0,4,0.5,0.5,Design 1,Design 2,"Have an option between Design #1 and Design #2,",4.0,3.0,4.0
1426,3261,5,Player object (1283),sell,2023-03-09 01:37:51.136073+00:00,"{""priceA"": 95, ""sharesA"": 0, ""secs_since_round_starts"": 105, ""market"": ""A""}",175.0,20.0,3.0,gy1a20qq,vmu7c279,FULL STUDY,205.0,s3,1,95,70.0,1,25.0,1,buy,0,sell,0.5232479875730728,17,0,0,block 2 (G first),20.0,12.0,Female,1.0,0.0,0.0,"[5, 'block 2 (G first)']",0,0,0,0.5,7.0,-0.30000000000000004,0.5,0.0,1.0,0.0,4,0.5,0.5,Design 1,Design 2,"Have an option between Design #1 and Design #2,",4.0,3.0,4.0
1427,3262,5,Player object (1283),buy,2023-03-09 01:38:42.184873+00:00,"{""priceA"": 80, ""sharesA"": 1, ""secs_since_round_starts"": 156, ""market"": ""A""}",95.0,29.0,4.0,gy1a20qq,vmu7c279,FULL STUDY,205.0,s3,1,80,95.0,-1,,1,sell,0,sell,0.4304345659865384,17,0,0,block 2 (G first),20.0,12.0,Female,1.0,0.0,0.0,"[5, 'block 2 (G first)']",0,0,0,0.5,7.0,-0.30000000000000004,0.5,0.0,1.0,0.0,4,0.5,0.5,Design 1,Design 2,"Have an option between Design #1 and Design #2,",4.0,3.0,4.0
1428,3264,5,Player object (1283),sell,2023-03-09 01:38:57.944696+00:00,"{""priceA"": 95, ""sharesA"": 0, ""secs_since_round_starts"": 172, ""market"": ""A""}",190.0,32.0,5.0,gy1a20qq,vmu7c279,FULL STUDY,205.0,s3,1,95,80.0,1,15.0,1,buy,0,sell,0.5188715333997952,17,0,0,block 2 (G first),20.0,12.0,Female,1.0,0.0,0.0,"[5, 'block 2 (G first)']",0,0,0,0.5,7.0,-0.30000000000000004,0.5,0.0,1.0,0.0,4,0.5,0.5,Design 1,Design 2,"Have an option between Design #1 and Design #2,",4.0,3.0,4.0
1429,3265,5,Player object (1283),buy,2023-03-09 01:39:25.211957+00:00,"{""priceA"": 95, ""sharesA"": 1, ""secs_since_round_starts"": 199, ""market"": ""A""}",95.0,37.0,6.0,gy1a20qq,vmu7c279,FULL STUDY,205.0,s3,1,95,95.0,-1,,1,sell,0,sell,0.4805886028013266,17,0,0,block 2 (G first),20.0,12.0,Female,1.0,0.0,0.0,"[5, 'block 2 (G first)']",0,0,0,0.5,7.0,-0.30000000000000004,0.5,0.0,1.0,0.0,4,0.5,0.5,Design 1,Design 2,"Have an option between Design #1 and Design #2,",4.0,3.0,4.0
1430,3266,5,Player object (1283),sell,2023-03-09 01:39:53.357708+00:00,"{""priceA"": 100, ""sharesA"": 0, ""secs_since_round_starts"": 227, ""market"": ""A""}",195.0,42.0,7.0,gy1a20qq,vmu7c279,FULL STUDY,205.0,s3,1,100,95.0,1,5.0,1,buy,0,sell,0.5529358605422235,17,0,1,block 2 (G first),20.0,12.0,Female,1.0,0.0,0.0,"[5, 'block 2 (G first)']",0,0,0,0.5,7.0,-0.30000000000000004,0.5,0.0,1.0,0.0,4,0.5,0.5,Design 1,Design 2,"Have an option between Design #1 and Design #2,",4.0,3.0,4.0
1431,3267,5,Player object (1283),buy,2023-03-09 01:40:24.721860+00:00,"{""priceA"": 75, ""sharesA"": 1, ""secs_since_round_starts"": 259, ""market"": ""A""}",120.0,48.0,8.0,gy1a20qq,vmu7c279,FULL STUDY,205.0,s3,1,75,100.0,-1,,1,sell,0,sell,0.4393932183506925,17,1,0,block 2 (G first),20.0,12.0,Female,1.0,0.0,0.0,"[5, 'block 2 (G first)']",0,0,0,0.5,7.0,-0.30000000000000004,0.5,0.0,1.0,0.0,4,0.5,0.5,Design 1,Design 2,"Have an option between Design #1 and Design #2,",4.0,3.0,4.0
1432,3268,5,Player object (1283),sell,2023-03-09 01:40:46.429645+00:00,"{""priceA"": 95, ""sharesA"": 0, ""secs_since_round_starts"": 280, ""market"": ""A""}",215.0,52.0,9.0,gy1a20qq,vmu7c279,FULL STUDY,205.0,s3,1,95,75.0,1,20.0,1,buy,0,sell,0.5397855680881701,17,0,0,block 2 (G first),20.0,12.0,Female,1.0,0.0,0.0,"[5, 'block 2 (G first)']",0,0,0,0.5,7.0,-0.30000000000000004,0.5,0.0,1.0,0.0,4,0.5,0.5,Design 1,Design 2,"Have an option between Design #1 and Design #2,",4.0,3.0,4.0
1433,3269,5,Player object (1283),buy,2023-03-09 01:41:19.872595+00:00,"{""priceA"": 75, ""sharesA"": 1, ""secs_since_round_starts"": 314, ""market"": ""A""}",140.0,58.0,10.0,gy1a20qq,vmu7c279,FULL STUDY,205.0,s3,1,75,95.0,-1,,1,sell,0,sell,0.4529558772574278,17,0,0,block 2 (G first),20.0,12.0,Female,1.0,0.0,0.0,"[5, 'block 2 (G first)']",0,0,0,0.5,7.0,-0.30000000000000004,0.5,0.0,1.0,0.0,4,0.5,0.5,Design 1,Design 2,"Have an option between Design #1 and Design #2,",4.0,3.0,4.0
1434,572,2,Player object (860),sell,2023-03-01 23:01:08.291641+00:00,"{""priceA"": 110, ""sharesA"": 0, ""secs_since_round_starts"": 50, ""market"": ""A""}",160.0,6.0,1.0,hre8fq8i,vmu7c279,FULL STUDY,165.0,s1,1,110,,1,,1,,0,sell,0.5028735207100592,16,0,0,block 4 (G second),22.0,12.0,Female,1.0,1.0,1.0,"[2, 'block 4 (G second)']",0,1,1,0.0,6.0,-0.4,0.2857142857142857,0.21428571428571427,0.0,0.25,4,1.0,0.5,Design 1,Design 1,"Have an option between Design #1 and Design #2,",,3.0,2.0
1435,573,2,Player object (860),buy,2023-03-01 23:01:12.408458+00:00,"{""priceA"": 100, ""sharesA"": 1, ""secs_since_round_starts"": 54, ""market"": ""A""}",60.0,7.0,2.0,hre8fq8i,vmu7c279,FULL STUDY,165.0,s1,1,100,110.0,-1,,1,sell,0,sell,0.4669924949471701,16,0,0,block 4 (G second),22.0,12.0,Female,1.0,1.0,1.0,"[2, 'block 4 (G second)']",0,1,1,0.0,6.0,-0.4,0.2857142857142857,0.21428571428571427,0.0,0.25,4,1.0,0.5,Design 1,Design 1,"Have an option between Design #1 and Design #2,",,3.0,2.0
1436,574,2,Player object (860),sell,2023-03-01 23:01:35.286868+00:00,"{""priceA"": 65, ""sharesA"": 0, ""secs_since_round_starts"": 77, ""market"": ""A""}",125.0,11.0,3.0,hre8fq8i,vmu7c279,FULL STUDY,165.0,s1,1,65,100.0,1,-35.0,1,buy,0,sell,0.4529543903039196,16,0,0,block 4 (G second),22.0,12.0,Female,1.0,1.0,1.0,"[2, 'block 4 (G second)']",0,1,1,0.0,6.0,-0.4,0.2857142857142857,0.21428571428571427,0.0,0.25,4,1.0,0.5,Design 1,Design 1,"Have an option between Design #1 and Design #2,",,3.0,2.0
1437,575,2,Player object (860),buy,2023-03-01 23:01:41.610487+00:00,"{""priceA"": 80, ""sharesA"": 1, ""secs_since_round_starts"": 83, ""market"": ""A""}",45.0,12.0,4.0,hre8fq8i,vmu7c279,FULL STUDY,165.0,s1,1,80,65.0,-1,,1,sell,0,sell,0.502087716794639,16,0,0,block 4 (G second),22.0,12.0,Female,1.0,1.0,1.0,"[2, 'block 4 (G second)']",0,1,1,0.0,6.0,-0.4,0.2857142857142857,0.21428571428571427,0.0,0.25,4,1.0,0.5,Design 1,Design 1,"Have an option between Design #1 and Design #2,",,3.0,2.0
1438,576,2,Player object (860),sell,2023-03-01 23:02:00.766313+00:00,"{""priceA"": 105, ""sharesA"": 0, ""secs_since_round_starts"": 102, ""market"": ""A""}",150.0,16.0,5.0,hre8fq8i,vmu7c279,FULL STUDY,165.0,s1,1,105,80.0,1,25.0,1,buy,0,sell,0.5185790363913291,16,0,0,block 4 (G second),22.0,12.0,Female,1.0,1.0,1.0,"[2, 'block 4 (G second)']",0,1,1,0.0,6.0,-0.4,0.2857142857142857,0.21428571428571427,0.0,0.25,4,1.0,0.5,Design 1,Design 1,"Have an option between Design #1 and Design #2,",,3.0,2.0
1439,577,2,Player object (860),buy,2023-03-01 23:02:43.402138+00:00,"{""priceA"": 150, ""sharesA"": 1, ""secs_since_round_starts"": 145, ""market"": ""A""}",,23.0,6.0,hre8fq8i,vmu7c279,FULL STUDY,165.0,s1,1,150,105.0,-1,,1,sell,0,sell,0.5825581483921976,16,0,1,block 4 (G second),22.0,12.0,Female,1.0,1.0,1.0,"[2, 'block 4 (G second)']",0,1,1,0.0,6.0,-0.4,0.2857142857142857,0.21428571428571427,0.0,0.25,4,1.0,0.5,Design 1,Design 1,"Have an option between Design #1 and Design #2,",,3.0,2.0
1440,581,2,Player object (860),sell,2023-03-01 23:03:41.211266+00:00,"{""priceA"": 130, ""sharesA"": 0, ""secs_since_round_starts"": 203, ""market"": ""A""}",130.0,33.0,8.0,hre8fq8i,vmu7c279,FULL STUDY,165.0,s1,1,130,125.0,1,5.0,1,buy,0,sell,0.499206602391208,16,0,0,block 4 (G second),22.0,12.0,Female,1.0,1.0,1.0,"[2, 'block 4 (G second)']",0,1,1,0.0,6.0,-0.4,0.2857142857142857,0.21428571428571427,0.0,0.25,4,1.0,0.5,Design 1,Design 1,"Have an option between Design #1 and Design #2,",,3.0,2.0
1441,582,2,Player object (860),buy,2023-03-01 23:03:52.053518+00:00,"{""priceA"": 140, ""sharesA"": 1, ""secs_since_round_starts"": 214, ""market"": ""A""}",-10.0,35.0,9.0,hre8fq8i,vmu7c279,FULL STUDY,165.0,s1,1,140,130.0,-1,,1,sell,0,sell,0.5101876173062244,16,0,0,block 4 (G second),22.0,12.0,Female,1.0,1.0,1.0,"[2, 'block 4 (G second)']",0,1,1,0.0,6.0,-0.4,0.2857142857142857,0.21428571428571427,0.0,0.25,4,1.0,0.5,Design 1,Design 1,"Have an option between Design #1 and Design #2,",,3.0,2.0
1442,583,2,Player object (860),sell,2023-03-01 23:04:02.154076+00:00,"{""priceA"": 145, ""sharesA"": 0, ""secs_since_round_starts"": 224, ""market"": ""A""}",135.0,37.0,10.0,hre8fq8i,vmu7c279,FULL STUDY,165.0,s1,1,145,140.0,1,5.0,1,buy,0,sell,0.494384744736363,16,0,0,block 4 (G second),22.0,12.0,Female,1.0,1.0,1.0,"[2, 'block 4 (G second)']",0,1,1,0.0,6.0,-0.4,0.2857142857142857,0.21428571428571427,0.0,0.25,4,1.0,0.5,Design 1,Design 1,"Have an option between Design #1 and Design #2,",,3.0,2.0
1443,584,2,Player object (860),buy,2023-03-01 23:04:15.583374+00:00,"{""priceA"": 125, ""sharesA"": 1, ""secs_since_round_starts"": 237, ""market"": ""A""}",10.0,39.0,11.0,hre8fq8i,vmu7c279,FULL STUDY,165.0,s1,1,125,145.0,-1,,1,sell,0,sell,0.4382592777609274,16,1,0,block 4 (G second),22.0,12.0,Female,1.0,1.0,1.0,"[2, 'block 4 (G second)']",0,1,1,0.0,6.0,-0.4,0.2857142857142857,0.21428571428571427,0.0,0.25,4,1.0,0.5,Design 1,Design 1,"Have an option between Design #1 and Design #2,",,3.0,2.0
1444,585,2,Player object (860),sell,2023-03-01 23:04:23.979447+00:00,"{""priceA"": 135, ""sharesA"": 0, ""secs_since_round_starts"": 246, ""market"": ""A""}",145.0,41.0,12.0,hre8fq8i,vmu7c279,FULL STUDY,165.0,s1,1,135,125.0,1,10.0,1,buy,0,sell,0.4592429496222846,16,0,0,block 4 (G second),22.0,12.0,Female,1.0,1.0,1.0,"[2, 'block 4 (G second)']",0,1,1,0.0,6.0,-0.4,0.2857142857142857,0.21428571428571427,0.0,0.25,4,1.0,0.5,Design 1,Design 1,"Have an option between Design #1 and Design #2,",,3.0,2.0
1445,586,2,Player object (860),buy,2023-03-01 23:04:36.192204+00:00,"{""priceA"": 125, ""sharesA"": 1, ""secs_since_round_starts"": 258, ""market"": ""A""}",20.0,43.0,13.0,hre8fq8i,vmu7c279,FULL STUDY,165.0,s1,1,125,135.0,-1,,1,sell,0,sell,0.4218732662739463,16,1,0,block 4 (G second),22.0,12.0,Female,1.0,1.0,1.0,"[2, 'block 4 (G second)']",0,1,1,0.0,6.0,-0.4,0.2857142857142857,0.21428571428571427,0.0,0.25,4,1.0,0.5,Design 1,Design 1,"Have an option between Design #1 and Design #2,",,3.0,2.0
1446,587,2,Player object (860),sell,2023-03-01 23:04:57.239551+00:00,"{""priceA"": 140, ""sharesA"": 0, ""secs_since_round_starts"": 279, ""market"": ""A""}",160.0,47.0,14.0,hre8fq8i,vmu7c279,FULL STUDY,165.0,s1,1,140,125.0,1,15.0,1,buy,0,sell,0.4996814899229063,16,0,0,block 4 (G second),22.0,12.0,Female,1.0,1.0,1.0,"[2, 'block 4 (G second)']",0,1,1,0.0,6.0,-0.4,0.2857142857142857,0.21428571428571427,0.0,0.25,4,1.0,0.5,Design 1,Design 1,"Have an option between Design #1 and Design #2,",,3.0,2.0
1447,588,2,Player object (860),buy,2023-03-01 23:05:04.634079+00:00,"{""priceA"": 155, ""sharesA"": 1, ""secs_since_round_starts"": 286, ""market"": ""A""}",5.0,48.0,15.0,hre8fq8i,vmu7c279,FULL STUDY,165.0,s1,1,155,140.0,-1,,1,sell,0,sell,0.5347792584548927,16,0,0,block 4 (G second),22.0,12.0,Female,1.0,1.0,1.0,"[2, 'block 4 (G second)']",0,1,1,0.0,6.0,-0.4,0.2857142857142857,0.21428571428571427,0.0,0.25,4,1.0,0.5,Design 1,Design 1,"Have an option between Design #1 and Design #2,",,3.0,2.0
1448,589,2,Player object (860),sell,2023-03-01 23:05:13.510004+00:00,"{""priceA"": 155, ""sharesA"": 0, ""secs_since_round_starts"": 295, ""market"": ""A""}",160.0,50.0,16.0,hre8fq8i,vmu7c279,FULL STUDY,165.0,s1,1,155,155.0,1,0.0,1,buy,0,sell,0.5063294801170398,16,0,0,block 4 (G second),22.0,12.0,Female,1.0,1.0,1.0,"[2, 'block 4 (G second)']",0,1,1,0.0,6.0,-0.4,0.2857142857142857,0.21428571428571427,0.0,0.25,4,1.0,0.5,Design 1,Design 1,"Have an option between Design #1 and Design #2,",,3.0,2.0
1449,590,2,Player object (860),buy,2023-03-01 23:05:23.371193+00:00,"{""priceA"": 125, ""sharesA"": 1, ""secs_since_round_starts"": 305, ""market"": ""A""}",35.0,52.0,17.0,hre8fq8i,vmu7c279,FULL STUDY,165.0,s1,1,125,155.0,-1,,1,sell,0,sell,0.4439176376077041,16,1,0,block 4 (G second),22.0,12.0,Female,1.0,1.0,1.0,"[2, 'block 4 (G second)']",0,1,1,0.0,6.0,-0.4,0.2857142857142857,0.21428571428571427,0.0,0.25,4,1.0,0.5,Design 1,Design 1,"Have an option between Design #1 and Design #2,",,3.0,2.0
1450,591,2,Player object (860),sell,2023-03-01 23:05:40.883232+00:00,"{""priceA"": 135, ""sharesA"": 0, ""secs_since_round_starts"": 323, ""market"": ""A""}",170.0,55.0,18.0,hre8fq8i,vmu7c279,FULL STUDY,165.0,s1,1,135,125.0,1,10.0,1,buy,0,sell,0.4873282494519479,16,0,0,block 4 (G second),22.0,12.0,Female,1.0,1.0,1.0,"[2, 'block 4 (G second)']",0,1,1,0.0,6.0,-0.4,0.2857142857142857,0.21428571428571427,0.0,0.25,4,1.0,0.5,Design 1,Design 1,"Have an option between Design #1 and Design #2,",,3.0,2.0
1451,592,2,Player object (860),buy,2023-03-01 23:05:45.792384+00:00,"{""priceA"": 125, ""sharesA"": 1, ""secs_since_round_starts"": 327, ""market"": ""A""}",45.0,56.0,19.0,hre8fq8i,vmu7c279,FULL STUDY,165.0,s1,1,125,135.0,-1,,1,sell,0,sell,0.4562406760637778,16,0,0,block 4 (G second),22.0,12.0,Female,1.0,1.0,1.0,"[2, 'block 4 (G second)']",0,1,1,0.0,6.0,-0.4,0.2857142857142857,0.21428571428571427,0.0,0.25,4,1.0,0.5,Design 1,Design 1,"Have an option between Design #1 and Design #2,",,3.0,2.0
1452,593,2,Player object (860),sell,2023-03-01 23:05:51.715267+00:00,"{""priceA"": 110, ""sharesA"": 0, ""secs_since_round_starts"": 333, ""market"": ""A""}",155.0,57.0,20.0,hre8fq8i,vmu7c279,FULL STUDY,165.0,s1,1,110,125.0,1,-15.0,1,buy,0,sell,0.4349378880511929,16,1,0,block 4 (G second),22.0,12.0,Female,1.0,1.0,1.0,"[2, 'block 4 (G second)']",0,1,1,0.0,6.0,-0.4,0.2857142857142857,0.21428571428571427,0.0,0.25,4,1.0,0.5,Design 1,Design 1,"Have an option between Design #1 and Design #2,",,3.0,2.0
1453,594,2,Player object (860),buy,2023-03-01 23:05:55.884244+00:00,"{""priceA"": 115, ""sharesA"": 1, ""secs_since_round_starts"": 338, ""market"": ""A""}",40.0,58.0,21.0,hre8fq8i,vmu7c279,FULL STUDY,165.0,s1,1,115,110.0,-1,,1,sell,0,sell,0.4893175166503174,16,0,0,block 4 (G second),22.0,12.0,Female,1.0,1.0,1.0,"[2, 'block 4 (G second)']",0,1,1,0.0,6.0,-0.4,0.2857142857142857,0.21428571428571427,0.0,0.25,4,1.0,0.5,Design 1,Design 1,"Have an option between Design #1 and Design #2,",,3.0,2.0
1454,597,3,Player object (980),sell,2023-03-01 23:06:54.680951+00:00,"{""priceA"": 90, ""sharesA"": 0, ""secs_since_round_starts"": 39, ""market"": ""A""}",140.0,7.0,1.0,hre8fq8i,vmu7c279,FULL STUDY,190.0,s1,1,90,,1,,1,,0,sell,0.4580966810292103,19,0,0,block 4 (G second),22.0,12.0,Female,1.0,1.0,1.0,"[3, 'block 4 (G second)']",0,0,1,0.0,6.0,-0.4,0.4166666666666667,0.6,0.5,0.0,1,0.25,0.75,Design 1,Design 1,"Have an option between Design #1 and Design #2,",,3.0,2.0
1455,600,3,Player object (980),buy,2023-03-01 23:07:47.200892+00:00,"{""priceA"": 105, ""sharesA"": 1, ""secs_since_round_starts"": 91, ""market"": ""A""}",35.0,17.0,3.0,hre8fq8i,vmu7c279,FULL STUDY,190.0,s1,1,105,125.0,-1,,1,sell,0,sell,0.4990675303551922,19,0,0,block 4 (G second),22.0,12.0,Female,1.0,1.0,1.0,"[3, 'block 4 (G second)']",0,0,1,0.0,6.0,-0.4,0.4166666666666667,0.6,0.5,0.0,1,0.25,0.75,Design 1,Design 1,"Have an option between Design #1 and Design #2,",,3.0,2.0
1456,601,3,Player object (980),sell,2023-03-01 23:08:03.494315+00:00,"{""priceA"": 115, ""sharesA"": 0, ""secs_since_round_starts"": 107, ""market"": ""A""}",150.0,20.0,4.0,hre8fq8i,vmu7c279,FULL STUDY,190.0,s1,1,115,105.0,1,10.0,1,buy,0,sell,0.5061230669509241,19,0,0,block 4 (G second),22.0,12.0,Female,1.0,1.0,1.0,"[3, 'block 4 (G second)']",0,0,1,0.0,6.0,-0.4,0.4166666666666667,0.6,0.5,0.0,1,0.25,0.75,Design 1,Design 1,"Have an option between Design #1 and Design #2,",,3.0,2.0
1457,602,3,Player object (980),buy,2023-03-01 23:08:14.804664+00:00,"{""priceA"": 85, ""sharesA"": 1, ""secs_since_round_starts"": 119, ""market"": ""A""}",65.0,22.0,5.0,hre8fq8i,vmu7c279,FULL STUDY,190.0,s1,1,85,115.0,-1,,1,sell,0,sell,0.443819468959905,19,1,0,block 4 (G second),22.0,12.0,Female,1.0,1.0,1.0,"[3, 'block 4 (G second)']",0,0,1,0.0,6.0,-0.4,0.4166666666666667,0.6,0.5,0.0,1,0.25,0.75,Design 1,Design 1,"Have an option between Design #1 and Design #2,",,3.0,2.0
1458,603,3,Player object (980),sell,2023-03-01 23:08:31.111183+00:00,"{""priceA"": 110, ""sharesA"": 0, ""secs_since_round_starts"": 135, ""market"": ""A""}",175.0,25.0,6.0,hre8fq8i,vmu7c279,FULL STUDY,190.0,s1,1,110,85.0,1,25.0,1,buy,0,sell,0.4872943409941583,19,0,0,block 4 (G second),22.0,12.0,Female,1.0,1.0,1.0,"[3, 'block 4 (G second)']",0,0,1,0.0,6.0,-0.4,0.4166666666666667,0.6,0.5,0.0,1,0.25,0.75,Design 1,Design 1,"Have an option between Design #1 and Design #2,",,3.0,2.0
1459,604,3,Player object (980),buy,2023-03-01 23:08:54.704165+00:00,"{""priceA"": 115, ""sharesA"": 1, ""secs_since_round_starts"": 159, ""market"": ""A""}",60.0,29.0,7.0,hre8fq8i,vmu7c279,FULL STUDY,190.0,s1,1,115,110.0,-1,,1,sell,0,sell,0.5511004178331719,19,0,0,block 4 (G second),22.0,12.0,Female,1.0,1.0,1.0,"[3, 'block 4 (G second)']",0,0,1,0.0,6.0,-0.4,0.4166666666666667,0.6,0.5,0.0,1,0.25,0.75,Design 1,Design 1,"Have an option between Design #1 and Design #2,",,3.0,2.0
1460,605,3,Player object (980),sell,2023-03-01 23:09:02.579583+00:00,"{""priceA"": 120, ""sharesA"": 0, ""secs_since_round_starts"": 166, ""market"": ""A""}",180.0,30.0,8.0,hre8fq8i,vmu7c279,FULL STUDY,190.0,s1,1,120,115.0,1,5.0,1,buy,0,sell,0.570054331362491,19,0,1,block 4 (G second),22.0,12.0,Female,1.0,1.0,1.0,"[3, 'block 4 (G second)']",0,0,1,0.0,6.0,-0.4,0.4166666666666667,0.6,0.5,0.0,1,0.25,0.75,Design 1,Design 1,"Have an option between Design #1 and Design #2,",,3.0,2.0
1461,607,3,Player object (980),buy,2023-03-01 23:09:41.215822+00:00,"{""priceA"": 110, ""sharesA"": 1, ""secs_since_round_starts"": 190, ""market"": ""A""}",70.0,34.0,9.0,hre8fq8i,vmu7c279,FULL STUDY,190.0,s1,1,110,120.0,-1,,1,sell,0,sell,0.4983651933170437,19,0,0,block 4 (G second),22.0,12.0,Female,1.0,1.0,1.0,"[3, 'block 4 (G second)']",0,0,1,0.0,6.0,-0.4,0.4166666666666667,0.6,0.5,0.0,1,0.25,0.75,Design 1,Design 1,"Have an option between Design #1 and Design #2,",,3.0,2.0
1462,608,3,Player object (980),sell,2023-03-01 23:09:41.251102+00:00,"{""priceA"": 105, ""sharesA"": 0, ""secs_since_round_starts"": 196, ""market"": ""A""}",175.0,35.0,10.0,hre8fq8i,vmu7c279,FULL STUDY,190.0,s1,1,105,110.0,1,-5.0,1,buy,0,sell,0.463867449269012,19,0,0,block 4 (G second),22.0,12.0,Female,1.0,1.0,1.0,"[3, 'block 4 (G second)']",0,0,1,0.0,6.0,-0.4,0.4166666666666667,0.6,0.5,0.0,1,0.25,0.75,Design 1,Design 1,"Have an option between Design #1 and Design #2,",,3.0,2.0
1463,609,3,Player object (980),buy,2023-03-01 23:09:45.498147+00:00,"{""priceA"": 95, ""sharesA"": 1, ""secs_since_round_starts"": 209, ""market"": ""A""}",80.0,37.0,11.0,hre8fq8i,vmu7c279,FULL STUDY,190.0,s1,1,95,105.0,-1,,1,sell,0,sell,0.4240076400585448,19,1,0,block 4 (G second),22.0,12.0,Female,1.0,1.0,1.0,"[3, 'block 4 (G second)']",0,0,1,0.0,6.0,-0.4,0.4166666666666667,0.6,0.5,0.0,1,0.25,0.75,Design 1,Design 1,"Have an option between Design #1 and Design #2,",,3.0,2.0
1464,610,3,Player object (980),sell,2023-03-01 23:10:01.847954+00:00,"{""priceA"": 100, ""sharesA"": 0, ""secs_since_round_starts"": 224, ""market"": ""A""}",180.0,40.0,12.0,hre8fq8i,vmu7c279,FULL STUDY,190.0,s1,1,100,95.0,1,5.0,1,buy,0,sell,0.4804175727303482,19,0,0,block 4 (G second),22.0,12.0,Female,1.0,1.0,1.0,"[3, 'block 4 (G second)']",0,0,1,0.0,6.0,-0.4,0.4166666666666667,0.6,0.5,0.0,1,0.25,0.75,Design 1,Design 1,"Have an option between Design #1 and Design #2,",,3.0,2.0
1465,611,3,Player object (980),buy,2023-03-01 23:10:09.797963+00:00,"{""priceA"": 105, ""sharesA"": 1, ""secs_since_round_starts"": 233, ""market"": ""A""}",75.0,42.0,13.0,hre8fq8i,vmu7c279,FULL STUDY,190.0,s1,1,105,100.0,-1,,1,sell,0,sell,0.5010477910686952,19,0,0,block 4 (G second),22.0,12.0,Female,1.0,1.0,1.0,"[3, 'block 4 (G second)']",0,0,1,0.0,6.0,-0.4,0.4166666666666667,0.6,0.5,0.0,1,0.25,0.75,Design 1,Design 1,"Have an option between Design #1 and Design #2,",,3.0,2.0
1466,612,3,Player object (980),sell,2023-03-01 23:10:18.527384+00:00,"{""priceA"": 120, ""sharesA"": 0, ""secs_since_round_starts"": 242, ""market"": ""A""}",195.0,43.0,14.0,hre8fq8i,vmu7c279,FULL STUDY,190.0,s1,1,120,105.0,1,15.0,1,buy,0,sell,0.5357259670782416,19,0,0,block 4 (G second),22.0,12.0,Female,1.0,1.0,1.0,"[3, 'block 4 (G second)']",0,0,1,0.0,6.0,-0.4,0.4166666666666667,0.6,0.5,0.0,1,0.25,0.75,Design 1,Design 1,"Have an option between Design #1 and Design #2,",,3.0,2.0
1467,613,3,Player object (980),buy,2023-03-01 23:10:56.780753+00:00,"{""priceA"": 125, ""sharesA"": 1, ""secs_since_round_starts"": 281, ""market"": ""A""}",70.0,50.0,15.0,hre8fq8i,vmu7c279,FULL STUDY,190.0,s1,1,125,120.0,-1,,1,sell,0,sell,0.4911246412164243,19,0,0,block 4 (G second),22.0,12.0,Female,1.0,1.0,1.0,"[3, 'block 4 (G second)']",0,0,1,0.0,6.0,-0.4,0.4166666666666667,0.6,0.5,0.0,1,0.25,0.75,Design 1,Design 1,"Have an option between Design #1 and Design #2,",,3.0,2.0
1468,614,3,Player object (980),sell,2023-03-01 23:10:59.783160+00:00,"{""priceA"": 120, ""sharesA"": 0, ""secs_since_round_starts"": 284, ""market"": ""A""}",190.0,51.0,16.0,hre8fq8i,vmu7c279,FULL STUDY,190.0,s1,1,120,125.0,1,-5.0,1,buy,0,sell,0.4588602748157505,19,0,0,block 4 (G second),22.0,12.0,Female,1.0,1.0,1.0,"[3, 'block 4 (G second)']",0,0,1,0.0,6.0,-0.4,0.4166666666666667,0.6,0.5,0.0,1,0.25,0.75,Design 1,Design 1,"Have an option between Design #1 and Design #2,",,3.0,2.0
1469,615,3,Player object (980),buy,2023-03-01 23:11:41.825040+00:00,"{""priceA"": 115, ""sharesA"": 1, ""secs_since_round_starts"": 326, ""market"": ""A""}",75.0,58.0,17.0,hre8fq8i,vmu7c279,FULL STUDY,190.0,s1,1,115,120.0,-1,,1,sell,0,sell,0.442461876115205,19,1,0,block 4 (G second),22.0,12.0,Female,1.0,1.0,1.0,"[3, 'block 4 (G second)']",0,0,1,0.0,6.0,-0.4,0.4166666666666667,0.6,0.5,0.0,1,0.25,0.75,Design 1,Design 1,"Have an option between Design #1 and Design #2,",,3.0,2.0
1470,616,3,Player object (980),sell,2023-03-01 23:11:50.360244+00:00,"{""priceA"": 115, ""sharesA"": 0, ""secs_since_round_starts"": 334, ""market"": ""A""}",190.0,60.0,18.0,hre8fq8i,vmu7c279,FULL STUDY,190.0,s1,1,115,115.0,1,0.0,1,buy,0,sell,0.4613046310449969,19,0,0,block 4 (G second),22.0,12.0,Female,1.0,1.0,1.0,"[3, 'block 4 (G second)']",0,0,1,0.0,6.0,-0.4,0.4166666666666667,0.6,0.5,0.0,1,0.25,0.75,Design 1,Design 1,"Have an option between Design #1 and Design #2,",,3.0,2.0
1471,620,4,Player object (1100),sell,2023-03-01 23:13:10.018872+00:00,"{""priceA"": 90, ""sharesA"": 0, ""secs_since_round_starts"": 66, ""market"": ""A""}",140.0,12.0,1.0,hre8fq8i,vmu7c279,FULL STUDY,190.0,s1,1,90,,1,,1,,0,sell,0.5210961257750505,14,0,0,block 4 (G second),22.0,12.0,Female,1.0,1.0,1.0,"[4, 'block 4 (G second)']",1,1,1,0.0,6.0,-0.4,0.2857142857142857,0.46153846153846156,0.25,0.5,2,1.0,0.75,Design 1,Design 1,"Have an option between Design #1 and Design #2,",,3.0,2.0
1472,621,4,Player object (1100),buy,2023-03-01 23:13:22.458069+00:00,"{""priceA"": 90, ""sharesA"": 1, ""secs_since_round_starts"": 79, ""market"": ""A""}",50.0,14.0,2.0,hre8fq8i,vmu7c279,FULL STUDY,190.0,s1,1,90,90.0,-1,,1,sell,0,sell,0.5208618681016636,14,0,0,block 4 (G second),22.0,12.0,Female,1.0,1.0,1.0,"[4, 'block 4 (G second)']",1,1,1,0.0,6.0,-0.4,0.2857142857142857,0.46153846153846156,0.25,0.5,2,1.0,0.75,Design 1,Design 1,"Have an option between Design #1 and Design #2,",,3.0,2.0
1473,622,4,Player object (1100),sell,2023-03-01 23:13:30.851361+00:00,"{""priceA"": 90, ""sharesA"": 0, ""secs_since_round_starts"": 88, ""market"": ""A""}",140.0,16.0,3.0,hre8fq8i,vmu7c279,FULL STUDY,190.0,s1,1,90,90.0,1,0.0,1,buy,0,sell,0.4995738325599586,14,0,0,block 4 (G second),22.0,12.0,Female,1.0,1.0,1.0,"[4, 'block 4 (G second)']",1,1,1,0.0,6.0,-0.4,0.2857142857142857,0.46153846153846156,0.25,0.5,2,1.0,0.75,Design 1,Design 1,"Have an option between Design #1 and Design #2,",,3.0,2.0
1474,623,4,Player object (1100),buy,2023-03-01 23:13:48.111072+00:00,"{""priceA"": 85, ""sharesA"": 1, ""secs_since_round_starts"": 105, ""market"": ""A""}",55.0,19.0,4.0,hre8fq8i,vmu7c279,FULL STUDY,190.0,s1,1,85,90.0,-1,,1,sell,0,sell,0.4934202415852731,14,0,0,block 4 (G second),22.0,12.0,Female,1.0,1.0,1.0,"[4, 'block 4 (G second)']",1,1,1,0.0,6.0,-0.4,0.2857142857142857,0.46153846153846156,0.25,0.5,2,1.0,0.75,Design 1,Design 1,"Have an option between Design #1 and Design #2,",,3.0,2.0
1475,624,4,Player object (1100),sell,2023-03-01 23:13:52.574595+00:00,"{""priceA"": 70, ""sharesA"": 0, ""secs_since_round_starts"": 111, ""market"": ""A""}",125.0,20.0,5.0,hre8fq8i,vmu7c279,FULL STUDY,190.0,s1,1,70,85.0,1,-15.0,1,buy,0,sell,0.4604462199730844,14,0,0,block 4 (G second),22.0,12.0,Female,1.0,1.0,1.0,"[4, 'block 4 (G second)']",1,1,1,0.0,6.0,-0.4,0.2857142857142857,0.46153846153846156,0.25,0.5,2,1.0,0.75,Design 1,Design 1,"Have an option between Design #1 and Design #2,",,3.0,2.0
1476,625,4,Player object (1100),buy,2023-03-01 23:13:58.633395+00:00,"{""priceA"": 65, ""sharesA"": 1, ""secs_since_round_starts"": 117, ""market"": ""A""}",60.0,21.0,6.0,hre8fq8i,vmu7c279,FULL STUDY,190.0,s1,1,65,70.0,-1,,1,sell,0,sell,0.4378043684469758,14,0,0,block 4 (G second),22.0,12.0,Female,1.0,1.0,1.0,"[4, 'block 4 (G second)']",1,1,1,0.0,6.0,-0.4,0.2857142857142857,0.46153846153846156,0.25,0.5,2,1.0,0.75,Design 1,Design 1,"Have an option between Design #1 and Design #2,",,3.0,2.0
1477,626,4,Player object (1100),sell,2023-03-01 23:14:03.372015+00:00,"{""priceA"": 55, ""sharesA"": 0, ""secs_since_round_starts"": 122, ""market"": ""A""}",115.0,22.0,7.0,hre8fq8i,vmu7c279,FULL STUDY,190.0,s1,1,55,65.0,1,-10.0,1,buy,0,sell,0.4224279859932807,14,1,0,block 4 (G second),22.0,12.0,Female,1.0,1.0,1.0,"[4, 'block 4 (G second)']",1,1,1,0.0,6.0,-0.4,0.2857142857142857,0.46153846153846156,0.25,0.5,2,1.0,0.75,Design 1,Design 1,"Have an option between Design #1 and Design #2,",,3.0,2.0
1478,627,4,Player object (1100),buy,2023-03-01 23:14:09.257928+00:00,"{""priceA"": 65, ""sharesA"": 1, ""secs_since_round_starts"": 127, ""market"": ""A""}",50.0,23.0,8.0,hre8fq8i,vmu7c279,FULL STUDY,190.0,s1,1,65,55.0,-1,,1,sell,0,sell,0.4803954371098747,14,0,0,block 4 (G second),22.0,12.0,Female,1.0,1.0,1.0,"[4, 'block 4 (G second)']",1,1,1,0.0,6.0,-0.4,0.2857142857142857,0.46153846153846156,0.25,0.5,2,1.0,0.75,Design 1,Design 1,"Have an option between Design #1 and Design #2,",,3.0,2.0
1479,630,4,Player object (1100),sell,2023-03-01 23:14:17.562993+00:00,"{""priceA"": 55, ""sharesA"": 0, ""secs_since_round_starts"": 136, ""market"": ""A""}",105.0,24.0,9.0,hre8fq8i,vmu7c279,FULL STUDY,190.0,s1,1,55,55.0,1,0.0,3,buy,0,sell,0.4514670992379582,14,0,0,block 4 (G second),22.0,12.0,Female,1.0,1.0,1.0,"[4, 'block 4 (G second)']",1,1,1,0.0,6.0,-0.4,0.2857142857142857,0.46153846153846156,0.25,0.5,2,1.0,0.75,Design 1,Design 1,"Have an option between Design #1 and Design #2,",,3.0,2.0
1480,631,4,Player object (1100),buy,2023-03-01 23:14:25.601812+00:00,"{""priceA"": 55, ""sharesA"": 1, ""secs_since_round_starts"": 144, ""market"": ""A""}",50.0,26.0,10.0,hre8fq8i,vmu7c279,FULL STUDY,190.0,s1,1,55,55.0,-1,,1,sell,0,sell,0.4870054870256314,14,0,0,block 4 (G second),22.0,12.0,Female,1.0,1.0,1.0,"[4, 'block 4 (G second)']",1,1,1,0.0,6.0,-0.4,0.2857142857142857,0.46153846153846156,0.25,0.5,2,1.0,0.75,Design 1,Design 1,"Have an option between Design #1 and Design #2,",,3.0,2.0
1481,633,4,Player object (1100),sell,2023-03-01 23:14:47.065183+00:00,"{""priceA"": 90, ""sharesA"": 0, ""secs_since_round_starts"": 165, ""market"": ""A""}",140.0,29.0,11.0,hre8fq8i,vmu7c279,FULL STUDY,190.0,s1,1,90,55.0,1,35.0,1,buy,0,sell,0.5712793841154561,14,0,0,block 4 (G second),22.0,12.0,Female,1.0,1.0,1.0,"[4, 'block 4 (G second)']",1,1,1,0.0,6.0,-0.4,0.2857142857142857,0.46153846153846156,0.25,0.5,2,1.0,0.75,Design 1,Design 1,"Have an option between Design #1 and Design #2,",,3.0,2.0
1482,635,4,Player object (1100),buy,2023-03-01 23:15:08.015098+00:00,"{""priceA"": 95, ""sharesA"": 1, ""secs_since_round_starts"": 186, ""market"": ""A""}",45.0,32.0,12.0,hre8fq8i,vmu7c279,FULL STUDY,190.0,s1,1,95,90.0,-1,,1,sell,0,sell,0.5179404569050043,14,0,0,block 4 (G second),22.0,12.0,Female,1.0,1.0,1.0,"[4, 'block 4 (G second)']",1,1,1,0.0,6.0,-0.4,0.2857142857142857,0.46153846153846156,0.25,0.5,2,1.0,0.75,Design 1,Design 1,"Have an option between Design #1 and Design #2,",,3.0,2.0
1483,636,4,Player object (1100),sell,2023-03-01 23:15:15.987437+00:00,"{""priceA"": 95, ""sharesA"": 0, ""secs_since_round_starts"": 194, ""market"": ""A""}",140.0,34.0,13.0,hre8fq8i,vmu7c279,FULL STUDY,190.0,s1,1,95,95.0,1,0.0,1,buy,0,sell,0.4981543075921684,14,0,0,block 4 (G second),22.0,12.0,Female,1.0,1.0,1.0,"[4, 'block 4 (G second)']",1,1,1,0.0,6.0,-0.4,0.2857142857142857,0.46153846153846156,0.25,0.5,2,1.0,0.75,Design 1,Design 1,"Have an option between Design #1 and Design #2,",,3.0,2.0
1484,637,4,Player object (1100),buy,2023-03-01 23:15:22.398463+00:00,"{""priceA"": 100, ""sharesA"": 1, ""secs_since_round_starts"": 201, ""market"": ""A""}",40.0,35.0,14.0,hre8fq8i,vmu7c279,FULL STUDY,190.0,s1,1,100,95.0,-1,,1,sell,0,sell,0.5337204628349665,14,0,0,block 4 (G second),22.0,12.0,Female,1.0,1.0,1.0,"[4, 'block 4 (G second)']",1,1,1,0.0,6.0,-0.4,0.2857142857142857,0.46153846153846156,0.25,0.5,2,1.0,0.75,Design 1,Design 1,"Have an option between Design #1 and Design #2,",,3.0,2.0
1485,638,4,Player object (1100),sell,2023-03-01 23:15:27.692829+00:00,"{""priceA"": 85, ""sharesA"": 0, ""secs_since_round_starts"": 206, ""market"": ""A""}",125.0,36.0,15.0,hre8fq8i,vmu7c279,FULL STUDY,190.0,s1,1,85,100.0,1,-15.0,1,buy,0,sell,0.4885269486642424,14,0,0,block 4 (G second),22.0,12.0,Female,1.0,1.0,1.0,"[4, 'block 4 (G second)']",1,1,1,0.0,6.0,-0.4,0.2857142857142857,0.46153846153846156,0.25,0.5,2,1.0,0.75,Design 1,Design 1,"Have an option between Design #1 and Design #2,",,3.0,2.0
1486,640,4,Player object (1100),buy,2023-03-01 23:15:43.405674+00:00,"{""priceA"": 65, ""sharesA"": 1, ""secs_since_round_starts"": 222, ""market"": ""A""}",60.0,38.0,16.0,hre8fq8i,vmu7c279,FULL STUDY,190.0,s1,1,65,85.0,-1,,1,sell,0,sell,0.4355009867455686,14,1,0,block 4 (G second),22.0,12.0,Female,1.0,1.0,1.0,"[4, 'block 4 (G second)']",1,1,1,0.0,6.0,-0.4,0.2857142857142857,0.46153846153846156,0.25,0.5,2,1.0,0.75,Design 1,Design 1,"Have an option between Design #1 and Design #2,",,3.0,2.0
1487,641,4,Player object (1100),sell,2023-03-01 23:15:53.238727+00:00,"{""priceA"": 75, ""sharesA"": 0, ""secs_since_round_starts"": 231, ""market"": ""A""}",135.0,40.0,17.0,hre8fq8i,vmu7c279,FULL STUDY,190.0,s1,1,75,65.0,1,10.0,1,buy,0,sell,0.4578892350765483,14,0,0,block 4 (G second),22.0,12.0,Female,1.0,1.0,1.0,"[4, 'block 4 (G second)']",1,1,1,0.0,6.0,-0.4,0.2857142857142857,0.46153846153846156,0.25,0.5,2,1.0,0.75,Design 1,Design 1,"Have an option between Design #1 and Design #2,",,3.0,2.0
1488,642,4,Player object (1100),buy,2023-03-01 23:15:58.896292+00:00,"{""priceA"": 80, ""sharesA"": 1, ""secs_since_round_starts"": 237, ""market"": ""A""}",55.0,41.0,18.0,hre8fq8i,vmu7c279,FULL STUDY,190.0,s1,1,80,75.0,-1,,1,sell,0,sell,0.5055693706451859,14,0,0,block 4 (G second),22.0,12.0,Female,1.0,1.0,1.0,"[4, 'block 4 (G second)']",1,1,1,0.0,6.0,-0.4,0.2857142857142857,0.46153846153846156,0.25,0.5,2,1.0,0.75,Design 1,Design 1,"Have an option between Design #1 and Design #2,",,3.0,2.0
1489,643,4,Player object (1100),sell,2023-03-01 23:16:15.495120+00:00,"{""priceA"": 115, ""sharesA"": 0, ""secs_since_round_starts"": 254, ""market"": ""A""}",170.0,44.0,19.0,hre8fq8i,vmu7c279,FULL STUDY,190.0,s1,1,115,80.0,1,35.0,1,buy,0,sell,0.5772497941838325,14,0,0,block 4 (G second),22.0,12.0,Female,1.0,1.0,1.0,"[4, 'block 4 (G second)']",1,1,1,0.0,6.0,-0.4,0.2857142857142857,0.46153846153846156,0.25,0.5,2,1.0,0.75,Design 1,Design 1,"Have an option between Design #1 and Design #2,",,3.0,2.0
1490,644,4,Player object (1100),buy,2023-03-01 23:16:37.810493+00:00,"{""priceA"": 100, ""sharesA"": 1, ""secs_since_round_starts"": 276, ""market"": ""A""}",70.0,48.0,20.0,hre8fq8i,vmu7c279,FULL STUDY,190.0,s1,1,100,115.0,-1,,1,sell,0,sell,0.500105737602651,14,0,0,block 4 (G second),22.0,12.0,Female,1.0,1.0,1.0,"[4, 'block 4 (G second)']",1,1,1,0.0,6.0,-0.4,0.2857142857142857,0.46153846153846156,0.25,0.5,2,1.0,0.75,Design 1,Design 1,"Have an option between Design #1 and Design #2,",,3.0,2.0
1491,646,4,Player object (1100),sell,2023-03-01 23:16:53.037313+00:00,"{""priceA"": 120, ""sharesA"": 0, ""secs_since_round_starts"": 291, ""market"": ""A""}",190.0,50.0,21.0,hre8fq8i,vmu7c279,FULL STUDY,190.0,s1,1,120,100.0,1,20.0,1,buy,0,sell,0.5591364702939366,14,0,1,block 4 (G second),22.0,12.0,Female,1.0,1.0,1.0,"[4, 'block 4 (G second)']",1,1,1,0.0,6.0,-0.4,0.2857142857142857,0.46153846153846156,0.25,0.5,2,1.0,0.75,Design 1,Design 1,"Have an option between Design #1 and Design #2,",,3.0,2.0
1492,647,4,Player object (1100),buy,2023-03-01 23:17:14.155447+00:00,"{""priceA"": 85, ""sharesA"": 1, ""secs_since_round_starts"": 312, ""market"": ""A""}",105.0,54.0,22.0,hre8fq8i,vmu7c279,FULL STUDY,190.0,s1,1,85,120.0,-1,,1,sell,0,sell,0.4957421237757241,14,0,0,block 4 (G second),22.0,12.0,Female,1.0,1.0,1.0,"[4, 'block 4 (G second)']",1,1,1,0.0,6.0,-0.4,0.2857142857142857,0.46153846153846156,0.25,0.5,2,1.0,0.75,Design 1,Design 1,"Have an option between Design #1 and Design #2,",,3.0,2.0
1493,648,4,Player object (1100),sell,2023-03-01 23:17:20.609140+00:00,"{""priceA"": 70, ""sharesA"": 0, ""secs_since_round_starts"": 319, ""market"": ""A""}",175.0,55.0,23.0,hre8fq8i,vmu7c279,FULL STUDY,190.0,s1,1,70,85.0,1,-15.0,1,buy,0,sell,0.4620518023886796,14,0,0,block 4 (G second),22.0,12.0,Female,1.0,1.0,1.0,"[4, 'block 4 (G second)']",1,1,1,0.0,6.0,-0.4,0.2857142857142857,0.46153846153846156,0.25,0.5,2,1.0,0.75,Design 1,Design 1,"Have an option between Design #1 and Design #2,",,3.0,2.0
1494,649,4,Player object (1100),buy,2023-03-01 23:17:36.233110+00:00,"{""priceA"": 60, ""sharesA"": 1, ""secs_since_round_starts"": 334, ""market"": ""A""}",115.0,58.0,24.0,hre8fq8i,vmu7c279,FULL STUDY,190.0,s1,1,60,70.0,-1,,1,sell,0,sell,0.4809250988502129,14,0,0,block 4 (G second),22.0,12.0,Female,1.0,1.0,1.0,"[4, 'block 4 (G second)']",1,1,1,0.0,6.0,-0.4,0.2857142857142857,0.46153846153846156,0.25,0.5,2,1.0,0.75,Design 1,Design 1,"Have an option between Design #1 and Design #2,",,3.0,2.0
1495,653,5,Player object (1220),sell,2023-03-01 23:18:32.408281+00:00,"{""priceA"": 95, ""sharesA"": 0, ""secs_since_round_starts"": 36, ""market"": ""A""}",145.0,6.0,1.0,hre8fq8i,vmu7c279,FULL STUDY,170.0,s1,1,95,,1,,1,,0,sell,0.5560314405213382,17,0,1,block 4 (G second),22.0,12.0,Female,1.0,1.0,1.0,"[5, 'block 4 (G second)']",1,0,1,0.0,6.0,-0.4,0.23076923076923078,0.5,0.3333333333333333,0.5,5,0.25,0.75,Design 1,Design 1,"Have an option between Design #1 and Design #2,",,3.0,2.0
1496,654,5,Player object (1220),buy,2023-03-01 23:18:33.988986+00:00,"{""priceA"": 100, ""sharesA"": 1, ""secs_since_round_starts"": 38, ""market"": ""A""}",45.0,7.0,2.0,hre8fq8i,vmu7c279,FULL STUDY,170.0,s1,1,100,95.0,-1,,1,sell,0,sell,0.5733994727268583,17,0,0,block 4 (G second),22.0,12.0,Female,1.0,1.0,1.0,"[5, 'block 4 (G second)']",1,0,1,0.0,6.0,-0.4,0.23076923076923078,0.5,0.3333333333333333,0.5,5,0.25,0.75,Design 1,Design 1,"Have an option between Design #1 and Design #2,",,3.0,2.0
1497,655,5,Player object (1220),sell,2023-03-01 23:18:39.384402+00:00,"{""priceA"": 90, ""sharesA"": 0, ""secs_since_round_starts"": 43, ""market"": ""A""}",135.0,8.0,3.0,hre8fq8i,vmu7c279,FULL STUDY,170.0,s1,1,90,100.0,1,-10.0,1,buy,0,sell,0.5166236645513725,17,0,0,block 4 (G second),22.0,12.0,Female,1.0,1.0,1.0,"[5, 'block 4 (G second)']",1,0,1,0.0,6.0,-0.4,0.23076923076923078,0.5,0.3333333333333333,0.5,5,0.25,0.75,Design 1,Design 1,"Have an option between Design #1 and Design #2,",,3.0,2.0
1498,656,5,Player object (1220),buy,2023-03-01 23:18:56.465392+00:00,"{""priceA"": 85, ""sharesA"": 1, ""secs_since_round_starts"": 60, ""market"": ""A""}",50.0,11.0,4.0,hre8fq8i,vmu7c279,FULL STUDY,170.0,s1,1,85,90.0,-1,,1,sell,0,sell,0.4991731929932316,17,0,0,block 4 (G second),22.0,12.0,Female,1.0,1.0,1.0,"[5, 'block 4 (G second)']",1,0,1,0.0,6.0,-0.4,0.23076923076923078,0.5,0.3333333333333333,0.5,5,0.25,0.75,Design 1,Design 1,"Have an option between Design #1 and Design #2,",,3.0,2.0
1499,657,5,Player object (1220),sell,2023-03-01 23:19:07.087391+00:00,"{""priceA"": 85, ""sharesA"": 0, ""secs_since_round_starts"": 71, ""market"": ""A""}",135.0,13.0,5.0,hre8fq8i,vmu7c279,FULL STUDY,170.0,s1,1,85,85.0,1,0.0,1,buy,0,sell,0.4890232705715233,17,0,0,block 4 (G second),22.0,12.0,Female,1.0,1.0,1.0,"[5, 'block 4 (G second)']",1,0,1,0.0,6.0,-0.4,0.23076923076923078,0.5,0.3333333333333333,0.5,5,0.25,0.75,Design 1,Design 1,"Have an option between Design #1 and Design #2,",,3.0,2.0
1500,658,5,Player object (1220),buy,2023-03-01 23:19:18.218561+00:00,"{""priceA"": 90, ""sharesA"": 1, ""secs_since_round_starts"": 82, ""market"": ""A""}",45.0,15.0,6.0,hre8fq8i,vmu7c279,FULL STUDY,170.0,s1,1,90,85.0,-1,,1,sell,0,sell,0.505231414156075,17,0,0,block 4 (G second),22.0,12.0,Female,1.0,1.0,1.0,"[5, 'block 4 (G second)']",1,0,1,0.0,6.0,-0.4,0.23076923076923078,0.5,0.3333333333333333,0.5,5,0.25,0.75,Design 1,Design 1,"Have an option between Design #1 and Design #2,",,3.0,2.0
1501,659,5,Player object (1220),sell,2023-03-01 23:19:52.985469+00:00,"{""priceA"": 105, ""sharesA"": 0, ""secs_since_round_starts"": 117, ""market"": ""A""}",150.0,21.0,7.0,hre8fq8i,vmu7c279,FULL STUDY,170.0,s1,1,105,90.0,1,15.0,1,buy,0,sell,0.5510362930796925,17,0,1,block 4 (G second),22.0,12.0,Female,1.0,1.0,1.0,"[5, 'block 4 (G second)']",1,0,1,0.0,6.0,-0.4,0.23076923076923078,0.5,0.3333333333333333,0.5,5,0.25,0.75,Design 1,Design 1,"Have an option between Design #1 and Design #2,",,3.0,2.0
1502,660,5,Player object (1220),buy,2023-03-01 23:20:41.257836+00:00,"{""priceA"": 70, ""sharesA"": 1, ""secs_since_round_starts"": 165, ""market"": ""A""}",80.0,30.0,8.0,hre8fq8i,vmu7c279,FULL STUDY,170.0,s1,1,70,105.0,-1,,1,sell,0,sell,0.4174526841611717,17,0,0,block 4 (G second),22.0,12.0,Female,1.0,1.0,1.0,"[5, 'block 4 (G second)']",1,0,1,0.0,6.0,-0.4,0.23076923076923078,0.5,0.3333333333333333,0.5,5,0.25,0.75,Design 1,Design 1,"Have an option between Design #1 and Design #2,",,3.0,2.0
1503,662,5,Player object (1220),sell,2023-03-01 23:21:03.869297+00:00,"{""priceA"": 120, ""sharesA"": 0, ""secs_since_round_starts"": 188, ""market"": ""A""}",200.0,34.0,9.0,hre8fq8i,vmu7c279,FULL STUDY,170.0,s1,1,120,70.0,1,50.0,1,buy,0,sell,0.5679672812132522,17,0,0,block 4 (G second),22.0,12.0,Female,1.0,1.0,1.0,"[5, 'block 4 (G second)']",1,0,1,0.0,6.0,-0.4,0.23076923076923078,0.5,0.3333333333333333,0.5,5,0.25,0.75,Design 1,Design 1,"Have an option between Design #1 and Design #2,",,3.0,2.0
1504,663,5,Player object (1220),buy,2023-03-01 23:21:32.257013+00:00,"{""priceA"": 70, ""sharesA"": 1, ""secs_since_round_starts"": 216, ""market"": ""A""}",130.0,39.0,10.0,hre8fq8i,vmu7c279,FULL STUDY,170.0,s1,1,70,120.0,-1,,1,sell,0,sell,0.4317803147869401,17,0,0,block 4 (G second),22.0,12.0,Female,1.0,1.0,1.0,"[5, 'block 4 (G second)']",1,0,1,0.0,6.0,-0.4,0.23076923076923078,0.5,0.3333333333333333,0.5,5,0.25,0.75,Design 1,Design 1,"Have an option between Design #1 and Design #2,",,3.0,2.0
1505,665,5,Player object (1220),sell,2023-03-01 23:22:03.143102+00:00,"{""priceA"": 105, ""sharesA"": 0, ""secs_since_round_starts"": 247, ""market"": ""A""}",235.0,44.0,11.0,hre8fq8i,vmu7c279,FULL STUDY,170.0,s1,1,105,70.0,1,35.0,1,buy,0,sell,0.515125859635568,17,0,0,block 4 (G second),22.0,12.0,Female,1.0,1.0,1.0,"[5, 'block 4 (G second)']",1,0,1,0.0,6.0,-0.4,0.23076923076923078,0.5,0.3333333333333333,0.5,5,0.25,0.75,Design 1,Design 1,"Have an option between Design #1 and Design #2,",,3.0,2.0
1506,666,5,Player object (1220),buy,2023-03-01 23:22:09.858852+00:00,"{""priceA"": 110, ""sharesA"": 1, ""secs_since_round_starts"": 254, ""market"": ""A""}",125.0,45.0,12.0,hre8fq8i,vmu7c279,FULL STUDY,170.0,s1,1,110,105.0,-1,,1,sell,0,sell,0.5454506058480159,17,0,0,block 4 (G second),22.0,12.0,Female,1.0,1.0,1.0,"[5, 'block 4 (G second)']",1,0,1,0.0,6.0,-0.4,0.23076923076923078,0.5,0.3333333333333333,0.5,5,0.25,0.75,Design 1,Design 1,"Have an option between Design #1 and Design #2,",,3.0,2.0
1507,667,5,Player object (1220),sell,2023-03-01 23:22:14.225581+00:00,"{""priceA"": 95, ""sharesA"": 0, ""secs_since_round_starts"": 258, ""market"": ""A""}",220.0,46.0,13.0,hre8fq8i,vmu7c279,FULL STUDY,170.0,s1,1,95,110.0,1,-15.0,1,buy,0,sell,0.4967862103563366,17,0,0,block 4 (G second),22.0,12.0,Female,1.0,1.0,1.0,"[5, 'block 4 (G second)']",1,0,1,0.0,6.0,-0.4,0.23076923076923078,0.5,0.3333333333333333,0.5,5,0.25,0.75,Design 1,Design 1,"Have an option between Design #1 and Design #2,",,3.0,2.0
1508,668,5,Player object (1220),buy,2023-03-01 23:22:30.943146+00:00,"{""priceA"": 85, ""sharesA"": 1, ""secs_since_round_starts"": 275, ""market"": ""A""}",135.0,49.0,14.0,hre8fq8i,vmu7c279,FULL STUDY,170.0,s1,1,85,95.0,-1,,1,sell,0,sell,0.4924841505562556,17,0,0,block 4 (G second),22.0,12.0,Female,1.0,1.0,1.0,"[5, 'block 4 (G second)']",1,0,1,0.0,6.0,-0.4,0.23076923076923078,0.5,0.3333333333333333,0.5,5,0.25,0.75,Design 1,Design 1,"Have an option between Design #1 and Design #2,",,3.0,2.0
1509,669,5,Player object (1220),sell,2023-03-01 23:22:36.456692+00:00,"{""priceA"": 70, ""sharesA"": 0, ""secs_since_round_starts"": 280, ""market"": ""A""}",205.0,50.0,15.0,hre8fq8i,vmu7c279,FULL STUDY,170.0,s1,1,70,85.0,1,-15.0,1,buy,0,sell,0.4597993338202879,17,0,0,block 4 (G second),22.0,12.0,Female,1.0,1.0,1.0,"[5, 'block 4 (G second)']",1,0,1,0.0,6.0,-0.4,0.23076923076923078,0.5,0.3333333333333333,0.5,5,0.25,0.75,Design 1,Design 1,"Have an option between Design #1 and Design #2,",,3.0,2.0
1510,671,5,Player object (1220),buy,2023-03-01 23:22:45.381653+00:00,"{""priceA"": 85, ""sharesA"": 1, ""secs_since_round_starts"": 289, ""market"": ""A""}",120.0,51.0,16.0,hre8fq8i,vmu7c279,FULL STUDY,170.0,s1,1,85,70.0,-1,,1,sell,0,sell,0.5069151322589074,17,0,0,block 4 (G second),22.0,12.0,Female,1.0,1.0,1.0,"[5, 'block 4 (G second)']",1,0,1,0.0,6.0,-0.4,0.23076923076923078,0.5,0.3333333333333333,0.5,5,0.25,0.75,Design 1,Design 1,"Have an option between Design #1 and Design #2,",,3.0,2.0
1511,672,5,Player object (1220),sell,2023-03-01 23:22:56.170861+00:00,"{""priceA"": 85, ""sharesA"": 0, ""secs_since_round_starts"": 300, ""market"": ""A""}",205.0,53.0,17.0,hre8fq8i,vmu7c279,FULL STUDY,170.0,s1,1,85,85.0,1,0.0,1,buy,0,sell,0.4927925471404216,17,0,0,block 4 (G second),22.0,12.0,Female,1.0,1.0,1.0,"[5, 'block 4 (G second)']",1,0,1,0.0,6.0,-0.4,0.23076923076923078,0.5,0.3333333333333333,0.5,5,0.25,0.75,Design 1,Design 1,"Have an option between Design #1 and Design #2,",,3.0,2.0
1512,673,5,Player object (1220),buy,2023-03-01 23:23:02.346192+00:00,"{""priceA"": 95, ""sharesA"": 1, ""secs_since_round_starts"": 306, ""market"": ""A""}",110.0,54.0,18.0,hre8fq8i,vmu7c279,FULL STUDY,170.0,s1,1,95,85.0,-1,,1,sell,0,sell,0.5299980248683189,17,0,0,block 4 (G second),22.0,12.0,Female,1.0,1.0,1.0,"[5, 'block 4 (G second)']",1,0,1,0.0,6.0,-0.4,0.23076923076923078,0.5,0.3333333333333333,0.5,5,0.25,0.75,Design 1,Design 1,"Have an option between Design #1 and Design #2,",,3.0,2.0
1513,674,5,Player object (1220),sell,2023-03-01 23:23:07.772379+00:00,"{""priceA"": 80, ""sharesA"": 0, ""secs_since_round_starts"": 312, ""market"": ""A""}",190.0,55.0,19.0,hre8fq8i,vmu7c279,FULL STUDY,170.0,s1,1,80,95.0,1,-15.0,1,buy,0,sell,0.4859141076178286,17,0,0,block 4 (G second),22.0,12.0,Female,1.0,1.0,1.0,"[5, 'block 4 (G second)']",1,0,1,0.0,6.0,-0.4,0.23076923076923078,0.5,0.3333333333333333,0.5,5,0.25,0.75,Design 1,Design 1,"Have an option between Design #1 and Design #2,",,3.0,2.0
1514,675,5,Player object (1220),buy,2023-03-01 23:23:13.629297+00:00,"{""priceA"": 95, ""sharesA"": 1, ""secs_since_round_starts"": 318, ""market"": ""A""}",95.0,56.0,20.0,hre8fq8i,vmu7c279,FULL STUDY,170.0,s1,1,95,80.0,-1,,1,sell,0,sell,0.5252108989343294,17,0,0,block 4 (G second),22.0,12.0,Female,1.0,1.0,1.0,"[5, 'block 4 (G second)']",1,0,1,0.0,6.0,-0.4,0.23076923076923078,0.5,0.3333333333333333,0.5,5,0.25,0.75,Design 1,Design 1,"Have an option between Design #1 and Design #2,",,3.0,2.0
1515,679,5,Player object (1220),sell,2023-03-01 23:23:28.124006+00:00,"{""priceA"": 75, ""sharesA"": 0, ""secs_since_round_starts"": 332, ""market"": ""A""}",170.0,58.0,22.0,hre8fq8i,vmu7c279,FULL STUDY,170.0,s1,1,75,85.0,1,-10.0,1,buy,0,sell,0.4529558772574278,17,0,0,block 4 (G second),22.0,12.0,Female,1.0,1.0,1.0,"[5, 'block 4 (G second)']",1,0,1,0.0,6.0,-0.4,0.23076923076923078,0.5,0.3333333333333333,0.5,5,0.25,0.75,Design 1,Design 1,"Have an option between Design #1 and Design #2,",,3.0,2.0
1516,680,5,Player object (1220),buy,2023-03-01 23:23:39.940859+00:00,"{""priceA"": 65, ""sharesA"": 1, ""secs_since_round_starts"": 344, ""market"": ""A""}",105.0,60.0,23.0,hre8fq8i,vmu7c279,FULL STUDY,170.0,s1,1,65,75.0,-1,,1,sell,0,sell,0.4189820782479906,17,0,0,block 4 (G second),22.0,12.0,Female,1.0,1.0,1.0,"[5, 'block 4 (G second)']",1,0,1,0.0,6.0,-0.4,0.23076923076923078,0.5,0.3333333333333333,0.5,5,0.25,0.75,Design 1,Design 1,"Have an option between Design #1 and Design #2,",,3.0,2.0
1517,4231,3,Player object (1063),sell,2023-03-09 21:57:22.800646+00:00,"{""priceA"": 110, ""sharesA"": 0, ""secs_since_round_starts"": 43, ""market"": ""A""}",160.0,9.0,1.0,i6yb4yej,vmu7c279,FULL STUDY,205.0,s1,1,110,,1,,1,,0,sell,0.5389563723055646,19,0,0,block 2 (G first),23.0,11.0,Male,1.0,1.0,1.0,"[3, 'block 2 (G first)']",1,0,0,0.0,7.0,-0.21666666666666667,0.3076923076923077,0.0,1.0,0.0,1,0.25,1.0,Design 2,Design 2,"Have an option between Design #1 and Design #2,",,5.0,3.0
1518,4232,3,Player object (1063),buy,2023-03-09 21:58:00.334740+00:00,"{""priceA"": 100, ""sharesA"": 1, ""secs_since_round_starts"": 81, ""market"": ""A""}",60.0,16.0,2.0,i6yb4yej,vmu7c279,FULL STUDY,205.0,s1,1,100,110.0,-1,,1,sell,0,sell,0.4486815727575955,19,1,0,block 2 (G first),23.0,11.0,Male,1.0,1.0,1.0,"[3, 'block 2 (G first)']",1,0,0,0.0,7.0,-0.21666666666666667,0.3076923076923077,0.0,1.0,0.0,1,0.25,1.0,Design 2,Design 2,"Have an option between Design #1 and Design #2,",,5.0,3.0
1519,4233,3,Player object (1063),sell,2023-03-09 21:58:16.474844+00:00,"{""priceA"": 120, ""sharesA"": 0, ""secs_since_round_starts"": 97, ""market"": ""A""}",180.0,19.0,3.0,i6yb4yej,vmu7c279,FULL STUDY,205.0,s1,1,120,100.0,1,20.0,1,buy,0,sell,0.5586446427659006,19,0,1,block 2 (G first),23.0,11.0,Male,1.0,1.0,1.0,"[3, 'block 2 (G first)']",1,0,0,0.0,7.0,-0.21666666666666667,0.3076923076923077,0.0,1.0,0.0,1,0.25,1.0,Design 2,Design 2,"Have an option between Design #1 and Design #2,",,5.0,3.0
1520,4234,3,Player object (1063),buy,2023-03-09 21:58:32.720440+00:00,"{""priceA"": 85, ""sharesA"": 1, ""secs_since_round_starts"": 113, ""market"": ""A""}",95.0,22.0,4.0,i6yb4yej,vmu7c279,FULL STUDY,205.0,s1,1,85,120.0,-1,,1,sell,0,sell,0.443819468959905,19,1,0,block 2 (G first),23.0,11.0,Male,1.0,1.0,1.0,"[3, 'block 2 (G first)']",1,0,0,0.0,7.0,-0.21666666666666667,0.3076923076923077,0.0,1.0,0.0,1,0.25,1.0,Design 2,Design 2,"Have an option between Design #1 and Design #2,",,5.0,3.0
1521,4235,3,Player object (1063),sell,2023-03-09 21:58:45.303676+00:00,"{""priceA"": 115, ""sharesA"": 0, ""secs_since_round_starts"": 126, ""market"": ""A""}",210.0,24.0,5.0,i6yb4yej,vmu7c279,FULL STUDY,205.0,s1,1,115,85.0,1,30.0,1,buy,0,sell,0.5319650978870379,19,0,0,block 2 (G first),23.0,11.0,Male,1.0,1.0,1.0,"[3, 'block 2 (G first)']",1,0,0,0.0,7.0,-0.21666666666666667,0.3076923076923077,0.0,1.0,0.0,1,0.25,1.0,Design 2,Design 2,"Have an option between Design #1 and Design #2,",,5.0,3.0
1522,4236,3,Player object (1063),buy,2023-03-09 21:59:07.234010+00:00,"{""priceA"": 110, ""sharesA"": 1, ""secs_since_round_starts"": 147, ""market"": ""A""}",100.0,28.0,6.0,i6yb4yej,vmu7c279,FULL STUDY,205.0,s1,1,110,115.0,-1,,1,sell,0,sell,0.5233413838959273,19,0,0,block 2 (G first),23.0,11.0,Male,1.0,1.0,1.0,"[3, 'block 2 (G first)']",1,0,0,0.0,7.0,-0.21666666666666667,0.3076923076923077,0.0,1.0,0.0,1,0.25,1.0,Design 2,Design 2,"Have an option between Design #1 and Design #2,",,5.0,3.0
1523,4237,3,Player object (1063),sell,2023-03-09 21:59:19.818650+00:00,"{""priceA"": 120, ""sharesA"": 0, ""secs_since_round_starts"": 160, ""market"": ""A""}",220.0,30.0,7.0,i6yb4yej,vmu7c279,FULL STUDY,205.0,s1,1,120,110.0,1,10.0,1,buy,0,sell,0.570054331362491,19,0,1,block 2 (G first),23.0,11.0,Male,1.0,1.0,1.0,"[3, 'block 2 (G first)']",1,0,0,0.0,7.0,-0.21666666666666667,0.3076923076923077,0.0,1.0,0.0,1,0.25,1.0,Design 2,Design 2,"Have an option between Design #1 and Design #2,",,5.0,3.0
1524,4239,3,Player object (1063),buy,2023-03-09 21:59:44.932637+00:00,"{""priceA"": 100, ""sharesA"": 1, ""secs_since_round_starts"": 185, ""market"": ""A""}",120.0,33.0,8.0,i6yb4yej,vmu7c279,FULL STUDY,205.0,s1,1,100,120.0,-1,,1,sell,0,sell,0.4476889957041811,19,1,0,block 2 (G first),23.0,11.0,Male,1.0,1.0,1.0,"[3, 'block 2 (G first)']",1,0,0,0.0,7.0,-0.21666666666666667,0.3076923076923077,0.0,1.0,0.0,1,0.25,1.0,Design 2,Design 2,"Have an option between Design #1 and Design #2,",,5.0,3.0
1525,4240,3,Player object (1063),sell,2023-03-09 22:00:00.108615+00:00,"{""priceA"": 100, ""sharesA"": 0, ""secs_since_round_starts"": 200, ""market"": ""A""}",220.0,36.0,9.0,i6yb4yej,vmu7c279,FULL STUDY,205.0,s1,1,100,100.0,1,0.0,1,buy,0,sell,0.440139794868048,19,0,0,block 2 (G first),23.0,11.0,Male,1.0,1.0,1.0,"[3, 'block 2 (G first)']",1,0,0,0.0,7.0,-0.21666666666666667,0.3076923076923077,0.0,1.0,0.0,1,0.25,1.0,Design 2,Design 2,"Have an option between Design #1 and Design #2,",,5.0,3.0
1526,4241,3,Player object (1063),buy,2023-03-09 22:00:07.368337+00:00,"{""priceA"": 95, ""sharesA"": 1, ""secs_since_round_starts"": 208, ""market"": ""A""}",125.0,37.0,10.0,i6yb4yej,vmu7c279,FULL STUDY,205.0,s1,1,95,100.0,-1,,1,sell,0,sell,0.4240076400585448,19,1,0,block 2 (G first),23.0,11.0,Male,1.0,1.0,1.0,"[3, 'block 2 (G first)']",1,0,0,0.0,7.0,-0.21666666666666667,0.3076923076923077,0.0,1.0,0.0,1,0.25,1.0,Design 2,Design 2,"Have an option between Design #1 and Design #2,",,5.0,3.0
1527,4243,3,Player object (1063),sell,2023-03-09 22:00:36.044744+00:00,"{""priceA"": 95, ""sharesA"": 0, ""secs_since_round_starts"": 236, ""market"": ""A""}",220.0,41.0,11.0,i6yb4yej,vmu7c279,FULL STUDY,205.0,s1,1,95,95.0,1,0.0,1,buy,0,sell,0.4514823197003955,19,0,0,block 2 (G first),23.0,11.0,Male,1.0,1.0,1.0,"[3, 'block 2 (G first)']",1,0,0,0.0,7.0,-0.21666666666666667,0.3076923076923077,0.0,1.0,0.0,1,0.25,1.0,Design 2,Design 2,"Have an option between Design #1 and Design #2,",,5.0,3.0
1528,4244,3,Player object (1063),buy,2023-03-09 22:02:04.436905+00:00,"{""priceA"": 130, ""sharesA"": 1, ""secs_since_round_starts"": 325, ""market"": ""A""}",90.0,57.0,12.0,i6yb4yej,vmu7c279,FULL STUDY,205.0,s1,1,130,95.0,-1,,1,sell,0,sell,0.46726452652799,19,0,0,block 2 (G first),23.0,11.0,Male,1.0,1.0,1.0,"[3, 'block 2 (G first)']",1,0,0,0.0,7.0,-0.21666666666666667,0.3076923076923077,0.0,1.0,0.0,1,0.25,1.0,Design 2,Design 2,"Have an option between Design #1 and Design #2,",,5.0,3.0
1529,4248,4,Player object (1183),sell,2023-03-09 22:03:18.002484+00:00,"{""priceA"": 95, ""sharesA"": 0, ""secs_since_round_starts"": 50, ""market"": ""A""}",145.0,11.0,1.0,i6yb4yej,vmu7c279,FULL STUDY,210.0,s1,1,95,,1,,1,,0,sell,0.5796571916404338,14,0,0,block 2 (G first),23.0,11.0,Male,1.0,1.0,1.0,"[4, 'block 2 (G first)']",0,1,0,0.0,7.0,-0.21666666666666667,0.2222222222222222,0.15384615384615385,0.0,0.0,2,1.0,0.75,Design 2,Design 2,"Have an option between Design #1 and Design #2,",,5.0,3.0
1530,4249,4,Player object (1183),buy,2023-03-09 22:04:20.366201+00:00,"{""priceA"": 55, ""sharesA"": 1, ""secs_since_round_starts"": 113, ""market"": ""A""}",90.0,22.0,2.0,i6yb4yej,vmu7c279,FULL STUDY,210.0,s1,1,55,95.0,-1,,1,sell,0,sell,0.4224279859932807,14,1,0,block 2 (G first),23.0,11.0,Male,1.0,1.0,1.0,"[4, 'block 2 (G first)']",0,1,0,0.0,7.0,-0.21666666666666667,0.2222222222222222,0.15384615384615385,0.0,0.0,2,1.0,0.75,Design 2,Design 2,"Have an option between Design #1 and Design #2,",,5.0,3.0
1531,4251,4,Player object (1183),sell,2023-03-09 22:05:43.748512+00:00,"{""priceA"": 85, ""sharesA"": 0, ""secs_since_round_starts"": 196, ""market"": ""A""}",175.0,36.0,3.0,i6yb4yej,vmu7c279,FULL STUDY,210.0,s1,1,85,55.0,1,30.0,1,buy,0,sell,0.4885269486642424,14,0,0,block 2 (G first),23.0,11.0,Male,1.0,1.0,1.0,"[4, 'block 2 (G first)']",0,1,0,0.0,7.0,-0.21666666666666667,0.2222222222222222,0.15384615384615385,0.0,0.0,2,1.0,0.75,Design 2,Design 2,"Have an option between Design #1 and Design #2,",,5.0,3.0
1532,4252,4,Player object (1183),buy,2023-03-09 22:05:50.276407+00:00,"{""priceA"": 70, ""sharesA"": 1, ""secs_since_round_starts"": 203, ""market"": ""A""}",105.0,37.0,4.0,i6yb4yej,vmu7c279,FULL STUDY,210.0,s1,1,70,85.0,-1,,1,sell,0,sell,0.4570673777008929,14,0,0,block 2 (G first),23.0,11.0,Male,1.0,1.0,1.0,"[4, 'block 2 (G first)']",0,1,0,0.0,7.0,-0.21666666666666667,0.2222222222222222,0.15384615384615385,0.0,0.0,2,1.0,0.75,Design 2,Design 2,"Have an option between Design #1 and Design #2,",,5.0,3.0
1533,4253,4,Player object (1183),sell,2023-03-09 22:06:03.298508+00:00,"{""priceA"": 80, ""sharesA"": 0, ""secs_since_round_starts"": 216, ""market"": ""A""}",185.0,39.0,5.0,i6yb4yej,vmu7c279,FULL STUDY,210.0,s1,1,80,70.0,1,10.0,1,buy,0,sell,0.4897180556691627,14,0,0,block 2 (G first),23.0,11.0,Male,1.0,1.0,1.0,"[4, 'block 2 (G first)']",0,1,0,0.0,7.0,-0.21666666666666667,0.2222222222222222,0.15384615384615385,0.0,0.0,2,1.0,0.75,Design 2,Design 2,"Have an option between Design #1 and Design #2,",,5.0,3.0
1534,4254,4,Player object (1183),buy,2023-03-09 22:06:12.716173+00:00,"{""priceA"": 80, ""sharesA"": 1, ""secs_since_round_starts"": 225, ""market"": ""A""}",105.0,41.0,6.0,i6yb4yej,vmu7c279,FULL STUDY,210.0,s1,1,80,80.0,-1,,1,sell,0,sell,0.5055693706451859,14,0,0,block 2 (G first),23.0,11.0,Male,1.0,1.0,1.0,"[4, 'block 2 (G first)']",0,1,0,0.0,7.0,-0.21666666666666667,0.2222222222222222,0.15384615384615385,0.0,0.0,2,1.0,0.75,Design 2,Design 2,"Have an option between Design #1 and Design #2,",,5.0,3.0
1535,4255,4,Player object (1183),sell,2023-03-09 22:06:32.585771+00:00,"{""priceA"": 100, ""sharesA"": 0, ""secs_since_round_starts"": 245, ""market"": ""A""}",205.0,45.0,7.0,i6yb4yej,vmu7c279,FULL STUDY,210.0,s1,1,100,80.0,1,20.0,1,buy,0,sell,0.5193741863096629,14,0,0,block 2 (G first),23.0,11.0,Male,1.0,1.0,1.0,"[4, 'block 2 (G first)']",0,1,0,0.0,7.0,-0.21666666666666667,0.2222222222222222,0.15384615384615385,0.0,0.0,2,1.0,0.75,Design 2,Design 2,"Have an option between Design #1 and Design #2,",,5.0,3.0
1536,4256,4,Player object (1183),buy,2023-03-09 22:06:44.724552+00:00,"{""priceA"": 85, ""sharesA"": 1, ""secs_since_round_starts"": 257, ""market"": ""A""}",120.0,47.0,8.0,i6yb4yej,vmu7c279,FULL STUDY,210.0,s1,1,85,100.0,-1,,1,sell,0,sell,0.4501495476988393,14,1,0,block 2 (G first),23.0,11.0,Male,1.0,1.0,1.0,"[4, 'block 2 (G first)']",0,1,0,0.0,7.0,-0.21666666666666667,0.2222222222222222,0.15384615384615385,0.0,0.0,2,1.0,0.75,Design 2,Design 2,"Have an option between Design #1 and Design #2,",,5.0,3.0
1537,4257,4,Player object (1183),sell,2023-03-09 22:06:50.692485+00:00,"{""priceA"": 100, ""sharesA"": 0, ""secs_since_round_starts"": 263, ""market"": ""A""}",220.0,48.0,9.0,i6yb4yej,vmu7c279,FULL STUDY,210.0,s1,1,100,85.0,1,15.0,1,buy,0,sell,0.500105737602651,14,0,0,block 2 (G first),23.0,11.0,Male,1.0,1.0,1.0,"[4, 'block 2 (G first)']",0,1,0,0.0,7.0,-0.21666666666666667,0.2222222222222222,0.15384615384615385,0.0,0.0,2,1.0,0.75,Design 2,Design 2,"Have an option between Design #1 and Design #2,",,5.0,3.0
1538,4258,4,Player object (1183),buy,2023-03-09 22:07:02.329583+00:00,"{""priceA"": 120, ""sharesA"": 1, ""secs_since_round_starts"": 275, ""market"": ""A""}",100.0,50.0,10.0,i6yb4yej,vmu7c279,FULL STUDY,210.0,s1,1,120,100.0,-1,,1,sell,0,sell,0.5591364702939366,14,0,1,block 2 (G first),23.0,11.0,Male,1.0,1.0,1.0,"[4, 'block 2 (G first)']",0,1,0,0.0,7.0,-0.21666666666666667,0.2222222222222222,0.15384615384615385,0.0,0.0,2,1.0,0.75,Design 2,Design 2,"Have an option between Design #1 and Design #2,",,5.0,3.0
1539,4259,4,Player object (1183),sell,2023-03-09 22:07:06.136545+00:00,"{""priceA"": 105, ""sharesA"": 0, ""secs_since_round_starts"": 279, ""market"": ""A""}",205.0,51.0,11.0,i6yb4yej,vmu7c279,FULL STUDY,210.0,s1,1,105,120.0,1,-15.0,1,buy,0,sell,0.5064720763559888,14,0,0,block 2 (G first),23.0,11.0,Male,1.0,1.0,1.0,"[4, 'block 2 (G first)']",0,1,0,0.0,7.0,-0.21666666666666667,0.2222222222222222,0.15384615384615385,0.0,0.0,2,1.0,0.75,Design 2,Design 2,"Have an option between Design #1 and Design #2,",,5.0,3.0
1540,4260,4,Player object (1183),buy,2023-03-09 22:07:31.133482+00:00,"{""priceA"": 70, ""sharesA"": 1, ""secs_since_round_starts"": 304, ""market"": ""A""}",135.0,55.0,12.0,i6yb4yej,vmu7c279,FULL STUDY,210.0,s1,1,70,105.0,-1,,1,sell,0,sell,0.4620518023886796,14,0,0,block 2 (G first),23.0,11.0,Male,1.0,1.0,1.0,"[4, 'block 2 (G first)']",0,1,0,0.0,7.0,-0.21666666666666667,0.2222222222222222,0.15384615384615385,0.0,0.0,2,1.0,0.75,Design 2,Design 2,"Have an option between Design #1 and Design #2,",,5.0,3.0
1541,4264,5,Player object (1303),sell,2023-03-09 22:08:28.676273+00:00,"{""priceA"": 95, ""sharesA"": 0, ""secs_since_round_starts"": 26, ""market"": ""A""}",145.0,6.0,1.0,i6yb4yej,vmu7c279,FULL STUDY,210.0,s1,1,95,,1,,1,,0,sell,0.5560314405213382,17,0,1,block 2 (G first),23.0,11.0,Male,1.0,1.0,1.0,"[5, 'block 2 (G first)']",0,0,0,0.0,7.0,-0.21666666666666667,0.6,0.14285714285714285,1.0,0.2,5,0.25,1.0,Design 2,Design 2,"Have an option between Design #1 and Design #2,",,5.0,3.0
1542,4265,5,Player object (1303),buy,2023-03-09 22:08:45.435749+00:00,"{""priceA"": 80, ""sharesA"": 1, ""secs_since_round_starts"": 43, ""market"": ""A""}",65.0,9.0,2.0,i6yb4yej,vmu7c279,FULL STUDY,210.0,s1,1,80,95.0,-1,,1,sell,0,sell,0.4765586288879626,17,0,0,block 2 (G first),23.0,11.0,Male,1.0,1.0,1.0,"[5, 'block 2 (G first)']",0,0,0,0.0,7.0,-0.21666666666666667,0.6,0.14285714285714285,1.0,0.2,5,0.25,1.0,Design 2,Design 2,"Have an option between Design #1 and Design #2,",,5.0,3.0
1543,4268,5,Player object (1303),sell,2023-03-09 22:08:56.859612+00:00,"{""priceA"": 85, ""sharesA"": 0, ""secs_since_round_starts"": 54, ""market"": ""A""}",150.0,11.0,4.0,i6yb4yej,vmu7c279,FULL STUDY,210.0,s1,1,85,75.0,1,10.0,1,buy,0,sell,0.4991731929932316,17,0,0,block 2 (G first),23.0,11.0,Male,1.0,1.0,1.0,"[5, 'block 2 (G first)']",0,0,0,0.0,7.0,-0.21666666666666667,0.6,0.14285714285714285,1.0,0.2,5,0.25,1.0,Design 2,Design 2,"Have an option between Design #1 and Design #2,",,5.0,3.0
1544,4269,5,Player object (1303),buy,2023-03-09 22:09:12.709605+00:00,"{""priceA"": 80, ""sharesA"": 1, ""secs_since_round_starts"": 70, ""market"": ""A""}",70.0,14.0,5.0,i6yb4yej,vmu7c279,FULL STUDY,210.0,s1,1,80,85.0,-1,,1,sell,0,sell,0.457409789643144,17,0,0,block 2 (G first),23.0,11.0,Male,1.0,1.0,1.0,"[5, 'block 2 (G first)']",0,0,0,0.0,7.0,-0.21666666666666667,0.6,0.14285714285714285,1.0,0.2,5,0.25,1.0,Design 2,Design 2,"Have an option between Design #1 and Design #2,",,5.0,3.0
1545,4270,5,Player object (1303),sell,2023-03-09 22:09:25.151937+00:00,"{""priceA"": 85, ""sharesA"": 0, ""secs_since_round_starts"": 82, ""market"": ""A""}",155.0,16.0,6.0,i6yb4yej,vmu7c279,FULL STUDY,210.0,s1,1,85,80.0,1,5.0,1,buy,0,sell,0.4686291671454359,17,0,0,block 2 (G first),23.0,11.0,Male,1.0,1.0,1.0,"[5, 'block 2 (G first)']",0,0,0,0.0,7.0,-0.21666666666666667,0.6,0.14285714285714285,1.0,0.2,5,0.25,1.0,Design 2,Design 2,"Have an option between Design #1 and Design #2,",,5.0,3.0
1546,4271,5,Player object (1303),buy,2023-03-09 22:09:30.381328+00:00,"{""priceA"": 80, ""sharesA"": 1, ""secs_since_round_starts"": 88, ""market"": ""A""}",75.0,17.0,7.0,i6yb4yej,vmu7c279,FULL STUDY,210.0,s1,1,80,85.0,-1,,1,sell,0,sell,0.4433955626702647,17,0,0,block 2 (G first),23.0,11.0,Male,1.0,1.0,1.0,"[5, 'block 2 (G first)']",0,0,0,0.0,7.0,-0.21666666666666667,0.6,0.14285714285714285,1.0,0.2,5,0.25,1.0,Design 2,Design 2,"Have an option between Design #1 and Design #2,",,5.0,3.0
1547,4272,5,Player object (1303),sell,2023-03-09 22:09:50.096313+00:00,"{""priceA"": 105, ""sharesA"": 0, ""secs_since_round_starts"": 107, ""market"": ""A""}",180.0,21.0,8.0,i6yb4yej,vmu7c279,FULL STUDY,210.0,s1,1,105,80.0,1,25.0,1,buy,0,sell,0.5510362930796925,17,0,1,block 2 (G first),23.0,11.0,Male,1.0,1.0,1.0,"[5, 'block 2 (G first)']",0,0,0,0.0,7.0,-0.21666666666666667,0.6,0.14285714285714285,1.0,0.2,5,0.25,1.0,Design 2,Design 2,"Have an option between Design #1 and Design #2,",,5.0,3.0
1548,4273,5,Player object (1303),buy,2023-03-09 22:10:12.790783+00:00,"{""priceA"": 115, ""sharesA"": 1, ""secs_since_round_starts"": 130, ""market"": ""A""}",65.0,25.0,9.0,i6yb4yej,vmu7c279,FULL STUDY,210.0,s1,1,115,105.0,-1,,1,sell,0,sell,0.5757035170695836,17,0,1,block 2 (G first),23.0,11.0,Male,1.0,1.0,1.0,"[5, 'block 2 (G first)']",0,0,0,0.0,7.0,-0.21666666666666667,0.6,0.14285714285714285,1.0,0.2,5,0.25,1.0,Design 2,Design 2,"Have an option between Design #1 and Design #2,",,5.0,3.0
1549,4274,5,Player object (1303),sell,2023-03-09 22:10:17.605187+00:00,"{""priceA"": 105, ""sharesA"": 0, ""secs_since_round_starts"": 135, ""market"": ""A""}",170.0,26.0,10.0,i6yb4yej,vmu7c279,FULL STUDY,210.0,s1,1,105,115.0,1,-10.0,1,buy,0,sell,0.5182690684964619,17,0,0,block 2 (G first),23.0,11.0,Male,1.0,1.0,1.0,"[5, 'block 2 (G first)']",0,0,0,0.0,7.0,-0.21666666666666667,0.6,0.14285714285714285,1.0,0.2,5,0.25,1.0,Design 2,Design 2,"Have an option between Design #1 and Design #2,",,5.0,3.0
1550,4275,5,Player object (1303),buy,2023-03-09 22:10:30.629633+00:00,"{""priceA"": 85, ""sharesA"": 1, ""secs_since_round_starts"": 148, ""market"": ""A""}",85.0,28.0,11.0,i6yb4yej,vmu7c279,FULL STUDY,210.0,s1,1,85,105.0,-1,,1,sell,0,sell,0.4496194529460131,17,1,0,block 2 (G first),23.0,11.0,Male,1.0,1.0,1.0,"[5, 'block 2 (G first)']",0,0,0,0.0,7.0,-0.21666666666666667,0.6,0.14285714285714285,1.0,0.2,5,0.25,1.0,Design 2,Design 2,"Have an option between Design #1 and Design #2,",,5.0,3.0
1551,4277,5,Player object (1303),sell,2023-03-09 22:10:57.096957+00:00,"{""priceA"": 110, ""sharesA"": 0, ""secs_since_round_starts"": 174, ""market"": ""A""}",195.0,33.0,12.0,i6yb4yej,vmu7c279,FULL STUDY,210.0,s1,1,110,85.0,1,25.0,1,buy,0,sell,0.5480287979668599,17,0,1,block 2 (G first),23.0,11.0,Male,1.0,1.0,1.0,"[5, 'block 2 (G first)']",0,0,0,0.0,7.0,-0.21666666666666667,0.6,0.14285714285714285,1.0,0.2,5,0.25,1.0,Design 2,Design 2,"Have an option between Design #1 and Design #2,",,5.0,3.0
1552,4278,5,Player object (1303),buy,2023-03-09 22:11:02.508935+00:00,"{""priceA"": 120, ""sharesA"": 1, ""secs_since_round_starts"": 180, ""market"": ""A""}",75.0,34.0,13.0,i6yb4yej,vmu7c279,FULL STUDY,210.0,s1,1,120,110.0,-1,,1,sell,0,sell,0.5679672812132522,17,0,0,block 2 (G first),23.0,11.0,Male,1.0,1.0,1.0,"[5, 'block 2 (G first)']",0,0,0,0.0,7.0,-0.21666666666666667,0.6,0.14285714285714285,1.0,0.2,5,0.25,1.0,Design 2,Design 2,"Have an option between Design #1 and Design #2,",,5.0,3.0
1553,4279,5,Player object (1303),sell,2023-03-09 22:11:04.914860+00:00,"{""priceA"": 125, ""sharesA"": 0, ""secs_since_round_starts"": 182, ""market"": ""A""}",200.0,35.0,14.0,i6yb4yej,vmu7c279,FULL STUDY,210.0,s1,1,125,120.0,1,5.0,1,buy,0,sell,0.5814696428244381,17,0,0,block 2 (G first),23.0,11.0,Male,1.0,1.0,1.0,"[5, 'block 2 (G first)']",0,0,0,0.0,7.0,-0.21666666666666667,0.6,0.14285714285714285,1.0,0.2,5,0.25,1.0,Design 2,Design 2,"Have an option between Design #1 and Design #2,",,5.0,3.0
1554,4280,5,Player object (1303),buy,2023-03-09 22:11:14.672067+00:00,"{""priceA"": 110, ""sharesA"": 1, ""secs_since_round_starts"": 192, ""market"": ""A""}",90.0,36.0,15.0,i6yb4yej,vmu7c279,FULL STUDY,210.0,s1,1,110,125.0,-1,,1,sell,0,sell,0.5223936301876935,17,0,0,block 2 (G first),23.0,11.0,Male,1.0,1.0,1.0,"[5, 'block 2 (G first)']",0,0,0,0.0,7.0,-0.21666666666666667,0.6,0.14285714285714285,1.0,0.2,5,0.25,1.0,Design 2,Design 2,"Have an option between Design #1 and Design #2,",,5.0,3.0
1555,4281,5,Player object (1303),sell,2023-03-09 22:11:52.131811+00:00,"{""priceA"": 110, ""sharesA"": 0, ""secs_since_round_starts"": 229, ""market"": ""A""}",200.0,43.0,16.0,i6yb4yej,vmu7c279,FULL STUDY,210.0,s1,1,110,110.0,1,0.0,1,buy,0,sell,0.571300234525265,17,0,0,block 2 (G first),23.0,11.0,Male,1.0,1.0,1.0,"[5, 'block 2 (G first)']",0,0,0,0.0,7.0,-0.21666666666666667,0.6,0.14285714285714285,1.0,0.2,5,0.25,1.0,Design 2,Design 2,"Have an option between Design #1 and Design #2,",,5.0,3.0
1556,4282,5,Player object (1303),buy,2023-03-09 22:12:17.658660+00:00,"{""priceA"": 75, ""sharesA"": 1, ""secs_since_round_starts"": 255, ""market"": ""A""}",125.0,48.0,17.0,i6yb4yej,vmu7c279,FULL STUDY,210.0,s1,1,75,110.0,-1,,1,sell,0,sell,0.4393932183506925,17,1,0,block 2 (G first),23.0,11.0,Male,1.0,1.0,1.0,"[5, 'block 2 (G first)']",0,0,0,0.0,7.0,-0.21666666666666667,0.6,0.14285714285714285,1.0,0.2,5,0.25,1.0,Design 2,Design 2,"Have an option between Design #1 and Design #2,",,5.0,3.0
1557,4283,5,Player object (1303),sell,2023-03-09 22:12:35.747240+00:00,"{""priceA"": 85, ""sharesA"": 0, ""secs_since_round_starts"": 273, ""market"": ""A""}",210.0,51.0,18.0,i6yb4yej,vmu7c279,FULL STUDY,210.0,s1,1,85,75.0,1,10.0,1,buy,0,sell,0.5069151322589074,17,0,0,block 2 (G first),23.0,11.0,Male,1.0,1.0,1.0,"[5, 'block 2 (G first)']",0,0,0,0.0,7.0,-0.21666666666666667,0.6,0.14285714285714285,1.0,0.2,5,0.25,1.0,Design 2,Design 2,"Have an option between Design #1 and Design #2,",,5.0,3.0
1558,5050,2,Player object (1511),sell,2023-03-10 12:36:36.917471+00:00,"{""priceA"": 110, ""sharesA"": 0, ""secs_since_round_starts"": 64, ""market"": ""A""}",160.0,6.0,1.0,in3zb9k3,t7od4xlw,FULL STUDY,180.0,s3,1,110,,1,,1,,0,sell,0.5028735207100592,16,0,0,block 2 (G first),21.0,12.0,Female,1.0,1.0,1.0,"[2, 'block 2 (G first)']",1,1,0,0.5,7.0,-0.30000000000000004,0.4,0.0,0.5,0.0,4,1.0,0.75,Design 1,Design 1,"Have an option between Design #1 and Design #2,",3.0,4.0,4.0
1559,5051,2,Player object (1511),buy,2023-03-10 12:36:46.648397+00:00,"{""priceA"": 85, ""sharesA"": 1, ""secs_since_round_starts"": 74, ""market"": ""A""}",75.0,8.0,2.0,in3zb9k3,t7od4xlw,FULL STUDY,180.0,s3,1,85,110.0,-1,,1,sell,0,sell,0.4422758127435268,16,1,0,block 2 (G first),21.0,12.0,Female,1.0,1.0,1.0,"[2, 'block 2 (G first)']",1,1,0,0.5,7.0,-0.30000000000000004,0.4,0.0,0.5,0.0,4,1.0,0.75,Design 1,Design 1,"Have an option between Design #1 and Design #2,",3.0,4.0,4.0
1560,5053,2,Player object (1511),sell,2023-03-10 12:37:35.243402+00:00,"{""priceA"": 110, ""sharesA"": 0, ""secs_since_round_starts"": 123, ""market"": ""A""}",185.0,17.0,3.0,in3zb9k3,t7od4xlw,FULL STUDY,180.0,s3,1,110,85.0,1,25.0,1,buy,0,sell,0.5478276073026133,16,0,0,block 2 (G first),21.0,12.0,Female,1.0,1.0,1.0,"[2, 'block 2 (G first)']",1,1,0,0.5,7.0,-0.30000000000000004,0.4,0.0,0.5,0.0,4,1.0,0.75,Design 1,Design 1,"Have an option between Design #1 and Design #2,",3.0,4.0,4.0
1561,5064,2,Player object (1511),buy,2023-03-10 12:38:18.468706+00:00,"{""priceA"": 145, ""sharesA"": 1, ""secs_since_round_starts"": 166, ""market"": ""A""}",40.0,25.0,4.0,in3zb9k3,t7od4xlw,FULL STUDY,180.0,s3,1,145,110.0,-1,,1,sell,0,sell,0.5294358264188312,16,0,0,block 2 (G first),21.0,12.0,Female,1.0,1.0,1.0,"[2, 'block 2 (G first)']",1,1,0,0.5,7.0,-0.30000000000000004,0.4,0.0,0.5,0.0,4,1.0,0.75,Design 1,Design 1,"Have an option between Design #1 and Design #2,",3.0,4.0,4.0
1562,5073,2,Player object (1511),sell,2023-03-10 12:40:17.181088+00:00,"{""priceA"": 155, ""sharesA"": 0, ""secs_since_round_starts"": 285, ""market"": ""A""}",195.0,46.0,5.0,in3zb9k3,t7od4xlw,FULL STUDY,180.0,s3,1,155,145.0,1,10.0,1,buy,0,sell,0.5495494947508355,16,0,1,block 2 (G first),21.0,12.0,Female,1.0,1.0,1.0,"[2, 'block 2 (G first)']",1,1,0,0.5,7.0,-0.30000000000000004,0.4,0.0,0.5,0.0,4,1.0,0.75,Design 1,Design 1,"Have an option between Design #1 and Design #2,",3.0,4.0,4.0
1563,5074,2,Player object (1511),buy,2023-03-10 12:40:22.484365+00:00,"{""priceA"": 140, ""sharesA"": 1, ""secs_since_round_starts"": 290, ""market"": ""A""}",55.0,47.0,6.0,in3zb9k3,t7od4xlw,FULL STUDY,180.0,s3,1,140,155.0,-1,,1,sell,0,sell,0.4996814899229063,16,0,0,block 2 (G first),21.0,12.0,Female,1.0,1.0,1.0,"[2, 'block 2 (G first)']",1,1,0,0.5,7.0,-0.30000000000000004,0.4,0.0,0.5,0.0,4,1.0,0.75,Design 1,Design 1,"Have an option between Design #1 and Design #2,",3.0,4.0,4.0
1564,5075,2,Player object (1511),sell,2023-03-10 12:40:28.492144+00:00,"{""priceA"": 155, ""sharesA"": 0, ""secs_since_round_starts"": 296, ""market"": ""A""}",210.0,48.0,7.0,in3zb9k3,t7od4xlw,FULL STUDY,180.0,s3,1,155,140.0,1,15.0,1,buy,0,sell,0.5347792584548927,16,0,0,block 2 (G first),21.0,12.0,Female,1.0,1.0,1.0,"[2, 'block 2 (G first)']",1,1,0,0.5,7.0,-0.30000000000000004,0.4,0.0,0.5,0.0,4,1.0,0.75,Design 1,Design 1,"Have an option between Design #1 and Design #2,",3.0,4.0,4.0
1565,5076,2,Player object (1511),buy,2023-03-10 12:40:39.440354+00:00,"{""priceA"": 155, ""sharesA"": 1, ""secs_since_round_starts"": 307, ""market"": ""A""}",55.0,50.0,8.0,in3zb9k3,t7od4xlw,FULL STUDY,180.0,s3,1,155,155.0,-1,,1,sell,0,sell,0.5063294801170398,16,0,0,block 2 (G first),21.0,12.0,Female,1.0,1.0,1.0,"[2, 'block 2 (G first)']",1,1,0,0.5,7.0,-0.30000000000000004,0.4,0.0,0.5,0.0,4,1.0,0.75,Design 1,Design 1,"Have an option between Design #1 and Design #2,",3.0,4.0,4.0
1566,5085,3,Player object (1691),sell,2023-03-10 12:42:28.583953+00:00,"{""priceA"": 110, ""sharesA"": 0, ""secs_since_round_starts"": 47, ""market"": ""A""}",160.0,9.0,1.0,in3zb9k3,t7od4xlw,FULL STUDY,235.0,s3,1,110,,1,,1,,0,sell,0.5389563723055646,19,0,0,block 2 (G first),21.0,12.0,Female,1.0,1.0,1.0,"[3, 'block 2 (G first)']",1,0,0,0.5,7.0,-0.30000000000000004,0.875,0.07142857142857142,1.0,0.0,4,1.0,0.5,Design 1,Design 1,"Have an option between Design #1 and Design #2,",3.0,4.0,4.0
1567,5088,3,Player object (1691),buy,2023-03-10 12:42:34.883090+00:00,"{""priceA"": 95, ""sharesA"": 1, ""secs_since_round_starts"": 53, ""market"": ""A""}",65.0,10.0,2.0,in3zb9k3,t7od4xlw,FULL STUDY,235.0,s3,1,95,110.0,-1,,1,sell,0,sell,0.4922087569005138,19,0,0,block 2 (G first),21.0,12.0,Female,1.0,1.0,1.0,"[3, 'block 2 (G first)']",1,0,0,0.5,7.0,-0.30000000000000004,0.875,0.07142857142857142,1.0,0.0,4,1.0,0.5,Design 1,Design 1,"Have an option between Design #1 and Design #2,",3.0,4.0,4.0
1568,5091,3,Player object (1691),sell,2023-03-10 12:42:38.843767+00:00,"{""priceA"": 110, ""sharesA"": 0, ""secs_since_round_starts"": 57, ""market"": ""A""}",175.0,11.0,3.0,in3zb9k3,t7od4xlw,FULL STUDY,235.0,s3,1,110,95.0,1,15.0,1,buy,0,sell,0.5295922419004607,19,0,0,block 2 (G first),21.0,12.0,Female,1.0,1.0,1.0,"[3, 'block 2 (G first)']",1,0,0,0.5,7.0,-0.30000000000000004,0.875,0.07142857142857142,1.0,0.0,4,1.0,0.5,Design 1,Design 1,"Have an option between Design #1 and Design #2,",3.0,4.0,4.0
1569,5096,3,Player object (1691),buy,2023-03-10 12:43:01.304397+00:00,"{""priceA"": 110, ""sharesA"": 1, ""secs_since_round_starts"": 80, ""market"": ""A""}",65.0,15.0,4.0,in3zb9k3,t7od4xlw,FULL STUDY,235.0,s3,1,110,110.0,-1,,1,sell,0,sell,0.4763410641166328,19,0,0,block 2 (G first),21.0,12.0,Female,1.0,1.0,1.0,"[3, 'block 2 (G first)']",1,0,0,0.5,7.0,-0.30000000000000004,0.875,0.07142857142857142,1.0,0.0,4,1.0,0.5,Design 1,Design 1,"Have an option between Design #1 and Design #2,",3.0,4.0,4.0
1570,5099,3,Player object (1691),sell,2023-03-10 12:43:23.369981+00:00,"{""priceA"": 120, ""sharesA"": 0, ""secs_since_round_starts"": 102, ""market"": ""A""}",185.0,19.0,5.0,in3zb9k3,t7od4xlw,FULL STUDY,235.0,s3,1,120,110.0,1,10.0,1,buy,0,sell,0.5586446427659006,19,0,1,block 2 (G first),21.0,12.0,Female,1.0,1.0,1.0,"[3, 'block 2 (G first)']",1,0,0,0.5,7.0,-0.30000000000000004,0.875,0.07142857142857142,1.0,0.0,4,1.0,0.5,Design 1,Design 1,"Have an option between Design #1 and Design #2,",3.0,4.0,4.0
1571,5100,3,Player object (1691),buy,2023-03-10 12:43:34.254701+00:00,"{""priceA"": 100, ""sharesA"": 1, ""secs_since_round_starts"": 113, ""market"": ""A""}",85.0,21.0,6.0,in3zb9k3,t7od4xlw,FULL STUDY,235.0,s3,1,100,120.0,-1,,1,sell,0,sell,0.4692484881524699,19,0,0,block 2 (G first),21.0,12.0,Female,1.0,1.0,1.0,"[3, 'block 2 (G first)']",1,0,0,0.5,7.0,-0.30000000000000004,0.875,0.07142857142857142,1.0,0.0,4,1.0,0.5,Design 1,Design 1,"Have an option between Design #1 and Design #2,",3.0,4.0,4.0
1572,5102,3,Player object (1691),sell,2023-03-10 12:43:50.256381+00:00,"{""priceA"": 115, ""sharesA"": 0, ""secs_since_round_starts"": 129, ""market"": ""A""}",200.0,24.0,7.0,in3zb9k3,t7od4xlw,FULL STUDY,235.0,s3,1,115,100.0,1,15.0,1,buy,0,sell,0.5319650978870379,19,0,0,block 2 (G first),21.0,12.0,Female,1.0,1.0,1.0,"[3, 'block 2 (G first)']",1,0,0,0.5,7.0,-0.30000000000000004,0.875,0.07142857142857142,1.0,0.0,4,1.0,0.5,Design 1,Design 1,"Have an option between Design #1 and Design #2,",3.0,4.0,4.0
1573,5108,3,Player object (1691),buy,2023-03-10 12:44:35.712355+00:00,"{""priceA"": 110, ""sharesA"": 1, ""secs_since_round_starts"": 174, ""market"": ""A""}",90.0,32.0,8.0,in3zb9k3,t7od4xlw,FULL STUDY,235.0,s3,1,110,115.0,-1,,1,sell,0,sell,0.4748947710808772,19,0,0,block 2 (G first),21.0,12.0,Female,1.0,1.0,1.0,"[3, 'block 2 (G first)']",1,0,0,0.5,7.0,-0.30000000000000004,0.875,0.07142857142857142,1.0,0.0,4,1.0,0.5,Design 1,Design 1,"Have an option between Design #1 and Design #2,",3.0,4.0,4.0
1574,5113,3,Player object (1691),sell,2023-03-10 12:45:12.787313+00:00,"{""priceA"": 115, ""sharesA"": 0, ""secs_since_round_starts"": 211, ""market"": ""A""}",205.0,39.0,9.0,in3zb9k3,t7od4xlw,FULL STUDY,235.0,s3,1,115,110.0,1,5.0,1,buy,0,sell,0.5221490272476892,19,0,0,block 2 (G first),21.0,12.0,Female,1.0,1.0,1.0,"[3, 'block 2 (G first)']",1,0,0,0.5,7.0,-0.30000000000000004,0.875,0.07142857142857142,1.0,0.0,4,1.0,0.5,Design 1,Design 1,"Have an option between Design #1 and Design #2,",3.0,4.0,4.0
1575,5115,3,Player object (1691),buy,2023-03-10 12:45:19.676962+00:00,"{""priceA"": 100, ""sharesA"": 1, ""secs_since_round_starts"": 218, ""market"": ""A""}",105.0,40.0,10.0,in3zb9k3,t7od4xlw,FULL STUDY,235.0,s3,1,100,115.0,-1,,1,sell,0,sell,0.4804175727303482,19,0,0,block 2 (G first),21.0,12.0,Female,1.0,1.0,1.0,"[3, 'block 2 (G first)']",1,0,0,0.5,7.0,-0.30000000000000004,0.875,0.07142857142857142,1.0,0.0,4,1.0,0.5,Design 1,Design 1,"Have an option between Design #1 and Design #2,",3.0,4.0,4.0
1576,5119,3,Player object (1691),sell,2023-03-10 12:45:39.792410+00:00,"{""priceA"": 120, ""sharesA"": 0, ""secs_since_round_starts"": 238, ""market"": ""A""}",225.0,43.0,11.0,in3zb9k3,t7od4xlw,FULL STUDY,235.0,s3,1,120,100.0,1,20.0,1,buy,0,sell,0.5357259670782416,19,0,0,block 2 (G first),21.0,12.0,Female,1.0,1.0,1.0,"[3, 'block 2 (G first)']",1,0,0,0.5,7.0,-0.30000000000000004,0.875,0.07142857142857142,1.0,0.0,4,1.0,0.5,Design 1,Design 1,"Have an option between Design #1 and Design #2,",3.0,4.0,4.0
1577,5125,3,Player object (1691),buy,2023-03-10 12:46:14.284719+00:00,"{""priceA"": 110, ""sharesA"": 1, ""secs_since_round_starts"": 273, ""market"": ""A""}",115.0,49.0,12.0,in3zb9k3,t7od4xlw,FULL STUDY,235.0,s3,1,110,120.0,-1,,1,sell,0,sell,0.4374794566672981,19,1,0,block 2 (G first),21.0,12.0,Female,1.0,1.0,1.0,"[3, 'block 2 (G first)']",1,0,0,0.5,7.0,-0.30000000000000004,0.875,0.07142857142857142,1.0,0.0,4,1.0,0.5,Design 1,Design 1,"Have an option between Design #1 and Design #2,",3.0,4.0,4.0
1578,5128,3,Player object (1691),sell,2023-03-10 12:46:18.650221+00:00,"{""priceA"": 125, ""sharesA"": 0, ""secs_since_round_starts"": 277, ""market"": ""A""}",240.0,50.0,13.0,in3zb9k3,t7od4xlw,FULL STUDY,235.0,s3,1,125,110.0,1,15.0,1,buy,0,sell,0.4911246412164243,19,0,0,block 2 (G first),21.0,12.0,Female,1.0,1.0,1.0,"[3, 'block 2 (G first)']",1,0,0,0.5,7.0,-0.30000000000000004,0.875,0.07142857142857142,1.0,0.0,4,1.0,0.5,Design 1,Design 1,"Have an option between Design #1 and Design #2,",3.0,4.0,4.0
1579,5135,3,Player object (1691),buy,2023-03-10 12:46:57.256917+00:00,"{""priceA"": 130, ""sharesA"": 1, ""secs_since_round_starts"": 316, ""market"": ""A""}",110.0,57.0,14.0,in3zb9k3,t7od4xlw,FULL STUDY,235.0,s3,1,130,125.0,-1,,1,sell,0,sell,0.46726452652799,19,0,0,block 2 (G first),21.0,12.0,Female,1.0,1.0,1.0,"[3, 'block 2 (G first)']",1,0,0,0.5,7.0,-0.30000000000000004,0.875,0.07142857142857142,1.0,0.0,4,1.0,0.5,Design 1,Design 1,"Have an option between Design #1 and Design #2,",3.0,4.0,4.0
1580,5137,3,Player object (1691),sell,2023-03-10 12:47:08.458844+00:00,"{""priceA"": 125, ""sharesA"": 0, ""secs_since_round_starts"": 327, ""market"": ""A""}",235.0,59.0,15.0,in3zb9k3,t7od4xlw,FULL STUDY,235.0,s3,1,125,130.0,1,-5.0,1,buy,0,sell,0.4946618842475483,19,0,0,block 2 (G first),21.0,12.0,Female,1.0,1.0,1.0,"[3, 'block 2 (G first)']",1,0,0,0.5,7.0,-0.30000000000000004,0.875,0.07142857142857142,1.0,0.0,4,1.0,0.5,Design 1,Design 1,"Have an option between Design #1 and Design #2,",3.0,4.0,4.0
1581,5139,3,Player object (1691),buy,2023-03-10 12:47:18.083104+00:00,"{""priceA"": 115, ""sharesA"": 1, ""secs_since_round_starts"": 336, ""market"": ""A""}",120.0,60.0,16.0,in3zb9k3,t7od4xlw,FULL STUDY,235.0,s3,1,115,125.0,-1,,1,sell,0,sell,0.4613046310449969,19,0,0,block 2 (G first),21.0,12.0,Female,1.0,1.0,1.0,"[3, 'block 2 (G first)']",1,0,0,0.5,7.0,-0.30000000000000004,0.875,0.07142857142857142,1.0,0.0,4,1.0,0.5,Design 1,Design 1,"Have an option between Design #1 and Design #2,",3.0,4.0,4.0
1582,5150,4,Player object (1871),sell,2023-03-10 12:48:45.070167+00:00,"{""priceA"": 80, ""sharesA"": 0, ""secs_since_round_starts"": 46, ""market"": ""A""}",130.0,10.0,1.0,in3zb9k3,t7od4xlw,FULL STUDY,80.0,s3,1,80,,1,,1,,0,sell,0.5652817482669988,14,0,0,block 2 (G first),21.0,12.0,Female,1.0,1.0,1.0,"[4, 'block 2 (G first)']",0,1,0,0.5,7.0,-0.30000000000000004,1.0,0.09375,,0.0,2,1.0,0.5,Design 1,Design 1,"Have an option between Design #1 and Design #2,",3.0,4.0,4.0
1583,5151,4,Player object (1871),buy,2023-03-10 12:48:55.220486+00:00,"{""priceA"": 90, ""sharesA"": 1, ""secs_since_round_starts"": 56, ""market"": ""A""}",40.0,12.0,2.0,in3zb9k3,t7od4xlw,FULL STUDY,80.0,s3,1,90,80.0,-1,,1,sell,0,sell,0.5210961257750505,14,0,0,block 2 (G first),21.0,12.0,Female,1.0,1.0,1.0,"[4, 'block 2 (G first)']",0,1,0,0.5,7.0,-0.30000000000000004,1.0,0.09375,,0.0,2,1.0,0.5,Design 1,Design 1,"Have an option between Design #1 and Design #2,",3.0,4.0,4.0
1584,5152,4,Player object (1871),sell,2023-03-10 12:49:02.558941+00:00,"{""priceA"": 75, ""sharesA"": 0, ""secs_since_round_starts"": 64, ""market"": ""A""}",115.0,13.0,3.0,in3zb9k3,t7od4xlw,FULL STUDY,80.0,s3,1,75,90.0,1,-15.0,1,buy,0,sell,0.479681559969247,14,0,0,block 2 (G first),21.0,12.0,Female,1.0,1.0,1.0,"[4, 'block 2 (G first)']",0,1,0,0.5,7.0,-0.30000000000000004,1.0,0.09375,,0.0,2,1.0,0.5,Design 1,Design 1,"Have an option between Design #1 and Design #2,",3.0,4.0,4.0
1585,5155,4,Player object (1871),buy,2023-03-10 12:49:23.195792+00:00,"{""priceA"": 85, ""sharesA"": 1, ""secs_since_round_starts"": 84, ""market"": ""A""}",30.0,17.0,4.0,in3zb9k3,t7od4xlw,FULL STUDY,80.0,s3,1,85,75.0,-1,,1,sell,0,sell,0.4647046911342559,14,0,0,block 2 (G first),21.0,12.0,Female,1.0,1.0,1.0,"[4, 'block 2 (G first)']",0,1,0,0.5,7.0,-0.30000000000000004,1.0,0.09375,,0.0,2,1.0,0.5,Design 1,Design 1,"Have an option between Design #1 and Design #2,",3.0,4.0,4.0
1586,5158,4,Player object (1871),sell,2023-03-10 12:50:17.466363+00:00,"{""priceA"": 65, ""sharesA"": 0, ""secs_since_round_starts"": 139, ""market"": ""A""}",95.0,27.0,5.0,in3zb9k3,t7od4xlw,FULL STUDY,80.0,s3,1,65,85.0,1,-20.0,1,buy,0,sell,0.5259713378953906,14,0,0,block 2 (G first),21.0,12.0,Female,1.0,1.0,1.0,"[4, 'block 2 (G first)']",0,1,0,0.5,7.0,-0.30000000000000004,1.0,0.09375,,0.0,2,1.0,0.5,Design 1,Design 1,"Have an option between Design #1 and Design #2,",3.0,4.0,4.0
1587,5166,4,Player object (1871),buy,2023-03-10 12:51:07.525355+00:00,"{""priceA"": 85, ""sharesA"": 1, ""secs_since_round_starts"": 189, ""market"": ""A""}",10.0,36.0,6.0,in3zb9k3,t7od4xlw,FULL STUDY,80.0,s3,1,85,65.0,-1,,1,sell,0,sell,0.4885269486642424,14,0,0,block 2 (G first),21.0,12.0,Female,1.0,1.0,1.0,"[4, 'block 2 (G first)']",0,1,0,0.5,7.0,-0.30000000000000004,1.0,0.09375,,0.0,2,1.0,0.5,Design 1,Design 1,"Have an option between Design #1 and Design #2,",3.0,4.0,4.0
1588,5168,4,Player object (1871),sell,2023-03-10 12:51:42.384713+00:00,"{""priceA"": 95, ""sharesA"": 0, ""secs_since_round_starts"": 224, ""market"": ""A""}",105.0,42.0,7.0,in3zb9k3,t7od4xlw,FULL STUDY,80.0,s3,1,95,85.0,1,10.0,1,buy,0,sell,0.5388552795609507,14,0,0,block 2 (G first),21.0,12.0,Female,1.0,1.0,1.0,"[4, 'block 2 (G first)']",0,1,0,0.5,7.0,-0.30000000000000004,1.0,0.09375,,0.0,2,1.0,0.5,Design 1,Design 1,"Have an option between Design #1 and Design #2,",3.0,4.0,4.0
1589,5170,4,Player object (1871),buy,2023-03-10 12:51:57.326815+00:00,"{""priceA"": 100, ""sharesA"": 1, ""secs_since_round_starts"": 238, ""market"": ""A""}",5.0,45.0,8.0,in3zb9k3,t7od4xlw,FULL STUDY,80.0,s3,1,100,95.0,-1,,1,sell,0,sell,0.5193741863096629,14,0,0,block 2 (G first),21.0,12.0,Female,1.0,1.0,1.0,"[4, 'block 2 (G first)']",0,1,0,0.5,7.0,-0.30000000000000004,1.0,0.09375,,0.0,2,1.0,0.5,Design 1,Design 1,"Have an option between Design #1 and Design #2,",3.0,4.0,4.0
1590,5172,4,Player object (1871),sell,2023-03-10 12:52:18.974019+00:00,"{""priceA"": 105, ""sharesA"": 0, ""secs_since_round_starts"": 260, ""market"": ""A""}",110.0,49.0,9.0,in3zb9k3,t7od4xlw,FULL STUDY,80.0,s3,1,105,100.0,1,5.0,1,buy,0,sell,0.5350732746090608,14,0,0,block 2 (G first),21.0,12.0,Female,1.0,1.0,1.0,"[4, 'block 2 (G first)']",0,1,0,0.5,7.0,-0.30000000000000004,1.0,0.09375,,0.0,2,1.0,0.5,Design 1,Design 1,"Have an option between Design #1 and Design #2,",3.0,4.0,4.0
1591,5173,4,Player object (1871),buy,2023-03-10 12:52:30.623577+00:00,"{""priceA"": 105, ""sharesA"": 1, ""secs_since_round_starts"": 272, ""market"": ""A""}",5.0,51.0,10.0,in3zb9k3,t7od4xlw,FULL STUDY,80.0,s3,1,105,105.0,-1,,1,sell,0,sell,0.5064720763559888,14,0,0,block 2 (G first),21.0,12.0,Female,1.0,1.0,1.0,"[4, 'block 2 (G first)']",0,1,0,0.5,7.0,-0.30000000000000004,1.0,0.09375,,0.0,2,1.0,0.5,Design 1,Design 1,"Have an option between Design #1 and Design #2,",3.0,4.0,4.0
1592,5181,5,Player object (2051),sell,2023-03-10 12:54:29.784457+00:00,"{""priceA"": 100, ""sharesA"": 0, ""secs_since_round_starts"": 60, ""market"": ""A""}",150.0,12.0,1.0,in3zb9k3,t7od4xlw,FULL STUDY,165.0,s3,1,100,,1,,1,,0,sell,0.5344269279803172,17,0,0,block 2 (G first),21.0,12.0,Female,1.0,1.0,1.0,"[5, 'block 2 (G first)']",0,0,0,0.5,7.0,-0.30000000000000004,0.8333333333333334,0.0,0.0,0.0,4,0.5,0.5,Design 1,Design 1,"Have an option between Design #1 and Design #2,",3.0,4.0,4.0
1593,5182,5,Player object (2051),buy,2023-03-10 12:54:33.470868+00:00,"{""priceA"": 85, ""sharesA"": 1, ""secs_since_round_starts"": 64, ""market"": ""A""}",65.0,13.0,2.0,in3zb9k3,t7od4xlw,FULL STUDY,165.0,s3,1,85,100.0,-1,,1,sell,0,sell,0.4890232705715233,17,0,0,block 2 (G first),21.0,12.0,Female,1.0,1.0,1.0,"[5, 'block 2 (G first)']",0,0,0,0.5,7.0,-0.30000000000000004,0.8333333333333334,0.0,0.0,0.0,4,0.5,0.5,Design 1,Design 1,"Have an option between Design #1 and Design #2,",3.0,4.0,4.0
1594,5184,5,Player object (2051),sell,2023-03-10 12:54:43.757756+00:00,"{""priceA"": 90, ""sharesA"": 0, ""secs_since_round_starts"": 74, ""market"": ""A""}",155.0,15.0,3.0,in3zb9k3,t7od4xlw,FULL STUDY,165.0,s3,1,90,85.0,1,5.0,1,buy,0,sell,0.505231414156075,17,0,0,block 2 (G first),21.0,12.0,Female,1.0,1.0,1.0,"[5, 'block 2 (G first)']",0,0,0,0.5,7.0,-0.30000000000000004,0.8333333333333334,0.0,0.0,0.0,4,0.5,0.5,Design 1,Design 1,"Have an option between Design #1 and Design #2,",3.0,4.0,4.0
1595,5185,5,Player object (2051),buy,2023-03-10 12:54:49.587893+00:00,"{""priceA"": 85, ""sharesA"": 1, ""secs_since_round_starts"": 80, ""market"": ""A""}",70.0,16.0,4.0,in3zb9k3,t7od4xlw,FULL STUDY,165.0,s3,1,85,90.0,-1,,1,sell,0,sell,0.4686291671454359,17,0,0,block 2 (G first),21.0,12.0,Female,1.0,1.0,1.0,"[5, 'block 2 (G first)']",0,0,0,0.5,7.0,-0.30000000000000004,0.8333333333333334,0.0,0.0,0.0,4,0.5,0.5,Design 1,Design 1,"Have an option between Design #1 and Design #2,",3.0,4.0,4.0
1596,5186,5,Player object (2051),sell,2023-03-10 12:55:10.983697+00:00,"{""priceA"": 95, ""sharesA"": 0, ""secs_since_round_starts"": 102, ""market"": ""A""}",165.0,20.0,5.0,in3zb9k3,t7od4xlw,FULL STUDY,165.0,s3,1,95,85.0,1,10.0,1,buy,0,sell,0.5232479875730728,17,0,0,block 2 (G first),21.0,12.0,Female,1.0,1.0,1.0,"[5, 'block 2 (G first)']",0,0,0,0.5,7.0,-0.30000000000000004,0.8333333333333334,0.0,0.0,0.0,4,0.5,0.5,Design 1,Design 1,"Have an option between Design #1 and Design #2,",3.0,4.0,4.0
1597,5188,5,Player object (2051),buy,2023-03-10 12:55:22.165880+00:00,"{""priceA"": 90, ""sharesA"": 1, ""secs_since_round_starts"": 113, ""market"": ""A""}",75.0,22.0,6.0,in3zb9k3,t7od4xlw,FULL STUDY,165.0,s3,1,90,95.0,-1,,1,sell,0,sell,0.5007328859118227,17,0,0,block 2 (G first),21.0,12.0,Female,1.0,1.0,1.0,"[5, 'block 2 (G first)']",0,0,0,0.5,7.0,-0.30000000000000004,0.8333333333333334,0.0,0.0,0.0,4,0.5,0.5,Design 1,Design 1,"Have an option between Design #1 and Design #2,",3.0,4.0,4.0
1598,5189,5,Player object (2051),sell,2023-03-10 12:55:27.205844+00:00,"{""priceA"": 95, ""sharesA"": 0, ""secs_since_round_starts"": 118, ""market"": ""A""}",170.0,23.0,7.0,in3zb9k3,t7od4xlw,FULL STUDY,165.0,s3,1,95,90.0,1,5.0,1,buy,0,sell,0.5355078155027276,17,0,0,block 2 (G first),21.0,12.0,Female,1.0,1.0,1.0,"[5, 'block 2 (G first)']",0,0,0,0.5,7.0,-0.30000000000000004,0.8333333333333334,0.0,0.0,0.0,4,0.5,0.5,Design 1,Design 1,"Have an option between Design #1 and Design #2,",3.0,4.0,4.0
1599,5190,5,Player object (2051),buy,2023-03-10 12:55:54.718197+00:00,"{""priceA"": 85, ""sharesA"": 1, ""secs_since_round_starts"": 145, ""market"": ""A""}",85.0,28.0,8.0,in3zb9k3,t7od4xlw,FULL STUDY,165.0,s3,1,85,95.0,-1,,1,sell,0,sell,0.4496194529460131,17,1,0,block 2 (G first),21.0,12.0,Female,1.0,1.0,1.0,"[5, 'block 2 (G first)']",0,0,0,0.5,7.0,-0.30000000000000004,0.8333333333333334,0.0,0.0,0.0,4,0.5,0.5,Design 1,Design 1,"Have an option between Design #1 and Design #2,",3.0,4.0,4.0
1600,5193,5,Player object (2051),sell,2023-03-10 12:56:18.081552+00:00,"{""priceA"": 95, ""sharesA"": 0, ""secs_since_round_starts"": 169, ""market"": ""A""}",180.0,32.0,9.0,in3zb9k3,t7od4xlw,FULL STUDY,165.0,s3,1,95,85.0,1,10.0,1,buy,0,sell,0.5188715333997952,17,0,0,block 2 (G first),21.0,12.0,Female,1.0,1.0,1.0,"[5, 'block 2 (G first)']",0,0,0,0.5,7.0,-0.30000000000000004,0.8333333333333334,0.0,0.0,0.0,4,0.5,0.5,Design 1,Design 1,"Have an option between Design #1 and Design #2,",3.0,4.0,4.0
1601,5194,5,Player object (2051),buy,2023-03-10 12:56:43.838041+00:00,"{""priceA"": 95, ""sharesA"": 1, ""secs_since_round_starts"": 195, ""market"": ""A""}",85.0,37.0,10.0,in3zb9k3,t7od4xlw,FULL STUDY,165.0,s3,1,95,95.0,-1,,1,sell,0,sell,0.4805886028013266,17,0,0,block 2 (G first),21.0,12.0,Female,1.0,1.0,1.0,"[5, 'block 2 (G first)']",0,0,0,0.5,7.0,-0.30000000000000004,0.8333333333333334,0.0,0.0,0.0,4,0.5,0.5,Design 1,Design 1,"Have an option between Design #1 and Design #2,",3.0,4.0,4.0
1602,5196,5,Player object (2051),sell,2023-03-10 12:57:17.035988+00:00,"{""priceA"": 110, ""sharesA"": 0, ""secs_since_round_starts"": 228, ""market"": ""A""}",195.0,43.0,11.0,in3zb9k3,t7od4xlw,FULL STUDY,165.0,s3,1,110,95.0,1,15.0,1,buy,0,sell,0.571300234525265,17,0,0,block 2 (G first),21.0,12.0,Female,1.0,1.0,1.0,"[5, 'block 2 (G first)']",0,0,0,0.5,7.0,-0.30000000000000004,0.8333333333333334,0.0,0.0,0.0,4,0.5,0.5,Design 1,Design 1,"Have an option between Design #1 and Design #2,",3.0,4.0,4.0
1603,5198,5,Player object (2051),buy,2023-03-10 12:57:33.923028+00:00,"{""priceA"": 95, ""sharesA"": 1, ""secs_since_round_starts"": 245, ""market"": ""A""}",100.0,46.0,12.0,in3zb9k3,t7od4xlw,FULL STUDY,165.0,s3,1,95,110.0,-1,,1,sell,0,sell,0.4967862103563366,17,0,0,block 2 (G first),21.0,12.0,Female,1.0,1.0,1.0,"[5, 'block 2 (G first)']",0,0,0,0.5,7.0,-0.30000000000000004,0.8333333333333334,0.0,0.0,0.0,4,0.5,0.5,Design 1,Design 1,"Have an option between Design #1 and Design #2,",3.0,4.0,4.0
1604,2798,2,Player object (918),sell,2023-03-08 23:23:21.711064+00:00,"{""priceA"": 110, ""sharesA"": 0, ""secs_since_round_starts"": 78, ""market"": ""A""}",160.0,6.0,1.0,iwam94ip,vmu7c279,FULL STUDY,280.0,s4,1,110,,1,,1,,0,sell,0.5,0,0,0,block 1 (G first),20.0,10.0,Female,0.0,0.0,0.0,"[2, 'block 1 (G first)']",1,0,0,0.5,2.0,-0.6333333333333333,0.375,0.09090909090909091,0.6,0.3333333333333333,4,0.75,0.5,Design 1,Design 1,"Have an option between Design #1 and Design #2,",5.0,,
1605,2801,2,Player object (918),buy,2023-03-08 23:23:29.125471+00:00,"{""priceA"": 100, ""sharesA"": 1, ""secs_since_round_starts"": 85, ""market"": ""A""}",60.0,7.0,2.0,iwam94ip,vmu7c279,FULL STUDY,280.0,s4,1,100,100.0,-1,,3,sell,0,sell,0.5,0,0,0,block 1 (G first),20.0,10.0,Female,0.0,0.0,0.0,"[2, 'block 1 (G first)']",1,0,0,0.5,2.0,-0.6333333333333333,0.375,0.09090909090909091,0.6,0.3333333333333333,4,0.75,0.5,Design 1,Design 1,"Have an option between Design #1 and Design #2,",5.0,,
1606,2804,2,Player object (918),sell,2023-03-08 23:23:34.260487+00:00,"{""priceA"": 105, ""sharesA"": 0, ""secs_since_round_starts"": 90, ""market"": ""A""}",165.0,8.0,3.0,iwam94ip,vmu7c279,FULL STUDY,280.0,s4,1,105,105.0,1,0.0,3,buy,0,sell,0.5,0,0,0,block 1 (G first),20.0,10.0,Female,0.0,0.0,0.0,"[2, 'block 1 (G first)']",1,0,0,0.5,2.0,-0.6333333333333333,0.375,0.09090909090909091,0.6,0.3333333333333333,4,0.75,0.5,Design 1,Design 1,"Have an option between Design #1 and Design #2,",5.0,,
1607,2809,2,Player object (918),buy,2023-03-08 23:23:45.146276+00:00,"{""priceA"": 75, ""sharesA"": 1, ""secs_since_round_starts"": 101, ""market"": ""A""}",90.0,10.0,5.0,iwam94ip,vmu7c279,FULL STUDY,280.0,s4,1,75,75.0,-1,,3,sell,0,sell,0.5,0,0,0,block 1 (G first),20.0,10.0,Female,0.0,0.0,0.0,"[2, 'block 1 (G first)']",1,0,0,0.5,2.0,-0.6333333333333333,0.375,0.09090909090909091,0.6,0.3333333333333333,4,0.75,0.5,Design 1,Design 1,"Have an option between Design #1 and Design #2,",5.0,,
1608,2812,2,Player object (918),sell,2023-03-08 23:23:55.020879+00:00,"{""priceA"": 100, ""sharesA"": 0, ""secs_since_round_starts"": 111, ""market"": ""A""}",190.0,12.0,7.0,iwam94ip,vmu7c279,FULL STUDY,280.0,s4,1,100,85.0,1,15.0,1,buy,0,sell,0.5,0,0,0,block 1 (G first),20.0,10.0,Female,0.0,0.0,0.0,"[2, 'block 1 (G first)']",1,0,0,0.5,2.0,-0.6333333333333333,0.375,0.09090909090909091,0.6,0.3333333333333333,4,0.75,0.5,Design 1,Design 1,"Have an option between Design #1 and Design #2,",5.0,,
1609,2815,2,Player object (918),buy,2023-03-08 23:24:01.988178+00:00,"{""priceA"": 85, ""sharesA"": 1, ""secs_since_round_starts"": 118, ""market"": ""A""}",105.0,13.0,8.0,iwam94ip,vmu7c279,FULL STUDY,280.0,s4,1,85,85.0,-1,,3,sell,0,sell,0.5,0,0,0,block 1 (G first),20.0,10.0,Female,0.0,0.0,0.0,"[2, 'block 1 (G first)']",1,0,0,0.5,2.0,-0.6333333333333333,0.375,0.09090909090909091,0.6,0.3333333333333333,4,0.75,0.5,Design 1,Design 1,"Have an option between Design #1 and Design #2,",5.0,,
1610,2826,2,Player object (918),sell,2023-03-08 23:24:40.573908+00:00,"{""priceA"": 85, ""sharesA"": 0, ""secs_since_round_starts"": 156, ""market"": ""A""}",190.0,20.0,13.0,iwam94ip,vmu7c279,FULL STUDY,280.0,s4,1,85,60.0,1,25.0,1,buy,0,sell,0.5,0,0,0,block 1 (G first),20.0,10.0,Female,0.0,0.0,0.0,"[2, 'block 1 (G first)']",1,0,0,0.5,2.0,-0.6333333333333333,0.375,0.09090909090909091,0.6,0.3333333333333333,4,0.75,0.5,Design 1,Design 1,"Have an option between Design #1 and Design #2,",5.0,,
1611,2827,2,Player object (918),buy,2023-03-08 23:24:44.220331+00:00,"{""priceA"": 70, ""sharesA"": 1, ""secs_since_round_starts"": 160, ""market"": ""A""}",120.0,21.0,14.0,iwam94ip,vmu7c279,FULL STUDY,280.0,s4,1,70,85.0,-1,,1,sell,0,sell,0.5,0,0,0,block 1 (G first),20.0,10.0,Female,0.0,0.0,0.0,"[2, 'block 1 (G first)']",1,0,0,0.5,2.0,-0.6333333333333333,0.375,0.09090909090909091,0.6,0.3333333333333333,4,0.75,0.5,Design 1,Design 1,"Have an option between Design #1 and Design #2,",5.0,,
1612,2828,2,Player object (918),sell,2023-03-08 23:25:00.810292+00:00,"{""priceA"": 85, ""sharesA"": 0, ""secs_since_round_starts"": 177, ""market"": ""A""}",205.0,24.0,15.0,iwam94ip,vmu7c279,FULL STUDY,280.0,s4,1,85,70.0,1,15.0,1,buy,0,sell,0.5,0,0,0,block 1 (G first),20.0,10.0,Female,0.0,0.0,0.0,"[2, 'block 1 (G first)']",1,0,0,0.5,2.0,-0.6333333333333333,0.375,0.09090909090909091,0.6,0.3333333333333333,4,0.75,0.5,Design 1,Design 1,"Have an option between Design #1 and Design #2,",5.0,,
1613,2829,2,Player object (918),buy,2023-03-08 23:25:04.990708+00:00,"{""priceA"": 70, ""sharesA"": 1, ""secs_since_round_starts"": 181, ""market"": ""A""}",135.0,25.0,16.0,iwam94ip,vmu7c279,FULL STUDY,280.0,s4,1,70,85.0,-1,,1,sell,0,sell,0.5,0,0,0,block 1 (G first),20.0,10.0,Female,0.0,0.0,0.0,"[2, 'block 1 (G first)']",1,0,0,0.5,2.0,-0.6333333333333333,0.375,0.09090909090909091,0.6,0.3333333333333333,4,0.75,0.5,Design 1,Design 1,"Have an option between Design #1 and Design #2,",5.0,,
1614,2831,2,Player object (918),sell,2023-03-08 23:26:00.057203+00:00,"{""priceA"": 90, ""sharesA"": 0, ""secs_since_round_starts"": 236, ""market"": ""A""}",225.0,33.0,17.0,iwam94ip,vmu7c279,FULL STUDY,280.0,s4,1,90,70.0,1,20.0,1,buy,0,sell,0.5,0,0,0,block 1 (G first),20.0,10.0,Female,0.0,0.0,0.0,"[2, 'block 1 (G first)']",1,0,0,0.5,2.0,-0.6333333333333333,0.375,0.09090909090909091,0.6,0.3333333333333333,4,0.75,0.5,Design 1,Design 1,"Have an option between Design #1 and Design #2,",5.0,,
1615,2832,2,Player object (918),buy,2023-03-08 23:26:06.018639+00:00,"{""priceA"": 75, ""sharesA"": 1, ""secs_since_round_starts"": 242, ""market"": ""A""}",150.0,34.0,18.0,iwam94ip,vmu7c279,FULL STUDY,280.0,s4,1,75,90.0,-1,,1,sell,0,sell,0.5,0,1,0,block 1 (G first),20.0,10.0,Female,0.0,0.0,0.0,"[2, 'block 1 (G first)']",1,0,0,0.5,2.0,-0.6333333333333333,0.375,0.09090909090909091,0.6,0.3333333333333333,4,0.75,0.5,Design 1,Design 1,"Have an option between Design #1 and Design #2,",5.0,,
1616,2833,2,Player object (918),sell,2023-03-08 23:26:29.671489+00:00,"{""priceA"": 45, ""sharesA"": 0, ""secs_since_round_starts"": 266, ""market"": ""A""}",195.0,38.0,19.0,iwam94ip,vmu7c279,FULL STUDY,280.0,s4,1,45,75.0,1,-30.0,1,buy,0,sell,0.5,0,1,0,block 1 (G first),20.0,10.0,Female,0.0,0.0,0.0,"[2, 'block 1 (G first)']",1,0,0,0.5,2.0,-0.6333333333333333,0.375,0.09090909090909091,0.6,0.3333333333333333,4,0.75,0.5,Design 1,Design 1,"Have an option between Design #1 and Design #2,",5.0,,
1617,2834,2,Player object (918),buy,2023-03-08 23:26:32.613400+00:00,"{""priceA"": 35, ""sharesA"": 1, ""secs_since_round_starts"": 269, ""market"": ""A""}",160.0,39.0,20.0,iwam94ip,vmu7c279,FULL STUDY,280.0,s4,1,35,45.0,-1,,1,sell,0,sell,0.5,0,0,0,block 1 (G first),20.0,10.0,Female,0.0,0.0,0.0,"[2, 'block 1 (G first)']",1,0,0,0.5,2.0,-0.6333333333333333,0.375,0.09090909090909091,0.6,0.3333333333333333,4,0.75,0.5,Design 1,Design 1,"Have an option between Design #1 and Design #2,",5.0,,
1618,2835,2,Player object (918),sell,2023-03-08 23:26:54.387374+00:00,"{""priceA"": 60, ""sharesA"": 0, ""secs_since_round_starts"": 290, ""market"": ""A""}",220.0,43.0,21.0,iwam94ip,vmu7c279,FULL STUDY,280.0,s4,1,60,35.0,1,25.0,1,buy,0,sell,0.5,0,0,0,block 1 (G first),20.0,10.0,Female,0.0,0.0,0.0,"[2, 'block 1 (G first)']",1,0,0,0.5,2.0,-0.6333333333333333,0.375,0.09090909090909091,0.6,0.3333333333333333,4,0.75,0.5,Design 1,Design 1,"Have an option between Design #1 and Design #2,",5.0,,
1619,2836,2,Player object (918),buy,2023-03-08 23:27:05.581801+00:00,"{""priceA"": 50, ""sharesA"": 1, ""secs_since_round_starts"": 301, ""market"": ""A""}",170.0,45.0,22.0,iwam94ip,vmu7c279,FULL STUDY,280.0,s4,1,50,60.0,-1,,1,sell,0,sell,0.5,0,0,0,block 1 (G first),20.0,10.0,Female,0.0,0.0,0.0,"[2, 'block 1 (G first)']",1,0,0,0.5,2.0,-0.6333333333333333,0.375,0.09090909090909091,0.6,0.3333333333333333,4,0.75,0.5,Design 1,Design 1,"Have an option between Design #1 and Design #2,",5.0,,
1620,2837,2,Player object (918),sell,2023-03-08 23:27:29.870480+00:00,"{""priceA"": 65, ""sharesA"": 0, ""secs_since_round_starts"": 326, ""market"": ""A""}",235.0,49.0,23.0,iwam94ip,vmu7c279,FULL STUDY,280.0,s4,1,65,50.0,1,15.0,1,buy,0,sell,0.5,0,0,1,block 1 (G first),20.0,10.0,Female,0.0,0.0,0.0,"[2, 'block 1 (G first)']",1,0,0,0.5,2.0,-0.6333333333333333,0.375,0.09090909090909091,0.6,0.3333333333333333,4,0.75,0.5,Design 1,Design 1,"Have an option between Design #1 and Design #2,",5.0,,
1621,2838,2,Player object (918),buy,2023-03-08 23:27:40.264996+00:00,"{""priceA"": 75, ""sharesA"": 1, ""secs_since_round_starts"": 336, ""market"": ""A""}",160.0,51.0,24.0,iwam94ip,vmu7c279,FULL STUDY,280.0,s4,1,75,65.0,-1,,1,sell,0,sell,0.5,0,0,0,block 1 (G first),20.0,10.0,Female,0.0,0.0,0.0,"[2, 'block 1 (G first)']",1,0,0,0.5,2.0,-0.6333333333333333,0.375,0.09090909090909091,0.6,0.3333333333333333,4,0.75,0.5,Design 1,Design 1,"Have an option between Design #1 and Design #2,",5.0,,
1622,2839,2,Player object (918),sell,2023-03-08 23:27:50.494799+00:00,"{""priceA"": 105, ""sharesA"": 0, ""secs_since_round_starts"": 346, ""market"": ""A""}",265.0,53.0,25.0,iwam94ip,vmu7c279,FULL STUDY,280.0,s4,1,105,75.0,1,30.0,1,buy,0,sell,0.5,0,0,1,block 1 (G first),20.0,10.0,Female,0.0,0.0,0.0,"[2, 'block 1 (G first)']",1,0,0,0.5,2.0,-0.6333333333333333,0.375,0.09090909090909091,0.6,0.3333333333333333,4,0.75,0.5,Design 1,Design 1,"Have an option between Design #1 and Design #2,",5.0,,
1623,2840,2,Player object (918),buy,2023-03-08 23:28:11.345421+00:00,"{""priceA"": 95, ""sharesA"": 1, ""secs_since_round_starts"": 367, ""market"": ""A""}",170.0,57.0,26.0,iwam94ip,vmu7c279,FULL STUDY,280.0,s4,1,95,105.0,-1,,1,sell,0,sell,0.5,0,0,0,block 1 (G first),20.0,10.0,Female,0.0,0.0,0.0,"[2, 'block 1 (G first)']",1,0,0,0.5,2.0,-0.6333333333333333,0.375,0.09090909090909091,0.6,0.3333333333333333,4,0.75,0.5,Design 1,Design 1,"Have an option between Design #1 and Design #2,",5.0,,
1624,2841,2,Player object (918),sell,2023-03-08 23:28:18.225559+00:00,"{""priceA"": 110, ""sharesA"": 0, ""secs_since_round_starts"": 374, ""market"": ""A""}",280.0,58.0,27.0,iwam94ip,vmu7c279,FULL STUDY,280.0,s4,1,110,95.0,1,15.0,1,buy,0,sell,0.5,0,0,1,block 1 (G first),20.0,10.0,Female,0.0,0.0,0.0,"[2, 'block 1 (G first)']",1,0,0,0.5,2.0,-0.6333333333333333,0.375,0.09090909090909091,0.6,0.3333333333333333,4,0.75,0.5,Design 1,Design 1,"Have an option between Design #1 and Design #2,",5.0,,
1625,2845,3,Player object (1038),sell,2023-03-08 23:35:22.527654+00:00,"{""priceA"": 105, ""sharesA"": 0, ""secs_since_round_starts"": 53, ""market"": ""A""}",155.0,7.0,1.0,iwam94ip,vmu7c279,FULL STUDY,220.0,s4,1,105,,1,,1,,0,sell,0.5,0,0,0,block 1 (G first),20.0,10.0,Female,0.0,0.0,0.0,"[3, 'block 1 (G first)']",1,1,0,0.5,2.0,-0.6333333333333333,0.4166666666666667,0.0,0.0,0.0,4,0.75,0.5,Design 1,Design 1,"Have an option between Design #1 and Design #2,",5.0,,
1626,2846,3,Player object (1038),buy,2023-03-08 23:36:50.831548+00:00,"{""priceA"": 130, ""sharesA"": 1, ""secs_since_round_starts"": 141, ""market"": ""A""}",25.0,23.0,2.0,iwam94ip,vmu7c279,FULL STUDY,220.0,s4,1,130,105.0,-1,,1,sell,0,sell,0.5,0,0,0,block 1 (G first),20.0,10.0,Female,0.0,0.0,0.0,"[3, 'block 1 (G first)']",1,1,0,0.5,2.0,-0.6333333333333333,0.4166666666666667,0.0,0.0,0.0,4,0.75,0.5,Design 1,Design 1,"Have an option between Design #1 and Design #2,",5.0,,
1627,2847,3,Player object (1038),sell,2023-03-08 23:37:07.100053+00:00,"{""priceA"": 170, ""sharesA"": 0, ""secs_since_round_starts"": 158, ""market"": ""A""}",195.0,26.0,3.0,iwam94ip,vmu7c279,FULL STUDY,220.0,s4,1,170,130.0,1,40.0,1,buy,0,sell,0.5,0,0,0,block 1 (G first),20.0,10.0,Female,0.0,0.0,0.0,"[3, 'block 1 (G first)']",1,1,0,0.5,2.0,-0.6333333333333333,0.4166666666666667,0.0,0.0,0.0,4,0.75,0.5,Design 1,Design 1,"Have an option between Design #1 and Design #2,",5.0,,
1628,2848,3,Player object (1038),buy,2023-03-08 23:37:24.743275+00:00,"{""priceA"": 160, ""sharesA"": 1, ""secs_since_round_starts"": 175, ""market"": ""A""}",35.0,29.0,4.0,iwam94ip,vmu7c279,FULL STUDY,220.0,s4,1,160,170.0,-1,,1,sell,0,sell,0.5,0,0,0,block 1 (G first),20.0,10.0,Female,0.0,0.0,0.0,"[3, 'block 1 (G first)']",1,1,0,0.5,2.0,-0.6333333333333333,0.4166666666666667,0.0,0.0,0.0,4,0.75,0.5,Design 1,Design 1,"Have an option between Design #1 and Design #2,",5.0,,
1629,2850,3,Player object (1038),sell,2023-03-08 23:39:20.956374+00:00,"{""priceA"": 165, ""sharesA"": 0, ""secs_since_round_starts"": 291, ""market"": ""A""}",200.0,49.0,5.0,iwam94ip,vmu7c279,FULL STUDY,220.0,s4,1,165,160.0,1,5.0,1,buy,0,sell,0.5,0,0,0,block 1 (G first),20.0,10.0,Female,0.0,0.0,0.0,"[3, 'block 1 (G first)']",1,1,0,0.5,2.0,-0.6333333333333333,0.4166666666666667,0.0,0.0,0.0,4,0.75,0.5,Design 1,Design 1,"Have an option between Design #1 and Design #2,",5.0,,
1630,2852,3,Player object (1038),buy,2023-03-08 23:39:33.064928+00:00,"{""priceA"": 185, ""sharesA"": 1, ""secs_since_round_starts"": 304, ""market"": ""A""}",15.0,51.0,6.0,iwam94ip,vmu7c279,FULL STUDY,220.0,s4,1,185,165.0,-1,,1,sell,0,sell,0.5,0,0,0,block 1 (G first),20.0,10.0,Female,0.0,0.0,0.0,"[3, 'block 1 (G first)']",1,1,0,0.5,2.0,-0.6333333333333333,0.4166666666666667,0.0,0.0,0.0,4,0.75,0.5,Design 1,Design 1,"Have an option between Design #1 and Design #2,",5.0,,
1631,2861,3,Player object (1038),sell,2023-03-08 23:39:48.782114+00:00,"{""priceA"": 200, ""sharesA"": 0, ""secs_since_round_starts"": 319, ""market"": ""A""}",215.0,54.0,8.0,iwam94ip,vmu7c279,FULL STUDY,220.0,s4,1,200,210.0,1,-10.0,1,buy,0,sell,0.5,0,0,0,block 1 (G first),20.0,10.0,Female,0.0,0.0,0.0,"[3, 'block 1 (G first)']",1,1,0,0.5,2.0,-0.6333333333333333,0.4166666666666667,0.0,0.0,0.0,4,0.75,0.5,Design 1,Design 1,"Have an option between Design #1 and Design #2,",5.0,,
1632,2864,3,Player object (1038),buy,2023-03-08 23:39:59.982752+00:00,"{""priceA"": 175, ""sharesA"": 1, ""secs_since_round_starts"": 330, ""market"": ""A""}",40.0,56.0,9.0,iwam94ip,vmu7c279,FULL STUDY,220.0,s4,1,175,200.0,-1,,1,sell,0,sell,0.5,0,1,0,block 1 (G first),20.0,10.0,Female,0.0,0.0,0.0,"[3, 'block 1 (G first)']",1,1,0,0.5,2.0,-0.6333333333333333,0.4166666666666667,0.0,0.0,0.0,4,0.75,0.5,Design 1,Design 1,"Have an option between Design #1 and Design #2,",5.0,,
1633,2867,3,Player object (1038),sell,2023-03-08 23:40:21.359130+00:00,"{""priceA"": 180, ""sharesA"": 0, ""secs_since_round_starts"": 352, ""market"": ""A""}",220.0,60.0,10.0,iwam94ip,vmu7c279,FULL STUDY,220.0,s4,1,180,175.0,1,5.0,1,buy,0,sell,0.5,0,0,0,block 1 (G first),20.0,10.0,Female,0.0,0.0,0.0,"[3, 'block 1 (G first)']",1,1,0,0.5,2.0,-0.6333333333333333,0.4166666666666667,0.0,0.0,0.0,4,0.75,0.5,Design 1,Design 1,"Have an option between Design #1 and Design #2,",5.0,,
1634,2894,4,Player object (1158),sell,2023-03-08 23:47:22.016866+00:00,"{""priceA"": 140, ""sharesA"": 0, ""secs_since_round_starts"": 45, ""market"": ""A""}",190.0,7.0,1.0,iwam94ip,vmu7c279,FULL STUDY,155.0,s4,1,140,,1,,1,,0,sell,0.5,0,0,0,block 1 (G first),20.0,10.0,Female,0.0,0.0,0.0,"[4, 'block 1 (G first)']",0,0,0,0.5,2.0,-0.6333333333333333,0.3,0.038461538461538464,,0.0,2,0.75,0.25,Design 1,Design 1,"Have an option between Design #1 and Design #2,",5.0,,
1635,2895,4,Player object (1158),buy,2023-03-08 23:47:36.160156+00:00,"{""priceA"": 135, ""sharesA"": 1, ""secs_since_round_starts"": 59, ""market"": ""A""}",55.0,10.0,2.0,iwam94ip,vmu7c279,FULL STUDY,155.0,s4,1,135,140.0,-1,,1,sell,0,sell,0.5,0,0,0,block 1 (G first),20.0,10.0,Female,0.0,0.0,0.0,"[4, 'block 1 (G first)']",0,0,0,0.5,2.0,-0.6333333333333333,0.3,0.038461538461538464,,0.0,2,0.75,0.25,Design 1,Design 1,"Have an option between Design #1 and Design #2,",5.0,,
1636,2909,4,Player object (1158),sell,2023-03-08 23:50:02.692077+00:00,"{""priceA"": 75, ""sharesA"": 0, ""secs_since_round_starts"": 206, ""market"": ""A""}",130.0,34.0,4.0,iwam94ip,vmu7c279,FULL STUDY,155.0,s4,1,75,30.0,1,45.0,1,buy,0,sell,0.5,0,0,0,block 1 (G first),20.0,10.0,Female,0.0,0.0,0.0,"[4, 'block 1 (G first)']",0,0,0,0.5,2.0,-0.6333333333333333,0.3,0.038461538461538464,,0.0,2,0.75,0.25,Design 1,Design 1,"Have an option between Design #1 and Design #2,",5.0,,
1637,2910,4,Player object (1158),buy,2023-03-08 23:50:06.297408+00:00,"{""priceA"": 85, ""sharesA"": 1, ""secs_since_round_starts"": 210, ""market"": ""A""}",45.0,35.0,5.0,iwam94ip,vmu7c279,FULL STUDY,155.0,s4,1,85,75.0,-1,,1,sell,0,sell,0.5,0,0,1,block 1 (G first),20.0,10.0,Female,0.0,0.0,0.0,"[4, 'block 1 (G first)']",0,0,0,0.5,2.0,-0.6333333333333333,0.3,0.038461538461538464,,0.0,2,0.75,0.25,Design 1,Design 1,"Have an option between Design #1 and Design #2,",5.0,,
1638,2914,4,Player object (1158),sell,2023-03-08 23:50:54.967691+00:00,"{""priceA"": 100, ""sharesA"": 0, ""secs_since_round_starts"": 258, ""market"": ""A""}",145.0,44.0,6.0,iwam94ip,vmu7c279,FULL STUDY,155.0,s4,1,100,85.0,1,15.0,1,buy,0,sell,0.5,0,0,0,block 1 (G first),20.0,10.0,Female,0.0,0.0,0.0,"[4, 'block 1 (G first)']",0,0,0,0.5,2.0,-0.6333333333333333,0.3,0.038461538461538464,,0.0,2,0.75,0.25,Design 1,Design 1,"Have an option between Design #1 and Design #2,",5.0,,
1639,2917,4,Player object (1158),buy,2023-03-08 23:51:00.490288+00:00,"{""priceA"": 110, ""sharesA"": 1, ""secs_since_round_starts"": 264, ""market"": ""A""}",35.0,45.0,7.0,iwam94ip,vmu7c279,FULL STUDY,155.0,s4,1,110,100.0,-1,,1,sell,0,sell,0.5,0,0,0,block 1 (G first),20.0,10.0,Female,0.0,0.0,0.0,"[4, 'block 1 (G first)']",0,0,0,0.5,2.0,-0.6333333333333333,0.3,0.038461538461538464,,0.0,2,0.75,0.25,Design 1,Design 1,"Have an option between Design #1 and Design #2,",5.0,,
1640,2919,4,Player object (1158),sell,2023-03-08 23:51:18.147428+00:00,"{""priceA"": 120, ""sharesA"": 0, ""secs_since_round_starts"": 281, ""market"": ""A""}",155.0,48.0,8.0,iwam94ip,vmu7c279,FULL STUDY,155.0,s4,1,120,110.0,1,10.0,1,buy,0,sell,0.5,0,0,0,block 1 (G first),20.0,10.0,Female,0.0,0.0,0.0,"[4, 'block 1 (G first)']",0,0,0,0.5,2.0,-0.6333333333333333,0.3,0.038461538461538464,,0.0,2,0.75,0.25,Design 1,Design 1,"Have an option between Design #1 and Design #2,",5.0,,
1641,2930,5,Player object (1278),sell,2023-03-08 23:53:28.559520+00:00,"{""priceA"": 125, ""sharesA"": 0, ""secs_since_round_starts"": 57, ""market"": ""A""}",175.0,7.0,1.0,iwam94ip,vmu7c279,FULL STUDY,170.0,s4,1,125,,1,,1,,0,sell,0.5,0,0,0,block 1 (G first),20.0,10.0,Female,0.0,0.0,0.0,"[5, 'block 1 (G first)']",0,1,0,0.5,2.0,-0.6333333333333333,0.3,0.0,0.0,0.0,4,0.75,0.25,Design 1,Design 1,"Have an option between Design #1 and Design #2,",5.0,,
1642,2943,5,Player object (1278),buy,2023-03-08 23:54:08.175136+00:00,"{""priceA"": 140, ""sharesA"": 1, ""secs_since_round_starts"": 96, ""market"": ""A""}",35.0,14.0,2.0,iwam94ip,vmu7c279,FULL STUDY,170.0,s4,1,140,125.0,-1,,1,sell,0,sell,0.5,0,0,0,block 1 (G first),20.0,10.0,Female,0.0,0.0,0.0,"[5, 'block 1 (G first)']",0,1,0,0.5,2.0,-0.6333333333333333,0.3,0.0,0.0,0.0,4,0.75,0.25,Design 1,Design 1,"Have an option between Design #1 and Design #2,",5.0,,
1643,2945,5,Player object (1278),sell,2023-03-08 23:54:59.123236+00:00,"{""priceA"": 150, ""sharesA"": 0, ""secs_since_round_starts"": 147, ""market"": ""A""}",185.0,23.0,3.0,iwam94ip,vmu7c279,FULL STUDY,170.0,s4,1,150,140.0,1,10.0,1,buy,0,sell,0.5,0,0,0,block 1 (G first),20.0,10.0,Female,0.0,0.0,0.0,"[5, 'block 1 (G first)']",0,1,0,0.5,2.0,-0.6333333333333333,0.3,0.0,0.0,0.0,4,0.75,0.25,Design 1,Design 1,"Have an option between Design #1 and Design #2,",5.0,,
1644,2948,5,Player object (1278),buy,2023-03-08 23:55:35.280423+00:00,"{""priceA"": 125, ""sharesA"": 1, ""secs_since_round_starts"": 183, ""market"": ""A""}",60.0,30.0,4.0,iwam94ip,vmu7c279,FULL STUDY,170.0,s4,1,125,150.0,-1,,1,sell,0,sell,0.5,0,1,0,block 1 (G first),20.0,10.0,Female,0.0,0.0,0.0,"[5, 'block 1 (G first)']",0,1,0,0.5,2.0,-0.6333333333333333,0.3,0.0,0.0,0.0,4,0.75,0.25,Design 1,Design 1,"Have an option between Design #1 and Design #2,",5.0,,
1645,2951,5,Player object (1278),sell,2023-03-08 23:56:04.607408+00:00,"{""priceA"": 140, ""sharesA"": 0, ""secs_since_round_starts"": 213, ""market"": ""A""}",200.0,34.0,5.0,iwam94ip,vmu7c279,FULL STUDY,170.0,s4,1,140,125.0,1,15.0,1,buy,0,sell,0.5,0,0,0,block 1 (G first),20.0,10.0,Female,0.0,0.0,0.0,"[5, 'block 1 (G first)']",0,1,0,0.5,2.0,-0.6333333333333333,0.3,0.0,0.0,0.0,4,0.75,0.25,Design 1,Design 1,"Have an option between Design #1 and Design #2,",5.0,,
1646,2954,5,Player object (1278),buy,2023-03-08 23:56:38.048545+00:00,"{""priceA"": 125, ""sharesA"": 1, ""secs_since_round_starts"": 246, ""market"": ""A""}",75.0,40.0,6.0,iwam94ip,vmu7c279,FULL STUDY,170.0,s4,1,125,140.0,-1,,1,sell,0,sell,0.5,0,0,0,block 1 (G first),20.0,10.0,Female,0.0,0.0,0.0,"[5, 'block 1 (G first)']",0,1,0,0.5,2.0,-0.6333333333333333,0.3,0.0,0.0,0.0,4,0.75,0.25,Design 1,Design 1,"Have an option between Design #1 and Design #2,",5.0,,
1647,2130,2,Player object (907),sell,2023-03-08 04:10:41.547165+00:00,"{""priceA"": 120, ""sharesA"": 0, ""secs_since_round_starts"": 152, ""market"": ""A""}",170.0,15.0,1.0,izacs7fd,vmu7c279,FULL STUDY,210.0,s1,1,120,,1,,1,,0,sell,0.5761373211134116,16,0,0,block 4 (G second),20.0,11.0,Female,1.0,0.0,0.0,"[2, 'block 4 (G second)']",0,1,1,0.5,3.0,-0.6166666666666667,0.4,0.0,0.0,0.0,2,0.5,0.75,Design 2,Design 2,"Have an option between Design #1 and Design #2,",,5.0,5.0
1648,2151,2,Player object (907),buy,2023-03-08 04:13:36.606577+00:00,"{""priceA"": 125, ""sharesA"": 1, ""secs_since_round_starts"": 327, ""market"": ""A""}",45.0,39.0,2.0,izacs7fd,vmu7c279,FULL STUDY,210.0,s1,1,125,120.0,-1,,1,sell,0,sell,0.4382592777609274,16,1,0,block 4 (G second),20.0,11.0,Female,1.0,0.0,0.0,"[2, 'block 4 (G second)']",0,1,1,0.5,3.0,-0.6166666666666667,0.4,0.0,0.0,0.0,2,0.5,0.75,Design 2,Design 2,"Have an option between Design #1 and Design #2,",,5.0,5.0
1649,2153,2,Player object (907),sell,2023-03-08 04:13:39.760708+00:00,"{""priceA"": 140, ""sharesA"": 0, ""secs_since_round_starts"": 330, ""market"": ""A""}",185.0,40.0,3.0,izacs7fd,vmu7c279,FULL STUDY,210.0,s1,1,140,125.0,1,15.0,1,buy,0,sell,0.4916787423410894,16,0,0,block 4 (G second),20.0,11.0,Female,1.0,0.0,0.0,"[2, 'block 4 (G second)']",0,1,1,0.5,3.0,-0.6166666666666667,0.4,0.0,0.0,0.0,2,0.5,0.75,Design 2,Design 2,"Have an option between Design #1 and Design #2,",,5.0,5.0
1650,2157,2,Player object (907),buy,2023-03-08 04:13:55.435587+00:00,"{""priceA"": 125, ""sharesA"": 1, ""secs_since_round_starts"": 346, ""market"": ""A""}",60.0,43.0,4.0,izacs7fd,vmu7c279,FULL STUDY,210.0,s1,1,125,140.0,-1,,1,sell,0,sell,0.4218732662739463,16,1,0,block 4 (G second),20.0,11.0,Female,1.0,0.0,0.0,"[2, 'block 4 (G second)']",0,1,1,0.5,3.0,-0.6166666666666667,0.4,0.0,0.0,0.0,2,0.5,0.75,Design 2,Design 2,"Have an option between Design #1 and Design #2,",,5.0,5.0
1651,2158,2,Player object (907),sell,2023-03-08 04:14:09.382709+00:00,"{""priceA"": 140, ""sharesA"": 0, ""secs_since_round_starts"": 360, ""market"": ""A""}",200.0,45.0,5.0,izacs7fd,vmu7c279,FULL STUDY,210.0,s1,1,140,125.0,1,15.0,1,buy,0,sell,0.5210834711709403,16,0,0,block 4 (G second),20.0,11.0,Female,1.0,0.0,0.0,"[2, 'block 4 (G second)']",0,1,1,0.5,3.0,-0.6166666666666667,0.4,0.0,0.0,0.0,2,0.5,0.75,Design 2,Design 2,"Have an option between Design #1 and Design #2,",,5.0,5.0
1652,2167,2,Player object (907),buy,2023-03-08 04:14:44.979614+00:00,"{""priceA"": 125, ""sharesA"": 1, ""secs_since_round_starts"": 396, ""market"": ""A""}",75.0,52.0,6.0,izacs7fd,vmu7c279,FULL STUDY,210.0,s1,1,125,140.0,-1,,1,sell,0,sell,0.4439176376077041,16,1,0,block 4 (G second),20.0,11.0,Female,1.0,0.0,0.0,"[2, 'block 4 (G second)']",0,1,1,0.5,3.0,-0.6166666666666667,0.4,0.0,0.0,0.0,2,0.5,0.75,Design 2,Design 2,"Have an option between Design #1 and Design #2,",,5.0,5.0
1653,2171,2,Player object (907),sell,2023-03-08 04:15:03.887402+00:00,"{""priceA"": 135, ""sharesA"": 0, ""secs_since_round_starts"": 415, ""market"": ""A""}",210.0,55.0,7.0,izacs7fd,vmu7c279,FULL STUDY,210.0,s1,1,135,125.0,1,10.0,1,buy,0,sell,0.4873282494519479,16,0,0,block 4 (G second),20.0,11.0,Female,1.0,0.0,0.0,"[2, 'block 4 (G second)']",0,1,1,0.5,3.0,-0.6166666666666667,0.4,0.0,0.0,0.0,2,0.5,0.75,Design 2,Design 2,"Have an option between Design #1 and Design #2,",,5.0,5.0
1654,2172,2,Player object (907),buy,2023-03-08 04:15:06.351004+00:00,"{""priceA"": 125, ""sharesA"": 1, ""secs_since_round_starts"": 417, ""market"": ""A""}",85.0,56.0,8.0,izacs7fd,vmu7c279,FULL STUDY,210.0,s1,1,125,135.0,-1,,1,sell,0,sell,0.4562406760637778,16,0,0,block 4 (G second),20.0,11.0,Female,1.0,0.0,0.0,"[2, 'block 4 (G second)']",0,1,1,0.5,3.0,-0.6166666666666667,0.4,0.0,0.0,0.0,2,0.5,0.75,Design 2,Design 2,"Have an option between Design #1 and Design #2,",,5.0,5.0
1655,2191,3,Player object (1027),sell,2023-03-08 04:16:39.429791+00:00,"{""priceA"": 110, ""sharesA"": 0, ""secs_since_round_starts"": 61, ""market"": ""A""}",160.0,11.0,1.0,izacs7fd,vmu7c279,FULL STUDY,220.0,s1,1,110,,1,,1,,0,sell,0.5295922419004607,19,0,0,block 4 (G second),20.0,11.0,Female,1.0,0.0,0.0,"[3, 'block 4 (G second)']",0,0,1,1.0,3.0,-0.6166666666666667,0.3076923076923077,0.0,1.0,0.0,4,1.0,0.75,Design 2,Design 2,"Have an option between Design #1 and Design #2,",,5.0,5.0
1656,2199,3,Player object (1027),buy,2023-03-08 04:17:12.273612+00:00,"{""priceA"": 105, ""sharesA"": 1, ""secs_since_round_starts"": 94, ""market"": ""A""}",55.0,17.0,2.0,izacs7fd,vmu7c279,FULL STUDY,220.0,s1,1,105,110.0,-1,,1,sell,0,sell,0.4990675303551922,19,0,0,block 4 (G second),20.0,11.0,Female,1.0,0.0,0.0,"[3, 'block 4 (G second)']",0,0,1,1.0,3.0,-0.6166666666666667,0.3076923076923077,0.0,1.0,0.0,4,1.0,0.75,Design 2,Design 2,"Have an option between Design #1 and Design #2,",,5.0,5.0
1657,2201,3,Player object (1027),sell,2023-03-08 04:17:26.213254+00:00,"{""priceA"": 120, ""sharesA"": 0, ""secs_since_round_starts"": 108, ""market"": ""A""}",175.0,19.0,3.0,izacs7fd,vmu7c279,FULL STUDY,220.0,s1,1,120,105.0,1,15.0,1,buy,0,sell,0.5586446427659006,19,0,1,block 4 (G second),20.0,11.0,Female,1.0,0.0,0.0,"[3, 'block 4 (G second)']",0,0,1,1.0,3.0,-0.6166666666666667,0.3076923076923077,0.0,1.0,0.0,4,1.0,0.75,Design 2,Design 2,"Have an option between Design #1 and Design #2,",,5.0,5.0
1658,2202,3,Player object (1027),buy,2023-03-08 04:17:39.464992+00:00,"{""priceA"": 85, ""sharesA"": 1, ""secs_since_round_starts"": 121, ""market"": ""A""}",90.0,22.0,4.0,izacs7fd,vmu7c279,FULL STUDY,220.0,s1,1,85,120.0,-1,,1,sell,0,sell,0.443819468959905,19,1,0,block 4 (G second),20.0,11.0,Female,1.0,0.0,0.0,"[3, 'block 4 (G second)']",0,0,1,1.0,3.0,-0.6166666666666667,0.3076923076923077,0.0,1.0,0.0,4,1.0,0.75,Design 2,Design 2,"Have an option between Design #1 and Design #2,",,5.0,5.0
1659,2206,3,Player object (1027),sell,2023-03-08 04:18:05.028300+00:00,"{""priceA"": 115, ""sharesA"": 0, ""secs_since_round_starts"": 146, ""market"": ""A""}",205.0,26.0,5.0,izacs7fd,vmu7c279,FULL STUDY,220.0,s1,1,115,85.0,1,30.0,1,buy,0,sell,0.526172546586359,19,0,0,block 4 (G second),20.0,11.0,Female,1.0,0.0,0.0,"[3, 'block 4 (G second)']",0,0,1,1.0,3.0,-0.6166666666666667,0.3076923076923077,0.0,1.0,0.0,4,1.0,0.75,Design 2,Design 2,"Have an option between Design #1 and Design #2,",,5.0,5.0
1660,2218,3,Player object (1027),buy,2023-03-08 04:19:02.841010+00:00,"{""priceA"": 95, ""sharesA"": 1, ""secs_since_round_starts"": 204, ""market"": ""A""}",110.0,37.0,6.0,izacs7fd,vmu7c279,FULL STUDY,220.0,s1,1,95,115.0,-1,,1,sell,0,sell,0.4240076400585448,19,1,0,block 4 (G second),20.0,11.0,Female,1.0,0.0,0.0,"[3, 'block 4 (G second)']",0,0,1,1.0,3.0,-0.6166666666666667,0.3076923076923077,0.0,1.0,0.0,4,1.0,0.75,Design 2,Design 2,"Have an option between Design #1 and Design #2,",,5.0,5.0
1661,2221,3,Player object (1027),sell,2023-03-08 04:19:36.452123+00:00,"{""priceA"": 120, ""sharesA"": 0, ""secs_since_round_starts"": 238, ""market"": ""A""}",230.0,43.0,7.0,izacs7fd,vmu7c279,FULL STUDY,220.0,s1,1,120,95.0,1,25.0,1,buy,0,sell,0.5357259670782416,19,0,0,block 4 (G second),20.0,11.0,Female,1.0,0.0,0.0,"[3, 'block 4 (G second)']",0,0,1,1.0,3.0,-0.6166666666666667,0.3076923076923077,0.0,1.0,0.0,4,1.0,0.75,Design 2,Design 2,"Have an option between Design #1 and Design #2,",,5.0,5.0
1662,2230,3,Player object (1027),buy,2023-03-08 04:21:03.227195+00:00,"{""priceA"": 125, ""sharesA"": 1, ""secs_since_round_starts"": 325, ""market"": ""A""}",105.0,59.0,8.0,izacs7fd,vmu7c279,FULL STUDY,220.0,s1,1,125,120.0,-1,,1,sell,0,sell,0.4946618842475483,19,0,0,block 4 (G second),20.0,11.0,Female,1.0,0.0,0.0,"[3, 'block 4 (G second)']",0,0,1,1.0,3.0,-0.6166666666666667,0.3076923076923077,0.0,1.0,0.0,4,1.0,0.75,Design 2,Design 2,"Have an option between Design #1 and Design #2,",,5.0,5.0
1663,2254,4,Player object (1147),sell,2023-03-08 04:24:31.567820+00:00,"{""priceA"": 85, ""sharesA"": 0, ""secs_since_round_starts"": 195, ""market"": ""A""}",135.0,30.0,1.0,izacs7fd,vmu7c279,FULL STUDY,155.0,s1,1,85,,1,,1,,0,sell,0.5151109892827086,14,0,0,block 4 (G second),20.0,11.0,Female,1.0,0.0,0.0,"[4, 'block 4 (G second)']",1,1,1,0.5,3.0,-0.6166666666666667,0.5,0.03125,,0.0,5,0.25,0.75,Design 2,Design 2,"Have an option between Design #1 and Design #2,",,5.0,5.0
1664,2256,4,Player object (1147),buy,2023-03-08 04:24:42.920142+00:00,"{""priceA"": 95, ""sharesA"": 1, ""secs_since_round_starts"": 207, ""market"": ""A""}",40.0,32.0,2.0,izacs7fd,vmu7c279,FULL STUDY,155.0,s1,1,95,85.0,-1,,1,sell,0,sell,0.5179404569050043,14,0,0,block 4 (G second),20.0,11.0,Female,1.0,0.0,0.0,"[4, 'block 4 (G second)']",1,1,1,0.5,3.0,-0.6166666666666667,0.5,0.03125,,0.0,5,0.25,0.75,Design 2,Design 2,"Have an option between Design #1 and Design #2,",,5.0,5.0
1665,2260,4,Player object (1147),sell,2023-03-08 04:24:59.709547+00:00,"{""priceA"": 100, ""sharesA"": 0, ""secs_since_round_starts"": 223, ""market"": ""A""}",140.0,35.0,3.0,izacs7fd,vmu7c279,FULL STUDY,155.0,s1,1,100,95.0,1,5.0,1,buy,0,sell,0.5337204628349665,14,0,0,block 4 (G second),20.0,11.0,Female,1.0,0.0,0.0,"[4, 'block 4 (G second)']",1,1,1,0.5,3.0,-0.6166666666666667,0.5,0.03125,,0.0,5,0.25,0.75,Design 2,Design 2,"Have an option between Design #1 and Design #2,",,5.0,5.0
1666,2268,4,Player object (1147),buy,2023-03-08 04:25:22.346421+00:00,"{""priceA"": 80, ""sharesA"": 1, ""secs_since_round_starts"": 246, ""market"": ""A""}",60.0,39.0,4.0,izacs7fd,vmu7c279,FULL STUDY,155.0,s1,1,80,100.0,-1,,1,sell,0,sell,0.4897180556691627,14,0,0,block 4 (G second),20.0,11.0,Female,1.0,0.0,0.0,"[4, 'block 4 (G second)']",1,1,1,0.5,3.0,-0.6166666666666667,0.5,0.03125,,0.0,5,0.25,0.75,Design 2,Design 2,"Have an option between Design #1 and Design #2,",,5.0,5.0
1667,2271,4,Player object (1147),sell,2023-03-08 04:25:37.565916+00:00,"{""priceA"": 95, ""sharesA"": 0, ""secs_since_round_starts"": 261, ""market"": ""A""}",155.0,42.0,5.0,izacs7fd,vmu7c279,FULL STUDY,155.0,s1,1,95,80.0,1,15.0,1,buy,0,sell,0.5388552795609507,14,0,0,block 4 (G second),20.0,11.0,Female,1.0,0.0,0.0,"[4, 'block 4 (G second)']",1,1,1,0.5,3.0,-0.6166666666666667,0.5,0.03125,,0.0,5,0.25,0.75,Design 2,Design 2,"Have an option between Design #1 and Design #2,",,5.0,5.0
1668,2274,4,Player object (1147),buy,2023-03-08 04:26:38.122762+00:00,"{""priceA"": 75, ""sharesA"": 1, ""secs_since_round_starts"": 322, ""market"": ""A""}",80.0,53.0,6.0,izacs7fd,vmu7c279,FULL STUDY,155.0,s1,1,75,95.0,-1,,1,sell,0,sell,0.4439854633835125,14,1,0,block 4 (G second),20.0,11.0,Female,1.0,0.0,0.0,"[4, 'block 4 (G second)']",1,1,1,0.5,3.0,-0.6166666666666667,0.5,0.03125,,0.0,5,0.25,0.75,Design 2,Design 2,"Have an option between Design #1 and Design #2,",,5.0,5.0
1669,2286,5,Player object (1267),sell,2023-03-08 04:28:08.625472+00:00,"{""priceA"": 100, ""sharesA"": 0, ""secs_since_round_starts"": 45, ""market"": ""A""}",150.0,7.0,1.0,izacs7fd,vmu7c279,FULL STUDY,250.0,s1,1,100,,1,,1,,0,sell,0.5733994727268583,17,0,0,block 4 (G second),20.0,11.0,Female,1.0,0.0,0.0,"[5, 'block 4 (G second)']",1,0,1,0.5,3.0,-0.6166666666666667,0.17391304347826086,0.0,0.0,0.0,5,0.25,1.0,Design 2,Design 2,"Have an option between Design #1 and Design #2,",,5.0,5.0
1670,2290,5,Player object (1267),buy,2023-03-08 04:28:26.980759+00:00,"{""priceA"": 85, ""sharesA"": 1, ""secs_since_round_starts"": 63, ""market"": ""A""}",65.0,11.0,2.0,izacs7fd,vmu7c279,FULL STUDY,250.0,s1,1,85,100.0,-1,,1,sell,0,sell,0.4991731929932316,17,0,0,block 4 (G second),20.0,11.0,Female,1.0,0.0,0.0,"[5, 'block 4 (G second)']",1,0,1,0.5,3.0,-0.6166666666666667,0.17391304347826086,0.0,0.0,0.0,5,0.25,1.0,Design 2,Design 2,"Have an option between Design #1 and Design #2,",,5.0,5.0
1671,2297,5,Player object (1267),sell,2023-03-08 04:29:38.582570+00:00,"{""priceA"": 105, ""sharesA"": 0, ""secs_since_round_starts"": 135, ""market"": ""A""}",170.0,24.0,3.0,izacs7fd,vmu7c279,FULL STUDY,250.0,s1,1,105,85.0,1,20.0,1,buy,0,sell,0.5594334008058068,17,0,0,block 4 (G second),20.0,11.0,Female,1.0,0.0,0.0,"[5, 'block 4 (G second)']",1,0,1,0.5,3.0,-0.6166666666666667,0.17391304347826086,0.0,0.0,0.0,5,0.25,1.0,Design 2,Design 2,"Have an option between Design #1 and Design #2,",,5.0,5.0
1672,2304,5,Player object (1267),buy,2023-03-08 04:30:06.264451+00:00,"{""priceA"": 80, ""sharesA"": 1, ""secs_since_round_starts"": 162, ""market"": ""A""}",90.0,29.0,4.0,izacs7fd,vmu7c279,FULL STUDY,250.0,s1,1,80,105.0,-1,,1,sell,0,sell,0.4304345659865384,17,0,0,block 4 (G second),20.0,11.0,Female,1.0,0.0,0.0,"[5, 'block 4 (G second)']",1,0,1,0.5,3.0,-0.6166666666666667,0.17391304347826086,0.0,0.0,0.0,5,0.25,1.0,Design 2,Design 2,"Have an option between Design #1 and Design #2,",,5.0,5.0
1673,2308,5,Player object (1267),sell,2023-03-08 04:30:33.670600+00:00,"{""priceA"": 120, ""sharesA"": 0, ""secs_since_round_starts"": 190, ""market"": ""A""}",210.0,34.0,5.0,izacs7fd,vmu7c279,FULL STUDY,250.0,s1,1,120,80.0,1,40.0,1,buy,0,sell,0.5679672812132522,17,0,0,block 4 (G second),20.0,11.0,Female,1.0,0.0,0.0,"[5, 'block 4 (G second)']",1,0,1,0.5,3.0,-0.6166666666666667,0.17391304347826086,0.0,0.0,0.0,5,0.25,1.0,Design 2,Design 2,"Have an option between Design #1 and Design #2,",,5.0,5.0
1674,2319,5,Player object (1267),buy,2023-03-08 04:30:59.653098+00:00,"{""priceA"": 70, ""sharesA"": 1, ""secs_since_round_starts"": 216, ""market"": ""A""}",140.0,39.0,6.0,izacs7fd,vmu7c279,FULL STUDY,250.0,s1,1,70,120.0,-1,,1,sell,0,sell,0.4317803147869401,17,0,0,block 4 (G second),20.0,11.0,Female,1.0,0.0,0.0,"[5, 'block 4 (G second)']",1,0,1,0.5,3.0,-0.6166666666666667,0.17391304347826086,0.0,0.0,0.0,5,0.25,1.0,Design 2,Design 2,"Have an option between Design #1 and Design #2,",,5.0,5.0
1675,2326,5,Player object (1267),sell,2023-03-08 04:31:27.396821+00:00,"{""priceA"": 105, ""sharesA"": 0, ""secs_since_round_starts"": 243, ""market"": ""A""}",245.0,44.0,7.0,izacs7fd,vmu7c279,FULL STUDY,250.0,s1,1,105,70.0,1,35.0,1,buy,0,sell,0.515125859635568,17,0,0,block 4 (G second),20.0,11.0,Female,1.0,0.0,0.0,"[5, 'block 4 (G second)']",1,0,1,0.5,3.0,-0.6166666666666667,0.17391304347826086,0.0,0.0,0.0,5,0.25,1.0,Design 2,Design 2,"Have an option between Design #1 and Design #2,",,5.0,5.0
1676,2328,5,Player object (1267),buy,2023-03-08 04:31:49.778693+00:00,"{""priceA"": 75, ""sharesA"": 1, ""secs_since_round_starts"": 266, ""market"": ""A""}",170.0,48.0,8.0,izacs7fd,vmu7c279,FULL STUDY,250.0,s1,1,75,105.0,-1,,1,sell,0,sell,0.4393932183506925,17,1,0,block 4 (G second),20.0,11.0,Female,1.0,0.0,0.0,"[5, 'block 4 (G second)']",1,0,1,0.5,3.0,-0.6166666666666667,0.17391304347826086,0.0,0.0,0.0,5,0.25,1.0,Design 2,Design 2,"Have an option between Design #1 and Design #2,",,5.0,5.0
1677,2331,5,Player object (1267),sell,2023-03-08 04:32:24.162036+00:00,"{""priceA"": 95, ""sharesA"": 0, ""secs_since_round_starts"": 300, ""market"": ""A""}",265.0,54.0,9.0,izacs7fd,vmu7c279,FULL STUDY,250.0,s1,1,95,75.0,1,20.0,1,buy,0,sell,0.5299980248683189,17,0,0,block 4 (G second),20.0,11.0,Female,1.0,0.0,0.0,"[5, 'block 4 (G second)']",1,0,1,0.5,3.0,-0.6166666666666667,0.17391304347826086,0.0,0.0,0.0,5,0.25,1.0,Design 2,Design 2,"Have an option between Design #1 and Design #2,",,5.0,5.0
1678,2332,5,Player object (1267),buy,2023-03-08 04:32:28.176007+00:00,"{""priceA"": 80, ""sharesA"": 1, ""secs_since_round_starts"": 304, ""market"": ""A""}",185.0,55.0,10.0,izacs7fd,vmu7c279,FULL STUDY,250.0,s1,1,80,95.0,-1,,1,sell,0,sell,0.4859141076178286,17,0,0,block 4 (G second),20.0,11.0,Female,1.0,0.0,0.0,"[5, 'block 4 (G second)']",1,0,1,0.5,3.0,-0.6166666666666667,0.17391304347826086,0.0,0.0,0.0,5,0.25,1.0,Design 2,Design 2,"Have an option between Design #1 and Design #2,",,5.0,5.0
1679,2125,2,Player object (905),sell,2023-03-08 04:10:03.809171+00:00,"{""priceA"": 145, ""sharesA"": 0, ""secs_since_round_starts"": 185, ""market"": ""A""}",195.0,25.0,2.0,j127swcg,vmu7c279,FULL STUDY,195.0,s3,1,145,70.0,1,75.0,1,,0,sell,0.5294358264188312,16,0,0,block 3 (G second),23.0,11.0,Female,1.0,0.0,1.0,"[2, 'block 3 (G second)']",0,0,1,1.0,4.0,-0.5166666666666666,0.10344827586206896,0.25,0.0,0.6666666666666666,5,0.75,0.25,Design 2,Design 2,"Have an option between Design #1 and Design #2,",4.0,4.0,5.0
1680,2126,2,Player object (905),buy,2023-03-08 04:10:08.814224+00:00,"{""priceA"": 140, ""sharesA"": 1, ""secs_since_round_starts"": 190, ""market"": ""A""}",55.0,26.0,3.0,j127swcg,vmu7c279,FULL STUDY,195.0,s3,1,140,145.0,-1,,1,sell,0,sell,0.4855198313469848,16,0,0,block 3 (G second),23.0,11.0,Female,1.0,0.0,1.0,"[2, 'block 3 (G second)']",0,0,1,1.0,4.0,-0.5166666666666666,0.10344827586206896,0.25,0.0,0.6666666666666666,5,0.75,0.25,Design 2,Design 2,"Have an option between Design #1 and Design #2,",4.0,4.0,5.0
1681,2128,2,Player object (905),sell,2023-03-08 04:10:14.416722+00:00,"{""priceA"": 125, ""sharesA"": 0, ""secs_since_round_starts"": 196, ""market"": ""A""}",180.0,27.0,4.0,j127swcg,vmu7c279,FULL STUDY,195.0,s3,1,125,140.0,1,-15.0,1,buy,0,sell,0.4549942201992644,16,1,0,block 3 (G second),23.0,11.0,Female,1.0,0.0,1.0,"[2, 'block 3 (G second)']",0,0,1,1.0,4.0,-0.5166666666666666,0.10344827586206896,0.25,0.0,0.6666666666666666,5,0.75,0.25,Design 2,Design 2,"Have an option between Design #1 and Design #2,",4.0,4.0,5.0
1682,2129,2,Player object (905),buy,2023-03-08 04:10:31.007672+00:00,"{""priceA"": 125, ""sharesA"": 1, ""secs_since_round_starts"": 212, ""market"": ""A""}",55.0,30.0,5.0,j127swcg,vmu7c279,FULL STUDY,195.0,s3,1,125,125.0,-1,,1,sell,0,sell,0.4785999259850118,16,0,0,block 3 (G second),23.0,11.0,Female,1.0,0.0,1.0,"[2, 'block 3 (G second)']",0,0,1,1.0,4.0,-0.5166666666666666,0.10344827586206896,0.25,0.0,0.6666666666666666,5,0.75,0.25,Design 2,Design 2,"Have an option between Design #1 and Design #2,",4.0,4.0,5.0
1683,2136,2,Player object (905),sell,2023-03-08 04:11:13.969223+00:00,"{""priceA"": 125, ""sharesA"": 0, ""secs_since_round_starts"": 255, ""market"": ""A""}",180.0,34.0,6.0,j127swcg,vmu7c279,FULL STUDY,195.0,s3,1,125,125.0,1,0.0,1,buy,0,sell,0.4644502626891607,16,0,0,block 3 (G second),23.0,11.0,Female,1.0,0.0,1.0,"[2, 'block 3 (G second)']",0,0,1,1.0,4.0,-0.5166666666666666,0.10344827586206896,0.25,0.0,0.6666666666666666,5,0.75,0.25,Design 2,Design 2,"Have an option between Design #1 and Design #2,",4.0,4.0,5.0
1684,2140,2,Player object (905),buy,2023-03-08 04:11:38.565334+00:00,"{""priceA"": 125, ""sharesA"": 1, ""secs_since_round_starts"": 280, ""market"": ""A""}",55.0,39.0,7.0,j127swcg,vmu7c279,FULL STUDY,195.0,s3,1,125,125.0,-1,,1,sell,0,sell,0.4382592777609274,16,1,0,block 3 (G second),23.0,11.0,Female,1.0,0.0,1.0,"[2, 'block 3 (G second)']",0,0,1,1.0,4.0,-0.5166666666666666,0.10344827586206896,0.25,0.0,0.6666666666666666,5,0.75,0.25,Design 2,Design 2,"Have an option between Design #1 and Design #2,",4.0,4.0,5.0
1685,2141,2,Player object (905),sell,2023-03-08 04:11:56.922580+00:00,"{""priceA"": 130, ""sharesA"": 0, ""secs_since_round_starts"": 298, ""market"": ""A""}",185.0,42.0,8.0,j127swcg,vmu7c279,FULL STUDY,195.0,s3,1,130,125.0,1,5.0,1,buy,0,sell,0.4369837361437204,16,0,0,block 3 (G second),23.0,11.0,Female,1.0,0.0,1.0,"[2, 'block 3 (G second)']",0,0,1,1.0,4.0,-0.5166666666666666,0.10344827586206896,0.25,0.0,0.6666666666666666,5,0.75,0.25,Design 2,Design 2,"Have an option between Design #1 and Design #2,",4.0,4.0,5.0
1686,2142,2,Player object (905),buy,2023-03-08 04:12:00.929032+00:00,"{""priceA"": 125, ""sharesA"": 1, ""secs_since_round_starts"": 302, ""market"": ""A""}",60.0,43.0,9.0,j127swcg,vmu7c279,FULL STUDY,195.0,s3,1,125,130.0,-1,,1,sell,0,sell,0.4218732662739463,16,1,0,block 3 (G second),23.0,11.0,Female,1.0,0.0,1.0,"[2, 'block 3 (G second)']",0,0,1,1.0,4.0,-0.5166666666666666,0.10344827586206896,0.25,0.0,0.6666666666666666,5,0.75,0.25,Design 2,Design 2,"Have an option between Design #1 and Design #2,",4.0,4.0,5.0
1687,2143,2,Player object (905),sell,2023-03-08 04:12:22.929659+00:00,"{""priceA"": 140, ""sharesA"": 0, ""secs_since_round_starts"": 324, ""market"": ""A""}",200.0,47.0,10.0,j127swcg,vmu7c279,FULL STUDY,195.0,s3,1,140,125.0,1,15.0,1,buy,0,sell,0.4996814899229063,16,0,0,block 3 (G second),23.0,11.0,Female,1.0,0.0,1.0,"[2, 'block 3 (G second)']",0,0,1,1.0,4.0,-0.5166666666666666,0.10344827586206896,0.25,0.0,0.6666666666666666,5,0.75,0.25,Design 2,Design 2,"Have an option between Design #1 and Design #2,",4.0,4.0,5.0
1688,2145,2,Player object (905),buy,2023-03-08 04:12:49.932259+00:00,"{""priceA"": 125, ""sharesA"": 1, ""secs_since_round_starts"": 351, ""market"": ""A""}",75.0,52.0,11.0,j127swcg,vmu7c279,FULL STUDY,195.0,s3,1,125,140.0,-1,,1,sell,0,sell,0.4439176376077041,16,1,0,block 3 (G second),23.0,11.0,Female,1.0,0.0,1.0,"[2, 'block 3 (G second)']",0,0,1,1.0,4.0,-0.5166666666666666,0.10344827586206896,0.25,0.0,0.6666666666666666,5,0.75,0.25,Design 2,Design 2,"Have an option between Design #1 and Design #2,",4.0,4.0,5.0
1689,2149,2,Player object (905),sell,2023-03-08 04:13:18.120095+00:00,"{""priceA"": 110, ""sharesA"": 0, ""secs_since_round_starts"": 379, ""market"": ""A""}",185.0,57.0,12.0,j127swcg,vmu7c279,FULL STUDY,195.0,s3,1,110,125.0,1,-15.0,1,buy,0,sell,0.4349378880511929,16,1,0,block 3 (G second),23.0,11.0,Female,1.0,0.0,1.0,"[2, 'block 3 (G second)']",0,0,1,1.0,4.0,-0.5166666666666666,0.10344827586206896,0.25,0.0,0.6666666666666666,5,0.75,0.25,Design 2,Design 2,"Have an option between Design #1 and Design #2,",4.0,4.0,5.0
1690,2150,2,Player object (905),buy,2023-03-08 04:13:23.907748+00:00,"{""priceA"": 115, ""sharesA"": 1, ""secs_since_round_starts"": 385, ""market"": ""A""}",70.0,58.0,13.0,j127swcg,vmu7c279,FULL STUDY,195.0,s3,1,115,110.0,-1,,1,sell,0,sell,0.4893175166503174,16,0,0,block 3 (G second),23.0,11.0,Female,1.0,0.0,1.0,"[2, 'block 3 (G second)']",0,0,1,1.0,4.0,-0.5166666666666666,0.10344827586206896,0.25,0.0,0.6666666666666666,5,0.75,0.25,Design 2,Design 2,"Have an option between Design #1 and Design #2,",4.0,4.0,5.0
1691,2170,3,Player object (1025),sell,2023-03-08 04:15:00.530918+00:00,"{""priceA"": 110, ""sharesA"": 0, ""secs_since_round_starts"": 72, ""market"": ""A""}",160.0,11.0,2.0,j127swcg,vmu7c279,FULL STUDY,210.0,s3,1,110,90.0,1,20.0,1,,0,sell,0.5295922419004607,19,0,0,block 3 (G second),23.0,11.0,Female,1.0,0.0,1.0,"[3, 'block 3 (G second)']",0,1,1,0.5,4.0,-0.5166666666666666,0.26666666666666666,0.0,0.0,0.0,5,0.75,0.25,Design 2,Design 2,"Have an option between Design #1 and Design #2,",4.0,4.0,5.0
1692,2176,3,Player object (1025),buy,2023-03-08 04:15:26.894846+00:00,"{""priceA"": 100, ""sharesA"": 1, ""secs_since_round_starts"": 99, ""market"": ""A""}",60.0,16.0,3.0,j127swcg,vmu7c279,FULL STUDY,210.0,s3,1,100,110.0,-1,,1,sell,0,sell,0.4486815727575955,19,1,0,block 3 (G second),23.0,11.0,Female,1.0,0.0,1.0,"[3, 'block 3 (G second)']",0,1,1,0.5,4.0,-0.5166666666666666,0.26666666666666666,0.0,0.0,0.0,5,0.75,0.25,Design 2,Design 2,"Have an option between Design #1 and Design #2,",4.0,4.0,5.0
1693,2180,3,Player object (1025),sell,2023-03-08 04:15:50.572146+00:00,"{""priceA"": 115, ""sharesA"": 0, ""secs_since_round_starts"": 122, ""market"": ""A""}",175.0,20.0,4.0,j127swcg,vmu7c279,FULL STUDY,210.0,s3,1,115,100.0,1,15.0,1,buy,0,sell,0.5061230669509241,19,0,0,block 3 (G second),23.0,11.0,Female,1.0,0.0,1.0,"[3, 'block 3 (G second)']",0,1,1,0.5,4.0,-0.5166666666666666,0.26666666666666666,0.0,0.0,0.0,5,0.75,0.25,Design 2,Design 2,"Have an option between Design #1 and Design #2,",4.0,4.0,5.0
1694,2183,3,Player object (1025),buy,2023-03-08 04:16:00.209701+00:00,"{""priceA"": 85, ""sharesA"": 1, ""secs_since_round_starts"": 132, ""market"": ""A""}",90.0,22.0,5.0,j127swcg,vmu7c279,FULL STUDY,210.0,s3,1,85,115.0,-1,,1,sell,0,sell,0.443819468959905,19,1,0,block 3 (G second),23.0,11.0,Female,1.0,0.0,1.0,"[3, 'block 3 (G second)']",0,1,1,0.5,4.0,-0.5166666666666666,0.26666666666666666,0.0,0.0,0.0,5,0.75,0.25,Design 2,Design 2,"Have an option between Design #1 and Design #2,",4.0,4.0,5.0
1695,2187,3,Player object (1025),sell,2023-03-08 04:16:17.560146+00:00,"{""priceA"": 110, ""sharesA"": 0, ""secs_since_round_starts"": 149, ""market"": ""A""}",200.0,25.0,6.0,j127swcg,vmu7c279,FULL STUDY,210.0,s3,1,110,85.0,1,25.0,1,buy,0,sell,0.4872943409941583,19,0,0,block 3 (G second),23.0,11.0,Female,1.0,0.0,1.0,"[3, 'block 3 (G second)']",0,1,1,0.5,4.0,-0.5166666666666666,0.26666666666666666,0.0,0.0,0.0,5,0.75,0.25,Design 2,Design 2,"Have an option between Design #1 and Design #2,",4.0,4.0,5.0
1696,2188,3,Player object (1025),buy,2023-03-08 04:16:34.413702+00:00,"{""priceA"": 110, ""sharesA"": 1, ""secs_since_round_starts"": 166, ""market"": ""A""}",90.0,28.0,7.0,j127swcg,vmu7c279,FULL STUDY,210.0,s3,1,110,110.0,-1,,1,sell,0,sell,0.5233413838959273,19,0,0,block 3 (G second),23.0,11.0,Female,1.0,0.0,1.0,"[3, 'block 3 (G second)']",0,1,1,0.5,4.0,-0.5166666666666666,0.26666666666666666,0.0,0.0,0.0,5,0.75,0.25,Design 2,Design 2,"Have an option between Design #1 and Design #2,",4.0,4.0,5.0
1697,2204,3,Player object (1025),sell,2023-03-08 04:18:00.163169+00:00,"{""priceA"": 120, ""sharesA"": 0, ""secs_since_round_starts"": 252, ""market"": ""A""}",210.0,43.0,8.0,j127swcg,vmu7c279,FULL STUDY,210.0,s3,1,120,110.0,1,10.0,1,buy,0,sell,0.5357259670782416,19,0,0,block 3 (G second),23.0,11.0,Female,1.0,0.0,1.0,"[3, 'block 3 (G second)']",0,1,1,0.5,4.0,-0.5166666666666666,0.26666666666666666,0.0,0.0,0.0,5,0.75,0.25,Design 2,Design 2,"Have an option between Design #1 and Design #2,",4.0,4.0,5.0
1698,2220,3,Player object (1025),buy,2023-03-08 04:19:24.047880+00:00,"{""priceA"": 115, ""sharesA"": 1, ""secs_since_round_starts"": 336, ""market"": ""A""}",95.0,58.0,9.0,j127swcg,vmu7c279,FULL STUDY,210.0,s3,1,115,120.0,-1,,1,sell,0,sell,0.442461876115205,19,1,0,block 3 (G second),23.0,11.0,Female,1.0,0.0,1.0,"[3, 'block 3 (G second)']",0,1,1,0.5,4.0,-0.5166666666666666,0.26666666666666666,0.0,0.0,0.0,5,0.75,0.25,Design 2,Design 2,"Have an option between Design #1 and Design #2,",4.0,4.0,5.0
1699,2240,4,Player object (1145),sell,2023-03-08 04:22:35.079819+00:00,"{""priceA"": 85, ""sharesA"": 0, ""secs_since_round_starts"": 174, ""market"": ""A""}",135.0,30.0,1.0,j127swcg,vmu7c279,FULL STUDY,165.0,s3,1,85,,1,,1,,0,sell,0.5151109892827086,14,0,0,block 3 (G second),23.0,11.0,Female,1.0,0.0,1.0,"[4, 'block 3 (G second)']",1,0,1,1.0,4.0,-0.5166666666666666,0.16666666666666666,0.02857142857142857,0.0,0.0,1,0.75,0.5,Design 2,Design 2,"Have an option between Design #1 and Design #2,",4.0,4.0,5.0
1700,2244,4,Player object (1145),buy,2023-03-08 04:23:22.453429+00:00,"{""priceA"": 70, ""sharesA"": 1, ""secs_since_round_starts"": 221, ""market"": ""A""}",65.0,37.0,2.0,j127swcg,vmu7c279,FULL STUDY,165.0,s3,1,70,85.0,-1,,1,sell,0,sell,0.4570673777008929,14,0,0,block 3 (G second),23.0,11.0,Female,1.0,0.0,1.0,"[4, 'block 3 (G second)']",1,0,1,1.0,4.0,-0.5166666666666666,0.16666666666666666,0.02857142857142857,0.0,0.0,1,0.75,0.5,Design 2,Design 2,"Have an option between Design #1 and Design #2,",4.0,4.0,5.0
1701,2250,4,Player object (1145),sell,2023-03-08 04:24:01.458250+00:00,"{""priceA"": 115, ""sharesA"": 0, ""secs_since_round_starts"": 260, ""market"": ""A""}",180.0,44.0,5.0,j127swcg,vmu7c279,FULL STUDY,165.0,s3,1,115,100.0,1,15.0,1,buy,0,sell,0.5772497941838325,14,0,0,block 3 (G second),23.0,11.0,Female,1.0,0.0,1.0,"[4, 'block 3 (G second)']",1,0,1,1.0,4.0,-0.5166666666666666,0.16666666666666666,0.02857142857142857,0.0,0.0,1,0.75,0.5,Design 2,Design 2,"Have an option between Design #1 and Design #2,",4.0,4.0,5.0
1702,2257,4,Player object (1145),buy,2023-03-08 04:24:45.445449+00:00,"{""priceA"": 90, ""sharesA"": 1, ""secs_since_round_starts"": 304, ""market"": ""A""}",90.0,52.0,6.0,j127swcg,vmu7c279,FULL STUDY,165.0,s3,1,90,115.0,-1,,1,sell,0,sell,0.4694909620846048,14,0,0,block 3 (G second),23.0,11.0,Female,1.0,0.0,1.0,"[4, 'block 3 (G second)']",1,0,1,1.0,4.0,-0.5166666666666666,0.16666666666666666,0.02857142857142857,0.0,0.0,1,0.75,0.5,Design 2,Design 2,"Have an option between Design #1 and Design #2,",4.0,4.0,5.0
1703,2281,5,Player object (1265),sell,2023-03-08 04:27:25.893959+00:00,"{""priceA"": 105, ""sharesA"": 0, ""secs_since_round_starts"": 110, ""market"": ""A""}",155.0,21.0,1.0,j127swcg,vmu7c279,FULL STUDY,225.0,s3,1,105,,1,,1,,0,sell,0.5510362930796925,17,0,1,block 3 (G second),23.0,11.0,Female,1.0,0.0,1.0,"[5, 'block 3 (G second)']",1,1,1,0.5,4.0,-0.5166666666666666,0.3333333333333333,0.043478260869565216,0.3333333333333333,0.0,4,0.5,0.25,Design 2,Design 2,"Have an option between Design #1 and Design #2,",4.0,4.0,5.0
1704,2287,5,Player object (1265),buy,2023-03-08 04:28:09.545070+00:00,"{""priceA"": 80, ""sharesA"": 1, ""secs_since_round_starts"": 154, ""market"": ""A""}",75.0,29.0,2.0,j127swcg,vmu7c279,FULL STUDY,225.0,s3,1,80,105.0,-1,,1,sell,0,sell,0.4304345659865384,17,0,0,block 3 (G second),23.0,11.0,Female,1.0,0.0,1.0,"[5, 'block 3 (G second)']",1,1,1,0.5,4.0,-0.5166666666666666,0.3333333333333333,0.043478260869565216,0.3333333333333333,0.0,4,0.5,0.25,Design 2,Design 2,"Have an option between Design #1 and Design #2,",4.0,4.0,5.0
1705,2291,5,Player object (1265),sell,2023-03-08 04:28:36.165176+00:00,"{""priceA"": 120, ""sharesA"": 0, ""secs_since_round_starts"": 180, ""market"": ""A""}",195.0,34.0,3.0,j127swcg,vmu7c279,FULL STUDY,225.0,s3,1,120,80.0,1,40.0,1,buy,0,sell,0.5679672812132522,17,0,0,block 3 (G second),23.0,11.0,Female,1.0,0.0,1.0,"[5, 'block 3 (G second)']",1,1,1,0.5,4.0,-0.5166666666666666,0.3333333333333333,0.043478260869565216,0.3333333333333333,0.0,4,0.5,0.25,Design 2,Design 2,"Have an option between Design #1 and Design #2,",4.0,4.0,5.0
1706,2293,5,Player object (1265),buy,2023-03-08 04:29:03.511547+00:00,"{""priceA"": 70, ""sharesA"": 1, ""secs_since_round_starts"": 208, ""market"": ""A""}",125.0,39.0,4.0,j127swcg,vmu7c279,FULL STUDY,225.0,s3,1,70,120.0,-1,,1,sell,0,sell,0.4317803147869401,17,0,0,block 3 (G second),23.0,11.0,Female,1.0,0.0,1.0,"[5, 'block 3 (G second)']",1,1,1,0.5,4.0,-0.5166666666666666,0.3333333333333333,0.043478260869565216,0.3333333333333333,0.0,4,0.5,0.25,Design 2,Design 2,"Have an option between Design #1 and Design #2,",4.0,4.0,5.0
1707,2295,5,Player object (1265),sell,2023-03-08 04:29:26.947206+00:00,"{""priceA"": 110, ""sharesA"": 0, ""secs_since_round_starts"": 231, ""market"": ""A""}",235.0,43.0,5.0,j127swcg,vmu7c279,FULL STUDY,225.0,s3,1,110,70.0,1,40.0,1,buy,0,sell,0.571300234525265,17,0,0,block 3 (G second),23.0,11.0,Female,1.0,0.0,1.0,"[5, 'block 3 (G second)']",1,1,1,0.5,4.0,-0.5166666666666666,0.3333333333333333,0.043478260869565216,0.3333333333333333,0.0,4,0.5,0.25,Design 2,Design 2,"Have an option between Design #1 and Design #2,",4.0,4.0,5.0
1708,2300,5,Player object (1265),buy,2023-03-08 04:29:51.502031+00:00,"{""priceA"": 90, ""sharesA"": 1, ""secs_since_round_starts"": 256, ""market"": ""A""}",145.0,47.0,6.0,j127swcg,vmu7c279,FULL STUDY,225.0,s3,1,90,110.0,-1,,1,sell,0,sell,0.4627742743797309,17,0,0,block 3 (G second),23.0,11.0,Female,1.0,0.0,1.0,"[5, 'block 3 (G second)']",1,1,1,0.5,4.0,-0.5166666666666666,0.3333333333333333,0.043478260869565216,0.3333333333333333,0.0,4,0.5,0.25,Design 2,Design 2,"Have an option between Design #1 and Design #2,",4.0,4.0,5.0
1709,2311,5,Player object (1265),sell,2023-03-08 04:30:38.923617+00:00,"{""priceA"": 95, ""sharesA"": 0, ""secs_since_round_starts"": 303, ""market"": ""A""}",240.0,56.0,8.0,j127swcg,vmu7c279,FULL STUDY,225.0,s3,1,95,75.0,1,20.0,1,buy,0,sell,0.5252108989343294,17,0,0,block 3 (G second),23.0,11.0,Female,1.0,0.0,1.0,"[5, 'block 3 (G second)']",1,1,1,0.5,4.0,-0.5166666666666666,0.3333333333333333,0.043478260869565216,0.3333333333333333,0.0,4,0.5,0.25,Design 2,Design 2,"Have an option between Design #1 and Design #2,",4.0,4.0,5.0
1710,2313,5,Player object (1265),buy,2023-03-08 04:30:45.289503+00:00,"{""priceA"": 85, ""sharesA"": 1, ""secs_since_round_starts"": 310, ""market"": ""A""}",155.0,57.0,9.0,j127swcg,vmu7c279,FULL STUDY,225.0,s3,1,85,95.0,-1,,1,sell,0,sell,0.4825596920859898,17,0,0,block 3 (G second),23.0,11.0,Female,1.0,0.0,1.0,"[5, 'block 3 (G second)']",1,1,1,0.5,4.0,-0.5166666666666666,0.3333333333333333,0.043478260869565216,0.3333333333333333,0.0,4,0.5,0.25,Design 2,Design 2,"Have an option between Design #1 and Design #2,",4.0,4.0,5.0
1711,2316,5,Player object (1265),sell,2023-03-08 04:30:50.384868+00:00,"{""priceA"": 75, ""sharesA"": 0, ""secs_since_round_starts"": 315, ""market"": ""A""}",230.0,58.0,10.0,j127swcg,vmu7c279,FULL STUDY,225.0,s3,1,75,85.0,1,-10.0,1,buy,0,sell,0.4529558772574278,17,0,0,block 3 (G second),23.0,11.0,Female,1.0,0.0,1.0,"[5, 'block 3 (G second)']",1,1,1,0.5,4.0,-0.5166666666666666,0.3333333333333333,0.043478260869565216,0.3333333333333333,0.0,4,0.5,0.25,Design 2,Design 2,"Have an option between Design #1 and Design #2,",4.0,4.0,5.0
1712,2320,5,Player object (1265),buy,2023-03-08 04:31:01.335267+00:00,"{""priceA"": 70, ""sharesA"": 1, ""secs_since_round_starts"": 326, ""market"": ""A""}",160.0,59.0,11.0,j127swcg,vmu7c279,FULL STUDY,225.0,s3,1,70,75.0,-1,,1,sell,0,sell,0.4327023062729965,17,1,0,block 3 (G second),23.0,11.0,Female,1.0,0.0,1.0,"[5, 'block 3 (G second)']",1,1,1,0.5,4.0,-0.5166666666666666,0.3333333333333333,0.043478260869565216,0.3333333333333333,0.0,4,0.5,0.25,Design 2,Design 2,"Have an option between Design #1 and Design #2,",4.0,4.0,5.0
1713,2469,3,Player object (1016),sell,2023-03-08 05:59:41.661302+00:00,"{""priceA"": 100, ""sharesA"": 0, ""secs_since_round_starts"": 43, ""market"": ""A""}",150.0,8.0,1.0,k744ov5s,vmu7c279,FULL STUDY,235.0,s1,1,100,,1,,1,,0,sell,0.5057155770500936,19,0,0,block 2 (G first),21.0,12.0,Female,1.0,1.0,1.0,"[3, 'block 2 (G first)']",1,0,0,0.5,7.0,-0.30000000000000004,0.5,0.0,1.0,0.0,4,1.0,0.5,Design 2,Design 2,"Have an option between Design #1 and Design #2,",,3.0,3.0
1714,2470,3,Player object (1016),buy,2023-03-08 05:59:53.389471+00:00,"{""priceA"": 95, ""sharesA"": 1, ""secs_since_round_starts"": 55, ""market"": ""A""}",55.0,10.0,2.0,k744ov5s,vmu7c279,FULL STUDY,235.0,s1,1,95,100.0,-1,,1,sell,0,sell,0.4922087569005138,19,0,0,block 2 (G first),21.0,12.0,Female,1.0,1.0,1.0,"[3, 'block 2 (G first)']",1,0,0,0.5,7.0,-0.30000000000000004,0.5,0.0,1.0,0.0,4,1.0,0.5,Design 2,Design 2,"Have an option between Design #1 and Design #2,",,3.0,3.0
1715,2471,3,Player object (1016),sell,2023-03-08 05:59:57.318657+00:00,"{""priceA"": 110, ""sharesA"": 0, ""secs_since_round_starts"": 59, ""market"": ""A""}",165.0,11.0,3.0,k744ov5s,vmu7c279,FULL STUDY,235.0,s1,1,110,95.0,1,15.0,1,buy,0,sell,0.5295922419004607,19,0,0,block 2 (G first),21.0,12.0,Female,1.0,1.0,1.0,"[3, 'block 2 (G first)']",1,0,0,0.5,7.0,-0.30000000000000004,0.5,0.0,1.0,0.0,4,1.0,0.5,Design 2,Design 2,"Have an option between Design #1 and Design #2,",,3.0,3.0
1716,2472,3,Player object (1016),buy,2023-03-08 06:00:24.024719+00:00,"{""priceA"": 100, ""sharesA"": 1, ""secs_since_round_starts"": 86, ""market"": ""A""}",65.0,16.0,4.0,k744ov5s,vmu7c279,FULL STUDY,235.0,s1,1,100,110.0,-1,,1,sell,0,sell,0.4486815727575955,19,1,0,block 2 (G first),21.0,12.0,Female,1.0,1.0,1.0,"[3, 'block 2 (G first)']",1,0,0,0.5,7.0,-0.30000000000000004,0.5,0.0,1.0,0.0,4,1.0,0.5,Design 2,Design 2,"Have an option between Design #1 and Design #2,",,3.0,3.0
1717,2473,3,Player object (1016),sell,2023-03-08 06:00:40.639064+00:00,"{""priceA"": 120, ""sharesA"": 0, ""secs_since_round_starts"": 102, ""market"": ""A""}",185.0,19.0,5.0,k744ov5s,vmu7c279,FULL STUDY,235.0,s1,1,120,100.0,1,20.0,1,buy,0,sell,0.5586446427659006,19,0,1,block 2 (G first),21.0,12.0,Female,1.0,1.0,1.0,"[3, 'block 2 (G first)']",1,0,0,0.5,7.0,-0.30000000000000004,0.5,0.0,1.0,0.0,4,1.0,0.5,Design 2,Design 2,"Have an option between Design #1 and Design #2,",,3.0,3.0
1718,2474,3,Player object (1016),buy,2023-03-08 06:00:52.032024+00:00,"{""priceA"": 100, ""sharesA"": 1, ""secs_since_round_starts"": 114, ""market"": ""A""}",85.0,21.0,6.0,k744ov5s,vmu7c279,FULL STUDY,235.0,s1,1,100,120.0,-1,,1,sell,0,sell,0.4692484881524699,19,0,0,block 2 (G first),21.0,12.0,Female,1.0,1.0,1.0,"[3, 'block 2 (G first)']",1,0,0,0.5,7.0,-0.30000000000000004,0.5,0.0,1.0,0.0,4,1.0,0.5,Design 2,Design 2,"Have an option between Design #1 and Design #2,",,3.0,3.0
1719,2475,3,Player object (1016),sell,2023-03-08 06:01:08.635156+00:00,"{""priceA"": 115, ""sharesA"": 0, ""secs_since_round_starts"": 130, ""market"": ""A""}",200.0,24.0,7.0,k744ov5s,vmu7c279,FULL STUDY,235.0,s1,1,115,100.0,1,15.0,1,buy,0,sell,0.5319650978870379,19,0,0,block 2 (G first),21.0,12.0,Female,1.0,1.0,1.0,"[3, 'block 2 (G first)']",1,0,0,0.5,7.0,-0.30000000000000004,0.5,0.0,1.0,0.0,4,1.0,0.5,Design 2,Design 2,"Have an option between Design #1 and Design #2,",,3.0,3.0
1720,2477,3,Player object (1016),buy,2023-03-08 06:01:59.559413+00:00,"{""priceA"": 100, ""sharesA"": 1, ""secs_since_round_starts"": 181, ""market"": ""A""}",100.0,33.0,8.0,k744ov5s,vmu7c279,FULL STUDY,235.0,s1,1,100,115.0,-1,,1,sell,0,sell,0.4476889957041811,19,1,0,block 2 (G first),21.0,12.0,Female,1.0,1.0,1.0,"[3, 'block 2 (G first)']",1,0,0,0.5,7.0,-0.30000000000000004,0.5,0.0,1.0,0.0,4,1.0,0.5,Design 2,Design 2,"Have an option between Design #1 and Design #2,",,3.0,3.0
1721,2478,3,Player object (1016),sell,2023-03-08 06:02:32.718565+00:00,"{""priceA"": 115, ""sharesA"": 0, ""secs_since_round_starts"": 214, ""market"": ""A""}",215.0,39.0,9.0,k744ov5s,vmu7c279,FULL STUDY,235.0,s1,1,115,100.0,1,15.0,1,buy,0,sell,0.5221490272476892,19,0,0,block 2 (G first),21.0,12.0,Female,1.0,1.0,1.0,"[3, 'block 2 (G first)']",1,0,0,0.5,7.0,-0.30000000000000004,0.5,0.0,1.0,0.0,4,1.0,0.5,Design 2,Design 2,"Have an option between Design #1 and Design #2,",,3.0,3.0
1722,2479,3,Player object (1016),buy,2023-03-08 06:02:39.845904+00:00,"{""priceA"": 100, ""sharesA"": 1, ""secs_since_round_starts"": 221, ""market"": ""A""}",115.0,40.0,10.0,k744ov5s,vmu7c279,FULL STUDY,235.0,s1,1,100,115.0,-1,,1,sell,0,sell,0.4804175727303482,19,0,0,block 2 (G first),21.0,12.0,Female,1.0,1.0,1.0,"[3, 'block 2 (G first)']",1,0,0,0.5,7.0,-0.30000000000000004,0.5,0.0,1.0,0.0,4,1.0,0.5,Design 2,Design 2,"Have an option between Design #1 and Design #2,",,3.0,3.0
1723,2481,3,Player object (1016),sell,2023-03-08 06:03:01.194939+00:00,"{""priceA"": 120, ""sharesA"": 0, ""secs_since_round_starts"": 242, ""market"": ""A""}",235.0,43.0,11.0,k744ov5s,vmu7c279,FULL STUDY,235.0,s1,1,120,100.0,1,20.0,1,buy,0,sell,0.5357259670782416,19,0,0,block 2 (G first),21.0,12.0,Female,1.0,1.0,1.0,"[3, 'block 2 (G first)']",1,0,0,0.5,7.0,-0.30000000000000004,0.5,0.0,1.0,0.0,4,1.0,0.5,Design 2,Design 2,"Have an option between Design #1 and Design #2,",,3.0,3.0
1724,2482,3,Player object (1016),buy,2023-03-08 06:03:23.069034+00:00,"{""priceA"": 130, ""sharesA"": 1, ""secs_since_round_starts"": 264, ""market"": ""A""}",105.0,47.0,12.0,k744ov5s,vmu7c279,FULL STUDY,235.0,s1,1,130,120.0,-1,,1,sell,0,sell,0.4927309765460438,19,0,0,block 2 (G first),21.0,12.0,Female,1.0,1.0,1.0,"[3, 'block 2 (G first)']",1,0,0,0.5,7.0,-0.30000000000000004,0.5,0.0,1.0,0.0,4,1.0,0.5,Design 2,Design 2,"Have an option between Design #1 and Design #2,",,3.0,3.0
1725,2483,3,Player object (1016),sell,2023-03-08 06:03:57.725262+00:00,"{""priceA"": 130, ""sharesA"": 0, ""secs_since_round_starts"": 299, ""market"": ""A""}",235.0,53.0,13.0,k744ov5s,vmu7c279,FULL STUDY,235.0,s1,1,130,130.0,1,0.0,1,buy,0,sell,0.4905868559773416,19,0,0,block 2 (G first),21.0,12.0,Female,1.0,1.0,1.0,"[3, 'block 2 (G first)']",1,0,0,0.5,7.0,-0.30000000000000004,0.5,0.0,1.0,0.0,4,1.0,0.5,Design 2,Design 2,"Have an option between Design #1 and Design #2,",,3.0,3.0
1726,2484,3,Player object (1016),buy,2023-03-08 06:04:33.541018+00:00,"{""priceA"": 115, ""sharesA"": 1, ""secs_since_round_starts"": 335, ""market"": ""A""}",120.0,60.0,14.0,k744ov5s,vmu7c279,FULL STUDY,235.0,s1,1,115,130.0,-1,,1,sell,0,sell,0.4613046310449969,19,0,0,block 2 (G first),21.0,12.0,Female,1.0,1.0,1.0,"[3, 'block 2 (G first)']",1,0,0,0.5,7.0,-0.30000000000000004,0.5,0.0,1.0,0.0,4,1.0,0.5,Design 2,Design 2,"Have an option between Design #1 and Design #2,",,3.0,3.0
1727,2488,4,Player object (1136),sell,2023-03-08 06:07:22.057939+00:00,"{""priceA"": 85, ""sharesA"": 0, ""secs_since_round_starts"": 160, ""market"": ""A""}",135.0,30.0,1.0,k744ov5s,vmu7c279,FULL STUDY,105.0,s1,1,85,,1,,1,,0,sell,0.5151109892827086,14,0,0,block 2 (G first),21.0,12.0,Female,1.0,1.0,1.0,"[4, 'block 2 (G first)']",0,1,0,0.5,7.0,-0.30000000000000004,1.0,0.05,1.0,0.0,2,1.0,0.5,Design 2,Design 2,"Have an option between Design #1 and Design #2,",,3.0,3.0
1728,2490,4,Player object (1136),buy,2023-03-08 06:07:56.576614+00:00,"{""priceA"": 85, ""sharesA"": 1, ""secs_since_round_starts"": 194, ""market"": ""A""}",50.0,36.0,2.0,k744ov5s,vmu7c279,FULL STUDY,105.0,s1,1,85,85.0,-1,,1,sell,0,sell,0.4885269486642424,14,0,0,block 2 (G first),21.0,12.0,Female,1.0,1.0,1.0,"[4, 'block 2 (G first)']",0,1,0,0.5,7.0,-0.30000000000000004,1.0,0.05,1.0,0.0,2,1.0,0.5,Design 2,Design 2,"Have an option between Design #1 and Design #2,",,3.0,3.0
1729,2491,4,Player object (1136),sell,2023-03-08 06:08:14.841852+00:00,"{""priceA"": 80, ""sharesA"": 0, ""secs_since_round_starts"": 213, ""market"": ""A""}",130.0,39.0,3.0,k744ov5s,vmu7c279,FULL STUDY,105.0,s1,1,80,85.0,1,-5.0,1,buy,0,sell,0.4897180556691627,14,0,0,block 2 (G first),21.0,12.0,Female,1.0,1.0,1.0,"[4, 'block 2 (G first)']",0,1,0,0.5,7.0,-0.30000000000000004,1.0,0.05,1.0,0.0,2,1.0,0.5,Design 2,Design 2,"Have an option between Design #1 and Design #2,",,3.0,3.0
1730,2492,4,Player object (1136),buy,2023-03-08 06:08:31.198408+00:00,"{""priceA"": 95, ""sharesA"": 1, ""secs_since_round_starts"": 229, ""market"": ""A""}",35.0,42.0,4.0,k744ov5s,vmu7c279,FULL STUDY,105.0,s1,1,95,80.0,-1,,1,sell,0,sell,0.5388552795609507,14,0,0,block 2 (G first),21.0,12.0,Female,1.0,1.0,1.0,"[4, 'block 2 (G first)']",0,1,0,0.5,7.0,-0.30000000000000004,1.0,0.05,1.0,0.0,2,1.0,0.5,Design 2,Design 2,"Have an option between Design #1 and Design #2,",,3.0,3.0
1731,2493,4,Player object (1136),sell,2023-03-08 06:08:35.655103+00:00,"{""priceA"": 100, ""sharesA"": 0, ""secs_since_round_starts"": 233, ""market"": ""A""}",135.0,43.0,5.0,k744ov5s,vmu7c279,FULL STUDY,105.0,s1,1,100,95.0,1,5.0,1,buy,0,sell,0.5617190733230237,14,0,1,block 2 (G first),21.0,12.0,Female,1.0,1.0,1.0,"[4, 'block 2 (G first)']",0,1,0,0.5,7.0,-0.30000000000000004,1.0,0.05,1.0,0.0,2,1.0,0.5,Design 2,Design 2,"Have an option between Design #1 and Design #2,",,3.0,3.0
1732,2494,4,Player object (1136),buy,2023-03-08 06:08:45.564221+00:00,"{""priceA"": 100, ""sharesA"": 1, ""secs_since_round_starts"": 243, ""market"": ""A""}",35.0,45.0,6.0,k744ov5s,vmu7c279,FULL STUDY,105.0,s1,1,100,100.0,-1,,1,sell,0,sell,0.5193741863096629,14,0,0,block 2 (G first),21.0,12.0,Female,1.0,1.0,1.0,"[4, 'block 2 (G first)']",0,1,0,0.5,7.0,-0.30000000000000004,1.0,0.05,1.0,0.0,2,1.0,0.5,Design 2,Design 2,"Have an option between Design #1 and Design #2,",,3.0,3.0
1733,2495,4,Player object (1136),sell,2023-03-08 06:09:03.646563+00:00,"{""priceA"": 100, ""sharesA"": 0, ""secs_since_round_starts"": 261, ""market"": ""A""}",135.0,48.0,7.0,k744ov5s,vmu7c279,FULL STUDY,105.0,s1,1,100,100.0,1,0.0,1,buy,0,sell,0.500105737602651,14,0,0,block 2 (G first),21.0,12.0,Female,1.0,1.0,1.0,"[4, 'block 2 (G first)']",0,1,0,0.5,7.0,-0.30000000000000004,1.0,0.05,1.0,0.0,2,1.0,0.5,Design 2,Design 2,"Have an option between Design #1 and Design #2,",,3.0,3.0
1734,2496,4,Player object (1136),buy,2023-03-08 06:09:18.660140+00:00,"{""priceA"": 105, ""sharesA"": 1, ""secs_since_round_starts"": 276, ""market"": ""A""}",30.0,51.0,8.0,k744ov5s,vmu7c279,FULL STUDY,105.0,s1,1,105,100.0,-1,,1,sell,0,sell,0.5064720763559888,14,0,0,block 2 (G first),21.0,12.0,Female,1.0,1.0,1.0,"[4, 'block 2 (G first)']",0,1,0,0.5,7.0,-0.30000000000000004,1.0,0.05,1.0,0.0,2,1.0,0.5,Design 2,Design 2,"Have an option between Design #1 and Design #2,",,3.0,3.0
1735,2500,5,Player object (1256),sell,2023-03-08 06:10:48.722041+00:00,"{""priceA"": 100, ""sharesA"": 0, ""secs_since_round_starts"": 33, ""market"": ""A""}",150.0,7.0,1.0,k744ov5s,vmu7c279,FULL STUDY,180.0,s1,1,100,,1,,1,,0,sell,0.5733994727268583,17,0,0,block 2 (G first),21.0,12.0,Female,1.0,1.0,1.0,"[5, 'block 2 (G first)']",0,0,0,0.5,7.0,-0.30000000000000004,0.6666666666666666,0.0,1.0,0.0,2,1.0,0.5,Design 2,Design 2,"Have an option between Design #1 and Design #2,",,3.0,3.0
1736,2501,5,Player object (1256),buy,2023-03-08 06:10:52.794945+00:00,"{""priceA"": 90, ""sharesA"": 1, ""secs_since_round_starts"": 37, ""market"": ""A""}",60.0,8.0,2.0,k744ov5s,vmu7c279,FULL STUDY,180.0,s1,1,90,100.0,-1,,1,sell,0,sell,0.5166236645513725,17,0,0,block 2 (G first),21.0,12.0,Female,1.0,1.0,1.0,"[5, 'block 2 (G first)']",0,0,0,0.5,7.0,-0.30000000000000004,0.6666666666666666,0.0,1.0,0.0,2,1.0,0.5,Design 2,Design 2,"Have an option between Design #1 and Design #2,",,3.0,3.0
1737,2502,5,Player object (1256),sell,2023-03-08 06:11:17.389138+00:00,"{""priceA"": 100, ""sharesA"": 0, ""secs_since_round_starts"": 61, ""market"": ""A""}",160.0,12.0,3.0,k744ov5s,vmu7c279,FULL STUDY,180.0,s1,1,100,90.0,1,10.0,1,buy,0,sell,0.5344269279803172,17,0,0,block 2 (G first),21.0,12.0,Female,1.0,1.0,1.0,"[5, 'block 2 (G first)']",0,0,0,0.5,7.0,-0.30000000000000004,0.6666666666666666,0.0,1.0,0.0,2,1.0,0.5,Design 2,Design 2,"Have an option between Design #1 and Design #2,",,3.0,3.0
1738,2503,5,Player object (1256),buy,2023-03-08 06:11:20.029374+00:00,"{""priceA"": 85, ""sharesA"": 1, ""secs_since_round_starts"": 64, ""market"": ""A""}",75.0,13.0,4.0,k744ov5s,vmu7c279,FULL STUDY,180.0,s1,1,85,100.0,-1,,1,sell,0,sell,0.4890232705715233,17,0,0,block 2 (G first),21.0,12.0,Female,1.0,1.0,1.0,"[5, 'block 2 (G first)']",0,0,0,0.5,7.0,-0.30000000000000004,0.6666666666666666,0.0,1.0,0.0,2,1.0,0.5,Design 2,Design 2,"Have an option between Design #1 and Design #2,",,3.0,3.0
1739,2504,5,Player object (1256),sell,2023-03-08 06:12:00.097466+00:00,"{""priceA"": 95, ""sharesA"": 0, ""secs_since_round_starts"": 104, ""market"": ""A""}",170.0,20.0,5.0,k744ov5s,vmu7c279,FULL STUDY,180.0,s1,1,95,85.0,1,10.0,1,buy,0,sell,0.5232479875730728,17,0,0,block 2 (G first),21.0,12.0,Female,1.0,1.0,1.0,"[5, 'block 2 (G first)']",0,0,0,0.5,7.0,-0.30000000000000004,0.6666666666666666,0.0,1.0,0.0,2,1.0,0.5,Design 2,Design 2,"Have an option between Design #1 and Design #2,",,3.0,3.0
1740,2505,5,Player object (1256),buy,2023-03-08 06:12:10.393366+00:00,"{""priceA"": 90, ""sharesA"": 1, ""secs_since_round_starts"": 114, ""market"": ""A""}",80.0,22.0,6.0,k744ov5s,vmu7c279,FULL STUDY,180.0,s1,1,90,95.0,-1,,1,sell,0,sell,0.5007328859118227,17,0,0,block 2 (G first),21.0,12.0,Female,1.0,1.0,1.0,"[5, 'block 2 (G first)']",0,0,0,0.5,7.0,-0.30000000000000004,0.6666666666666666,0.0,1.0,0.0,2,1.0,0.5,Design 2,Design 2,"Have an option between Design #1 and Design #2,",,3.0,3.0
1741,2506,5,Player object (1256),sell,2023-03-08 06:12:15.128103+00:00,"{""priceA"": 95, ""sharesA"": 0, ""secs_since_round_starts"": 119, ""market"": ""A""}",175.0,23.0,7.0,k744ov5s,vmu7c279,FULL STUDY,180.0,s1,1,95,90.0,1,5.0,1,buy,0,sell,0.5355078155027276,17,0,0,block 2 (G first),21.0,12.0,Female,1.0,1.0,1.0,"[5, 'block 2 (G first)']",0,0,0,0.5,7.0,-0.30000000000000004,0.6666666666666666,0.0,1.0,0.0,2,1.0,0.5,Design 2,Design 2,"Have an option between Design #1 and Design #2,",,3.0,3.0
1742,2509,5,Player object (1256),buy,2023-03-08 06:12:43.001563+00:00,"{""priceA"": 85, ""sharesA"": 1, ""secs_since_round_starts"": 147, ""market"": ""A""}",90.0,28.0,9.0,k744ov5s,vmu7c279,FULL STUDY,180.0,s1,1,85,100.0,-1,,1,sell,0,sell,0.4496194529460131,17,1,0,block 2 (G first),21.0,12.0,Female,1.0,1.0,1.0,"[5, 'block 2 (G first)']",0,0,0,0.5,7.0,-0.30000000000000004,0.6666666666666666,0.0,1.0,0.0,2,1.0,0.5,Design 2,Design 2,"Have an option between Design #1 and Design #2,",,3.0,3.0
1743,2511,5,Player object (1256),sell,2023-03-08 06:13:11.762153+00:00,"{""priceA"": 110, ""sharesA"": 0, ""secs_since_round_starts"": 176, ""market"": ""A""}",200.0,33.0,10.0,k744ov5s,vmu7c279,FULL STUDY,180.0,s1,1,110,85.0,1,25.0,1,buy,0,sell,0.5480287979668599,17,0,1,block 2 (G first),21.0,12.0,Female,1.0,1.0,1.0,"[5, 'block 2 (G first)']",0,0,0,0.5,7.0,-0.30000000000000004,0.6666666666666666,0.0,1.0,0.0,2,1.0,0.5,Design 2,Design 2,"Have an option between Design #1 and Design #2,",,3.0,3.0
1744,2512,5,Player object (1256),buy,2023-03-08 06:13:33.850242+00:00,"{""priceA"": 95, ""sharesA"": 1, ""secs_since_round_starts"": 198, ""market"": ""A""}",105.0,37.0,11.0,k744ov5s,vmu7c279,FULL STUDY,180.0,s1,1,95,110.0,-1,,1,sell,0,sell,0.4805886028013266,17,0,0,block 2 (G first),21.0,12.0,Female,1.0,1.0,1.0,"[5, 'block 2 (G first)']",0,0,0,0.5,7.0,-0.30000000000000004,0.6666666666666666,0.0,1.0,0.0,2,1.0,0.5,Design 2,Design 2,"Have an option between Design #1 and Design #2,",,3.0,3.0
1745,2513,5,Player object (1256),sell,2023-03-08 06:13:57.561140+00:00,"{""priceA"": 95, ""sharesA"": 0, ""secs_since_round_starts"": 221, ""market"": ""A""}",200.0,41.0,12.0,k744ov5s,vmu7c279,FULL STUDY,180.0,s1,1,95,95.0,1,0.0,1,buy,0,sell,0.5260161398462472,17,0,0,block 2 (G first),21.0,12.0,Female,1.0,1.0,1.0,"[5, 'block 2 (G first)']",0,0,0,0.5,7.0,-0.30000000000000004,0.6666666666666666,0.0,1.0,0.0,2,1.0,0.5,Design 2,Design 2,"Have an option between Design #1 and Design #2,",,3.0,3.0
1746,2514,5,Player object (1256),buy,2023-03-08 06:14:23.873767+00:00,"{""priceA"": 95, ""sharesA"": 1, ""secs_since_round_starts"": 248, ""market"": ""A""}",105.0,46.0,13.0,k744ov5s,vmu7c279,FULL STUDY,180.0,s1,1,95,95.0,-1,,1,sell,0,sell,0.4967862103563366,17,0,0,block 2 (G first),21.0,12.0,Female,1.0,1.0,1.0,"[5, 'block 2 (G first)']",0,0,0,0.5,7.0,-0.30000000000000004,0.6666666666666666,0.0,1.0,0.0,2,1.0,0.5,Design 2,Design 2,"Have an option between Design #1 and Design #2,",,3.0,3.0
1747,2515,5,Player object (1256),sell,2023-03-08 06:15:08.128067+00:00,"{""priceA"": 95, ""sharesA"": 0, ""secs_since_round_starts"": 292, ""market"": ""A""}",200.0,54.0,14.0,k744ov5s,vmu7c279,FULL STUDY,180.0,s1,1,95,95.0,1,0.0,1,buy,0,sell,0.5299980248683189,17,0,0,block 2 (G first),21.0,12.0,Female,1.0,1.0,1.0,"[5, 'block 2 (G first)']",0,0,0,0.5,7.0,-0.30000000000000004,0.6666666666666666,0.0,1.0,0.0,2,1.0,0.5,Design 2,Design 2,"Have an option between Design #1 and Design #2,",,3.0,3.0
1748,2516,5,Player object (1256),buy,2023-03-08 06:15:25.729159+00:00,"{""priceA"": 85, ""sharesA"": 1, ""secs_since_round_starts"": 310, ""market"": ""A""}",115.0,57.0,15.0,k744ov5s,vmu7c279,FULL STUDY,180.0,s1,1,85,95.0,-1,,1,sell,0,sell,0.4825596920859898,17,0,0,block 2 (G first),21.0,12.0,Female,1.0,1.0,1.0,"[5, 'block 2 (G first)']",0,0,0,0.5,7.0,-0.30000000000000004,0.6666666666666666,0.0,1.0,0.0,2,1.0,0.5,Design 2,Design 2,"Have an option between Design #1 and Design #2,",,3.0,3.0
1749,2123,2,Player object (906),sell,2023-03-08 04:09:52.619054+00:00,"{""priceA"": 105, ""sharesA"": 0, ""secs_since_round_starts"": 176, ""market"": ""A""}",155.0,8.0,1.0,l1c1hcmk,vmu7c279,FULL STUDY,160.0,s4,1,105,,1,,1,,0,sell,0.5,0,0,0,block 3 (G second),22.0,11.0,Male,1.0,1.0,1.0,"[2, 'block 3 (G second)']",0,0,1,0.5,5.0,-0.41666666666666663,0.16666666666666666,0.047619047619047616,0.0,0.0,3,1.0,0.25,Design 2,Design 2,"Have an option between Design #1 and Design #2,",3.0,,
1750,2124,2,Player object (906),buy,2023-03-08 04:10:02.185433+00:00,"{""priceA"": 75, ""sharesA"": 1, ""secs_since_round_starts"": 185, ""market"": ""A""}",80.0,10.0,2.0,l1c1hcmk,vmu7c279,FULL STUDY,160.0,s4,1,75,105.0,-1,,1,sell,0,sell,0.5,0,0,0,block 3 (G second),22.0,11.0,Male,1.0,1.0,1.0,"[2, 'block 3 (G second)']",0,0,1,0.5,5.0,-0.41666666666666663,0.16666666666666666,0.047619047619047616,0.0,0.0,3,1.0,0.25,Design 2,Design 2,"Have an option between Design #1 and Design #2,",3.0,,
1751,2134,2,Player object (906),sell,2023-03-08 04:11:09.866162+00:00,"{""priceA"": 75, ""sharesA"": 0, ""secs_since_round_starts"": 253, ""market"": ""A""}",155.0,22.0,3.0,l1c1hcmk,vmu7c279,FULL STUDY,160.0,s4,1,75,75.0,1,0.0,1,buy,0,sell,0.5,0,0,0,block 3 (G second),22.0,11.0,Male,1.0,1.0,1.0,"[2, 'block 3 (G second)']",0,0,1,0.5,5.0,-0.41666666666666663,0.16666666666666666,0.047619047619047616,0.0,0.0,3,1.0,0.25,Design 2,Design 2,"Have an option between Design #1 and Design #2,",3.0,,
1752,2137,2,Player object (906),buy,2023-03-08 04:11:26.733513+00:00,"{""priceA"": 70, ""sharesA"": 1, ""secs_since_round_starts"": 270, ""market"": ""A""}",85.0,25.0,4.0,l1c1hcmk,vmu7c279,FULL STUDY,160.0,s4,1,70,75.0,-1,,1,sell,0,sell,0.5,0,0,0,block 3 (G second),22.0,11.0,Male,1.0,1.0,1.0,"[2, 'block 3 (G second)']",0,0,1,0.5,5.0,-0.41666666666666663,0.16666666666666666,0.047619047619047616,0.0,0.0,3,1.0,0.25,Design 2,Design 2,"Have an option between Design #1 and Design #2,",3.0,,
1753,2139,2,Player object (906),sell,2023-03-08 04:11:32.347983+00:00,"{""priceA"": 80, ""sharesA"": 0, ""secs_since_round_starts"": 276, ""market"": ""A""}",165.0,26.0,5.0,l1c1hcmk,vmu7c279,FULL STUDY,160.0,s4,1,80,70.0,1,10.0,1,buy,0,sell,0.5,0,0,0,block 3 (G second),22.0,11.0,Male,1.0,1.0,1.0,"[2, 'block 3 (G second)']",0,0,1,0.5,5.0,-0.41666666666666663,0.16666666666666666,0.047619047619047616,0.0,0.0,3,1.0,0.25,Design 2,Design 2,"Have an option between Design #1 and Design #2,",3.0,,
1754,2146,2,Player object (906),buy,2023-03-08 04:12:50.545733+00:00,"{""priceA"": 75, ""sharesA"": 1, ""secs_since_round_starts"": 354, ""market"": ""A""}",90.0,34.0,6.0,l1c1hcmk,vmu7c279,FULL STUDY,160.0,s4,1,75,80.0,-1,,1,sell,0,sell,0.5,0,1,0,block 3 (G second),22.0,11.0,Male,1.0,1.0,1.0,"[2, 'block 3 (G second)']",0,0,1,0.5,5.0,-0.41666666666666663,0.16666666666666666,0.047619047619047616,0.0,0.0,3,1.0,0.25,Design 2,Design 2,"Have an option between Design #1 and Design #2,",3.0,,
1755,2162,2,Player object (906),sell,2023-03-08 04:14:17.905110+00:00,"{""priceA"": 60, ""sharesA"": 0, ""secs_since_round_starts"": 441, ""market"": ""A""}",150.0,50.0,7.0,l1c1hcmk,vmu7c279,FULL STUDY,160.0,s4,1,60,75.0,1,-15.0,1,buy,0,sell,0.5,0,0,0,block 3 (G second),22.0,11.0,Male,1.0,1.0,1.0,"[2, 'block 3 (G second)']",0,0,1,0.5,5.0,-0.41666666666666663,0.16666666666666666,0.047619047619047616,0.0,0.0,3,1.0,0.25,Design 2,Design 2,"Have an option between Design #1 and Design #2,",3.0,,
1756,2168,2,Player object (906),buy,2023-03-08 04:14:49.635541+00:00,"{""priceA"": 85, ""sharesA"": 1, ""secs_since_round_starts"": 473, ""market"": ""A""}",65.0,56.0,8.0,l1c1hcmk,vmu7c279,FULL STUDY,160.0,s4,1,85,60.0,-1,,1,sell,0,sell,0.5,0,0,0,block 3 (G second),22.0,11.0,Male,1.0,1.0,1.0,"[2, 'block 3 (G second)']",0,0,1,0.5,5.0,-0.41666666666666663,0.16666666666666666,0.047619047619047616,0.0,0.0,3,1.0,0.25,Design 2,Design 2,"Have an option between Design #1 and Design #2,",3.0,,
1757,2189,3,Player object (1026),sell,2023-03-08 04:16:36.148420+00:00,"{""priceA"": 125, ""sharesA"": 0, ""secs_since_round_starts"": 77, ""market"": ""A""}",175.0,9.0,1.0,l1c1hcmk,vmu7c279,FULL STUDY,255.0,s4,1,125,,1,,1,,0,sell,0.5,0,0,0,block 3 (G second),22.0,11.0,Male,1.0,1.0,1.0,"[3, 'block 3 (G second)']",0,1,1,0.0,5.0,-0.41666666666666663,0.26666666666666666,0.0,0.3333333333333333,0.0,3,1.0,0.5,Design 2,Design 2,"Have an option between Design #1 and Design #2,",3.0,,
1758,2193,3,Player object (1026),buy,2023-03-08 04:16:50.279169+00:00,"{""priceA"": 140, ""sharesA"": 1, ""secs_since_round_starts"": 91, ""market"": ""A""}",35.0,12.0,2.0,l1c1hcmk,vmu7c279,FULL STUDY,255.0,s4,1,140,125.0,-1,,1,sell,0,sell,0.5,0,0,0,block 3 (G second),22.0,11.0,Male,1.0,1.0,1.0,"[3, 'block 3 (G second)']",0,1,1,0.0,5.0,-0.41666666666666663,0.26666666666666666,0.0,0.3333333333333333,0.0,3,1.0,0.5,Design 2,Design 2,"Have an option between Design #1 and Design #2,",3.0,,
1759,2200,3,Player object (1026),sell,2023-03-08 04:17:24.614334+00:00,"{""priceA"": 165, ""sharesA"": 0, ""secs_since_round_starts"": 125, ""market"": ""A""}",200.0,18.0,3.0,l1c1hcmk,vmu7c279,FULL STUDY,255.0,s4,1,165,140.0,1,25.0,1,buy,0,sell,0.5,0,0,0,block 3 (G second),22.0,11.0,Male,1.0,1.0,1.0,"[3, 'block 3 (G second)']",0,1,1,0.0,5.0,-0.41666666666666663,0.26666666666666666,0.0,0.3333333333333333,0.0,3,1.0,0.5,Design 2,Design 2,"Have an option between Design #1 and Design #2,",3.0,,
1760,2203,3,Player object (1026),buy,2023-03-08 04:17:41.071506+00:00,"{""priceA"": 130, ""sharesA"": 1, ""secs_since_round_starts"": 142, ""market"": ""A""}",70.0,21.0,4.0,l1c1hcmk,vmu7c279,FULL STUDY,255.0,s4,1,130,165.0,-1,,1,sell,0,sell,0.5,0,1,0,block 3 (G second),22.0,11.0,Male,1.0,1.0,1.0,"[3, 'block 3 (G second)']",0,1,1,0.0,5.0,-0.41666666666666663,0.26666666666666666,0.0,0.3333333333333333,0.0,3,1.0,0.5,Design 2,Design 2,"Have an option between Design #1 and Design #2,",3.0,,
1761,2205,3,Player object (1026),sell,2023-03-08 04:18:01.513418+00:00,"{""priceA"": 155, ""sharesA"": 0, ""secs_since_round_starts"": 162, ""market"": ""A""}",225.0,25.0,5.0,l1c1hcmk,vmu7c279,FULL STUDY,255.0,s4,1,155,130.0,1,25.0,1,buy,0,sell,0.5,0,0,1,block 3 (G second),22.0,11.0,Male,1.0,1.0,1.0,"[3, 'block 3 (G second)']",0,1,1,0.0,5.0,-0.41666666666666663,0.26666666666666666,0.0,0.3333333333333333,0.0,3,1.0,0.5,Design 2,Design 2,"Have an option between Design #1 and Design #2,",3.0,,
1762,2217,3,Player object (1026),buy,2023-03-08 04:18:55.153420+00:00,"{""priceA"": 145, ""sharesA"": 1, ""secs_since_round_starts"": 216, ""market"": ""A""}",80.0,34.0,6.0,l1c1hcmk,vmu7c279,FULL STUDY,255.0,s4,1,145,155.0,-1,,1,sell,0,sell,0.5,0,0,0,block 3 (G second),22.0,11.0,Male,1.0,1.0,1.0,"[3, 'block 3 (G second)']",0,1,1,0.0,5.0,-0.41666666666666663,0.26666666666666666,0.0,0.3333333333333333,0.0,3,1.0,0.5,Design 2,Design 2,"Have an option between Design #1 and Design #2,",3.0,,
1763,2226,3,Player object (1026),sell,2023-03-08 04:19:57.057219+00:00,"{""priceA"": 150, ""sharesA"": 0, ""secs_since_round_starts"": 277, ""market"": ""A""}",230.0,45.0,7.0,l1c1hcmk,vmu7c279,FULL STUDY,255.0,s4,1,150,145.0,1,5.0,1,buy,0,sell,0.5,0,0,0,block 3 (G second),22.0,11.0,Male,1.0,1.0,1.0,"[3, 'block 3 (G second)']",0,1,1,0.0,5.0,-0.41666666666666663,0.26666666666666666,0.0,0.3333333333333333,0.0,3,1.0,0.5,Design 2,Design 2,"Have an option between Design #1 and Design #2,",3.0,,
1764,2231,3,Player object (1026),buy,2023-03-08 04:21:07.730178+00:00,"{""priceA"": 155, ""sharesA"": 1, ""secs_since_round_starts"": 348, ""market"": ""A""}",75.0,58.0,8.0,l1c1hcmk,vmu7c279,FULL STUDY,255.0,s4,1,155,150.0,-1,,1,sell,0,sell,0.5,0,0,0,block 3 (G second),22.0,11.0,Male,1.0,1.0,1.0,"[3, 'block 3 (G second)']",0,1,1,0.0,5.0,-0.41666666666666663,0.26666666666666666,0.0,0.3333333333333333,0.0,3,1.0,0.5,Design 2,Design 2,"Have an option between Design #1 and Design #2,",3.0,,
1765,2253,4,Player object (1146),sell,2023-03-08 04:24:28.116097+00:00,"{""priceA"": 45, ""sharesA"": 0, ""secs_since_round_starts"": 183, ""market"": ""A""}",95.0,32.0,1.0,l1c1hcmk,vmu7c279,FULL STUDY,95.0,s4,1,45,,1,,1,,0,sell,0.5,0,0,0,block 3 (G second),22.0,11.0,Male,1.0,1.0,1.0,"[4, 'block 3 (G second)']",1,0,1,0.0,5.0,-0.41666666666666663,0.0,0.058823529411764705,0.0,0.0,2,0.75,0.0,Design 2,Design 2,"Have an option between Design #1 and Design #2,",3.0,,
1766,2285,5,Player object (1266),sell,2023-03-08 04:28:02.049590+00:00,"{""priceA"": 135, ""sharesA"": 0, ""secs_since_round_starts"": 54, ""market"": ""A""}",185.0,10.0,1.0,l1c1hcmk,vmu7c279,FULL STUDY,240.0,s4,1,135,,1,,1,,0,sell,0.5,0,0,0,block 3 (G second),22.0,11.0,Male,1.0,1.0,1.0,"[5, 'block 3 (G second)']",1,1,1,0.0,5.0,-0.41666666666666663,0.35294117647058826,0.0,0.3333333333333333,0.0,3,1.0,0.25,Design 2,Design 2,"Have an option between Design #1 and Design #2,",3.0,,
1767,2292,5,Player object (1266),buy,2023-03-08 04:28:47.151188+00:00,"{""priceA"": 115, ""sharesA"": 1, ""secs_since_round_starts"": 99, ""market"": ""A""}",70.0,18.0,2.0,l1c1hcmk,vmu7c279,FULL STUDY,240.0,s4,1,115,135.0,-1,,1,sell,0,sell,0.5,0,1,0,block 3 (G second),22.0,11.0,Male,1.0,1.0,1.0,"[5, 'block 3 (G second)']",1,1,1,0.0,5.0,-0.41666666666666663,0.35294117647058826,0.0,0.3333333333333333,0.0,3,1.0,0.25,Design 2,Design 2,"Have an option between Design #1 and Design #2,",3.0,,
1768,2294,5,Player object (1266),sell,2023-03-08 04:29:16.059320+00:00,"{""priceA"": 150, ""sharesA"": 0, ""secs_since_round_starts"": 128, ""market"": ""A""}",220.0,23.0,3.0,l1c1hcmk,vmu7c279,FULL STUDY,240.0,s4,1,150,115.0,1,35.0,1,buy,0,sell,0.5,0,0,0,block 3 (G second),22.0,11.0,Male,1.0,1.0,1.0,"[5, 'block 3 (G second)']",1,1,1,0.0,5.0,-0.41666666666666663,0.35294117647058826,0.0,0.3333333333333333,0.0,3,1.0,0.25,Design 2,Design 2,"Have an option between Design #1 and Design #2,",3.0,,
1769,2299,5,Player object (1266),buy,2023-03-08 04:29:47.896248+00:00,"{""priceA"": 135, ""sharesA"": 1, ""secs_since_round_starts"": 160, ""market"": ""A""}",85.0,29.0,4.0,l1c1hcmk,vmu7c279,FULL STUDY,240.0,s4,1,135,150.0,-1,,1,sell,0,sell,0.5,0,0,0,block 3 (G second),22.0,11.0,Male,1.0,1.0,1.0,"[5, 'block 3 (G second)']",1,1,1,0.0,5.0,-0.41666666666666663,0.35294117647058826,0.0,0.3333333333333333,0.0,3,1.0,0.25,Design 2,Design 2,"Have an option between Design #1 and Design #2,",3.0,,
1770,2306,5,Player object (1266),sell,2023-03-08 04:30:24.319284+00:00,"{""priceA"": 140, ""sharesA"": 0, ""secs_since_round_starts"": 196, ""market"": ""A""}",225.0,36.0,5.0,l1c1hcmk,vmu7c279,FULL STUDY,240.0,s4,1,140,135.0,1,5.0,1,buy,0,sell,0.5,0,0,0,block 3 (G second),22.0,11.0,Male,1.0,1.0,1.0,"[5, 'block 3 (G second)']",1,1,1,0.0,5.0,-0.41666666666666663,0.35294117647058826,0.0,0.3333333333333333,0.0,3,1.0,0.25,Design 2,Design 2,"Have an option between Design #1 and Design #2,",3.0,,
1771,2307,5,Player object (1266),buy,2023-03-08 04:30:29.728888+00:00,"{""priceA"": 135, ""sharesA"": 1, ""secs_since_round_starts"": 202, ""market"": ""A""}",90.0,37.0,6.0,l1c1hcmk,vmu7c279,FULL STUDY,240.0,s4,1,135,140.0,-1,,1,sell,0,sell,0.5,0,0,0,block 3 (G second),22.0,11.0,Male,1.0,1.0,1.0,"[5, 'block 3 (G second)']",1,1,1,0.0,5.0,-0.41666666666666663,0.35294117647058826,0.0,0.3333333333333333,0.0,3,1.0,0.25,Design 2,Design 2,"Have an option between Design #1 and Design #2,",3.0,,
1772,2312,5,Player object (1266),sell,2023-03-08 04:30:41.003044+00:00,"{""priceA"": 135, ""sharesA"": 0, ""secs_since_round_starts"": 213, ""market"": ""A""}",225.0,39.0,7.0,l1c1hcmk,vmu7c279,FULL STUDY,240.0,s4,1,135,135.0,1,0.0,1,buy,0,sell,0.5,0,0,0,block 3 (G second),22.0,11.0,Male,1.0,1.0,1.0,"[5, 'block 3 (G second)']",1,1,1,0.0,5.0,-0.41666666666666663,0.35294117647058826,0.0,0.3333333333333333,0.0,3,1.0,0.25,Design 2,Design 2,"Have an option between Design #1 and Design #2,",3.0,,
1773,2315,5,Player object (1266),buy,2023-03-08 04:30:46.572913+00:00,"{""priceA"": 125, ""sharesA"": 1, ""secs_since_round_starts"": 219, ""market"": ""A""}",100.0,40.0,8.0,l1c1hcmk,vmu7c279,FULL STUDY,240.0,s4,1,125,135.0,-1,,1,sell,0,sell,0.5,0,0,0,block 3 (G second),22.0,11.0,Male,1.0,1.0,1.0,"[5, 'block 3 (G second)']",1,1,1,0.0,5.0,-0.41666666666666663,0.35294117647058826,0.0,0.3333333333333333,0.0,3,1.0,0.25,Design 2,Design 2,"Have an option between Design #1 and Design #2,",3.0,,
1774,2318,5,Player object (1266),sell,2023-03-08 04:30:59.465491+00:00,"{""priceA"": 130, ""sharesA"": 0, ""secs_since_round_starts"": 231, ""market"": ""A""}",230.0,42.0,9.0,l1c1hcmk,vmu7c279,FULL STUDY,240.0,s4,1,130,125.0,1,5.0,1,buy,0,sell,0.5,0,0,0,block 3 (G second),22.0,11.0,Male,1.0,1.0,1.0,"[5, 'block 3 (G second)']",1,1,1,0.0,5.0,-0.41666666666666663,0.35294117647058826,0.0,0.3333333333333333,0.0,3,1.0,0.25,Design 2,Design 2,"Have an option between Design #1 and Design #2,",3.0,,
1775,2322,5,Player object (1266),buy,2023-03-08 04:31:02.638374+00:00,"{""priceA"": 115, ""sharesA"": 1, ""secs_since_round_starts"": 235, ""market"": ""A""}",115.0,43.0,10.0,l1c1hcmk,vmu7c279,FULL STUDY,240.0,s4,1,115,130.0,-1,,1,sell,0,sell,0.5,0,0,0,block 3 (G second),22.0,11.0,Male,1.0,1.0,1.0,"[5, 'block 3 (G second)']",1,1,1,0.0,5.0,-0.41666666666666663,0.35294117647058826,0.0,0.3333333333333333,0.0,3,1.0,0.25,Design 2,Design 2,"Have an option between Design #1 and Design #2,",3.0,,
1776,2324,5,Player object (1266),sell,2023-03-08 04:31:16.448770+00:00,"{""priceA"": 120, ""sharesA"": 0, ""secs_since_round_starts"": 248, ""market"": ""A""}",235.0,45.0,11.0,l1c1hcmk,vmu7c279,FULL STUDY,240.0,s4,1,120,115.0,1,5.0,1,buy,0,sell,0.5,0,0,0,block 3 (G second),22.0,11.0,Male,1.0,1.0,1.0,"[5, 'block 3 (G second)']",1,1,1,0.0,5.0,-0.41666666666666663,0.35294117647058826,0.0,0.3333333333333333,0.0,3,1.0,0.25,Design 2,Design 2,"Have an option between Design #1 and Design #2,",3.0,,
1777,2325,5,Player object (1266),buy,2023-03-08 04:31:24.725027+00:00,"{""priceA"": 115, ""sharesA"": 1, ""secs_since_round_starts"": 257, ""market"": ""A""}",120.0,47.0,12.0,l1c1hcmk,vmu7c279,FULL STUDY,240.0,s4,1,115,120.0,-1,,1,sell,0,sell,0.5,0,0,0,block 3 (G second),22.0,11.0,Male,1.0,1.0,1.0,"[5, 'block 3 (G second)']",1,1,1,0.0,5.0,-0.41666666666666663,0.35294117647058826,0.0,0.3333333333333333,0.0,3,1.0,0.25,Design 2,Design 2,"Have an option between Design #1 and Design #2,",3.0,,
1778,2329,5,Player object (1266),sell,2023-03-08 04:31:53.498718+00:00,"{""priceA"": 115, ""sharesA"": 0, ""secs_since_round_starts"": 285, ""market"": ""A""}",235.0,52.0,13.0,l1c1hcmk,vmu7c279,FULL STUDY,240.0,s4,1,115,115.0,1,0.0,1,buy,0,sell,0.5,0,0,0,block 3 (G second),22.0,11.0,Male,1.0,1.0,1.0,"[5, 'block 3 (G second)']",1,1,1,0.0,5.0,-0.41666666666666663,0.35294117647058826,0.0,0.3333333333333333,0.0,3,1.0,0.25,Design 2,Design 2,"Have an option between Design #1 and Design #2,",3.0,,
1779,2330,5,Player object (1266),buy,2023-03-08 04:31:58.958709+00:00,"{""priceA"": 100, ""sharesA"": 1, ""secs_since_round_starts"": 291, ""market"": ""A""}",135.0,53.0,14.0,l1c1hcmk,vmu7c279,FULL STUDY,240.0,s4,1,100,115.0,-1,,1,sell,0,sell,0.5,0,0,0,block 3 (G second),22.0,11.0,Male,1.0,1.0,1.0,"[5, 'block 3 (G second)']",1,1,1,0.0,5.0,-0.41666666666666663,0.35294117647058826,0.0,0.3333333333333333,0.0,3,1.0,0.25,Design 2,Design 2,"Have an option between Design #1 and Design #2,",3.0,,
1780,2334,5,Player object (1266),sell,2023-03-08 04:32:30.905696+00:00,"{""priceA"": 105, ""sharesA"": 0, ""secs_since_round_starts"": 323, ""market"": ""A""}",240.0,59.0,15.0,l1c1hcmk,vmu7c279,FULL STUDY,240.0,s4,1,105,100.0,1,5.0,1,buy,0,sell,0.5,0,0,1,block 3 (G second),22.0,11.0,Male,1.0,1.0,1.0,"[5, 'block 3 (G second)']",1,1,1,0.0,5.0,-0.41666666666666663,0.35294117647058826,0.0,0.3333333333333333,0.0,3,1.0,0.25,Design 2,Design 2,"Have an option between Design #1 and Design #2,",3.0,,
1781,3315,2,Player object (930),sell,2023-03-09 03:42:23.764330+00:00,"{""priceA"": 100, ""sharesA"": 0, ""secs_since_round_starts"": 89, ""market"": ""A""}",150.0,12.0,1.0,leux5m59,vmu7c279,FULL STUDY,140.0,s4,1,100,,1,,1,,0,sell,0.5,0,0,0,block 3 (G second),22.0,12.0,Male,1.0,1.0,1.0,"[2, 'block 3 (G second)']",0,0,1,0.5,7.0,-0.30000000000000004,0.5,0.04,,0.16666666666666666,2,0.75,0.5,Design 2,Design 2,"Have an option between Design #1 and Design #2,",2.0,,
1782,3316,2,Player object (930),buy,2023-03-09 03:42:29.911448+00:00,"{""priceA"": 85, ""sharesA"": 1, ""secs_since_round_starts"": 95, ""market"": ""A""}",65.0,13.0,2.0,leux5m59,vmu7c279,FULL STUDY,140.0,s4,1,85,100.0,-1,,1,sell,0,sell,0.5,0,0,0,block 3 (G second),22.0,12.0,Male,1.0,1.0,1.0,"[2, 'block 3 (G second)']",0,0,1,0.5,7.0,-0.30000000000000004,0.5,0.04,,0.16666666666666666,2,0.75,0.5,Design 2,Design 2,"Have an option between Design #1 and Design #2,",2.0,,
1783,3320,2,Player object (930),sell,2023-03-09 03:43:10.229340+00:00,"{""priceA"": 85, ""sharesA"": 0, ""secs_since_round_starts"": 135, ""market"": ""A""}",150.0,20.0,4.0,leux5m59,vmu7c279,FULL STUDY,140.0,s4,1,85,70.0,1,15.0,1,buy,0,sell,0.5,0,0,0,block 3 (G second),22.0,12.0,Male,1.0,1.0,1.0,"[2, 'block 3 (G second)']",0,0,1,0.5,7.0,-0.30000000000000004,0.5,0.04,,0.16666666666666666,2,0.75,0.5,Design 2,Design 2,"Have an option between Design #1 and Design #2,",2.0,,
1784,3321,2,Player object (930),buy,2023-03-09 03:43:13.374321+00:00,"{""priceA"": 70, ""sharesA"": 1, ""secs_since_round_starts"": 139, ""market"": ""A""}",80.0,21.0,5.0,leux5m59,vmu7c279,FULL STUDY,140.0,s4,1,70,85.0,-1,,1,sell,0,sell,0.5,0,0,0,block 3 (G second),22.0,12.0,Male,1.0,1.0,1.0,"[2, 'block 3 (G second)']",0,0,1,0.5,7.0,-0.30000000000000004,0.5,0.04,,0.16666666666666666,2,0.75,0.5,Design 2,Design 2,"Have an option between Design #1 and Design #2,",2.0,,
1785,3322,2,Player object (930),sell,2023-03-09 03:43:21.914990+00:00,"{""priceA"": 75, ""sharesA"": 0, ""secs_since_round_starts"": 147, ""market"": ""A""}",155.0,22.0,6.0,leux5m59,vmu7c279,FULL STUDY,140.0,s4,1,75,70.0,1,5.0,1,buy,0,sell,0.5,0,0,0,block 3 (G second),22.0,12.0,Male,1.0,1.0,1.0,"[2, 'block 3 (G second)']",0,0,1,0.5,7.0,-0.30000000000000004,0.5,0.04,,0.16666666666666666,2,0.75,0.5,Design 2,Design 2,"Have an option between Design #1 and Design #2,",2.0,,
1786,3323,2,Player object (930),buy,2023-03-09 03:43:36.327657+00:00,"{""priceA"": 70, ""sharesA"": 1, ""secs_since_round_starts"": 161, ""market"": ""A""}",85.0,25.0,7.0,leux5m59,vmu7c279,FULL STUDY,140.0,s4,1,70,75.0,-1,,1,sell,0,sell,0.5,0,0,0,block 3 (G second),22.0,12.0,Male,1.0,1.0,1.0,"[2, 'block 3 (G second)']",0,0,1,0.5,7.0,-0.30000000000000004,0.5,0.04,,0.16666666666666666,2,0.75,0.5,Design 2,Design 2,"Have an option between Design #1 and Design #2,",2.0,,
1787,3324,2,Player object (930),sell,2023-03-09 03:43:41.771553+00:00,"{""priceA"": 80, ""sharesA"": 0, ""secs_since_round_starts"": 167, ""market"": ""A""}",165.0,26.0,8.0,leux5m59,vmu7c279,FULL STUDY,140.0,s4,1,80,70.0,1,10.0,1,buy,0,sell,0.5,0,0,0,block 3 (G second),22.0,12.0,Male,1.0,1.0,1.0,"[2, 'block 3 (G second)']",0,0,1,0.5,7.0,-0.30000000000000004,0.5,0.04,,0.16666666666666666,2,0.75,0.5,Design 2,Design 2,"Have an option between Design #1 and Design #2,",2.0,,
1788,3328,2,Player object (930),buy,2023-03-09 03:44:26.241056+00:00,"{""priceA"": 90, ""sharesA"": 1, ""secs_since_round_starts"": 211, ""market"": ""A""}",75.0,33.0,9.0,leux5m59,vmu7c279,FULL STUDY,140.0,s4,1,90,80.0,-1,,1,sell,0,sell,0.5,0,0,0,block 3 (G second),22.0,12.0,Male,1.0,1.0,1.0,"[2, 'block 3 (G second)']",0,0,1,0.5,7.0,-0.30000000000000004,0.5,0.04,,0.16666666666666666,2,0.75,0.5,Design 2,Design 2,"Have an option between Design #1 and Design #2,",2.0,,
1789,3333,2,Player object (930),sell,2023-03-09 03:45:55.642453+00:00,"{""priceA"": 65, ""sharesA"": 0, ""secs_since_round_starts"": 301, ""market"": ""A""}",140.0,49.0,10.0,leux5m59,vmu7c279,FULL STUDY,140.0,s4,1,65,90.0,1,-25.0,1,buy,0,sell,0.5,0,0,1,block 3 (G second),22.0,12.0,Male,1.0,1.0,1.0,"[2, 'block 3 (G second)']",0,0,1,0.5,7.0,-0.30000000000000004,0.5,0.04,,0.16666666666666666,2,0.75,0.5,Design 2,Design 2,"Have an option between Design #1 and Design #2,",2.0,,
1790,3343,3,Player object (1050),sell,2023-03-09 03:47:47.064088+00:00,"{""priceA"": 110, ""sharesA"": 0, ""secs_since_round_starts"": 45, ""market"": ""A""}",160.0,6.0,1.0,leux5m59,vmu7c279,FULL STUDY,190.0,s4,1,110,,1,,1,,0,sell,0.5,0,0,0,block 3 (G second),22.0,12.0,Male,1.0,1.0,1.0,"[3, 'block 3 (G second)']",0,1,1,0.0,7.0,-0.30000000000000004,0.36363636363636365,0.06666666666666667,0.6666666666666666,0.0,4,0.75,1.0,Design 2,Design 2,"Have an option between Design #1 and Design #2,",2.0,,
1791,3344,3,Player object (1050),buy,2023-03-09 03:48:24.550937+00:00,"{""priceA"": 125, ""sharesA"": 1, ""secs_since_round_starts"": 83, ""market"": ""A""}",35.0,13.0,2.0,leux5m59,vmu7c279,FULL STUDY,190.0,s4,1,125,110.0,-1,,1,sell,0,sell,0.5,0,0,0,block 3 (G second),22.0,12.0,Male,1.0,1.0,1.0,"[3, 'block 3 (G second)']",0,1,1,0.0,7.0,-0.30000000000000004,0.36363636363636365,0.06666666666666667,0.6666666666666666,0.0,4,0.75,1.0,Design 2,Design 2,"Have an option between Design #1 and Design #2,",2.0,,
1792,3345,3,Player object (1050),sell,2023-03-09 03:48:28.242181+00:00,"{""priceA"": 135, ""sharesA"": 0, ""secs_since_round_starts"": 86, ""market"": ""A""}",170.0,14.0,3.0,leux5m59,vmu7c279,FULL STUDY,190.0,s4,1,135,125.0,1,10.0,1,buy,0,sell,0.5,0,0,0,block 3 (G second),22.0,12.0,Male,1.0,1.0,1.0,"[3, 'block 3 (G second)']",0,1,1,0.0,7.0,-0.30000000000000004,0.36363636363636365,0.06666666666666667,0.6666666666666666,0.0,4,0.75,1.0,Design 2,Design 2,"Have an option between Design #1 and Design #2,",2.0,,
1793,3349,3,Player object (1050),buy,2023-03-09 03:48:44.730264+00:00,"{""priceA"": 155, ""sharesA"": 1, ""secs_since_round_starts"": 103, ""market"": ""A""}",15.0,17.0,5.0,leux5m59,vmu7c279,FULL STUDY,190.0,s4,1,155,160.0,-1,,1,sell,0,sell,0.5,0,0,0,block 3 (G second),22.0,12.0,Male,1.0,1.0,1.0,"[3, 'block 3 (G second)']",0,1,1,0.0,7.0,-0.30000000000000004,0.36363636363636365,0.06666666666666667,0.6666666666666666,0.0,4,0.75,1.0,Design 2,Design 2,"Have an option between Design #1 and Design #2,",2.0,,
1794,3354,3,Player object (1050),sell,2023-03-09 03:49:03.469046+00:00,"{""priceA"": 135, ""sharesA"": 0, ""secs_since_round_starts"": 122, ""market"": ""A""}",150.0,20.0,7.0,leux5m59,vmu7c279,FULL STUDY,190.0,s4,1,135,150.0,1,-15.0,1,buy,0,sell,0.5,0,0,0,block 3 (G second),22.0,12.0,Male,1.0,1.0,1.0,"[3, 'block 3 (G second)']",0,1,1,0.0,7.0,-0.30000000000000004,0.36363636363636365,0.06666666666666667,0.6666666666666666,0.0,4,0.75,1.0,Design 2,Design 2,"Have an option between Design #1 and Design #2,",2.0,,
1795,3355,3,Player object (1050),buy,2023-03-09 03:49:07.245924+00:00,"{""priceA"": 130, ""sharesA"": 1, ""secs_since_round_starts"": 125, ""market"": ""A""}",20.0,21.0,8.0,leux5m59,vmu7c279,FULL STUDY,190.0,s4,1,130,135.0,-1,,1,sell,0,sell,0.5,0,1,0,block 3 (G second),22.0,12.0,Male,1.0,1.0,1.0,"[3, 'block 3 (G second)']",0,1,1,0.0,7.0,-0.30000000000000004,0.36363636363636365,0.06666666666666667,0.6666666666666666,0.0,4,0.75,1.0,Design 2,Design 2,"Have an option between Design #1 and Design #2,",2.0,,
1796,3357,3,Player object (1050),sell,2023-03-09 03:49:30.480510+00:00,"{""priceA"": 155, ""sharesA"": 0, ""secs_since_round_starts"": 149, ""market"": ""A""}",175.0,25.0,9.0,leux5m59,vmu7c279,FULL STUDY,190.0,s4,1,155,130.0,1,25.0,1,buy,0,sell,0.5,0,0,1,block 3 (G second),22.0,12.0,Male,1.0,1.0,1.0,"[3, 'block 3 (G second)']",0,1,1,0.0,7.0,-0.30000000000000004,0.36363636363636365,0.06666666666666667,0.6666666666666666,0.0,4,0.75,1.0,Design 2,Design 2,"Have an option between Design #1 and Design #2,",2.0,,
1797,3360,3,Player object (1050),buy,2023-03-09 03:49:45.160926+00:00,"{""priceA"": 150, ""sharesA"": 1, ""secs_since_round_starts"": 163, ""market"": ""A""}",25.0,28.0,10.0,leux5m59,vmu7c279,FULL STUDY,190.0,s4,1,150,155.0,-1,,1,sell,0,sell,0.5,0,0,0,block 3 (G second),22.0,12.0,Male,1.0,1.0,1.0,"[3, 'block 3 (G second)']",0,1,1,0.0,7.0,-0.30000000000000004,0.36363636363636365,0.06666666666666667,0.6666666666666666,0.0,4,0.75,1.0,Design 2,Design 2,"Have an option between Design #1 and Design #2,",2.0,,
1798,3365,3,Player object (1050),sell,2023-03-09 03:51:25.443714+00:00,"{""priceA"": 155, ""sharesA"": 0, ""secs_since_round_starts"": 264, ""market"": ""A""}",180.0,46.0,11.0,leux5m59,vmu7c279,FULL STUDY,190.0,s4,1,155,150.0,1,5.0,1,buy,0,sell,0.5,0,0,1,block 3 (G second),22.0,12.0,Male,1.0,1.0,1.0,"[3, 'block 3 (G second)']",0,1,1,0.0,7.0,-0.30000000000000004,0.36363636363636365,0.06666666666666667,0.6666666666666666,0.0,4,0.75,1.0,Design 2,Design 2,"Have an option between Design #1 and Design #2,",2.0,,
1799,3372,3,Player object (1050),buy,2023-03-09 03:52:28.627804+00:00,"{""priceA"": 170, ""sharesA"": 1, ""secs_since_round_starts"": 327, ""market"": ""A""}",10.0,57.0,12.0,leux5m59,vmu7c279,FULL STUDY,190.0,s4,1,170,155.0,-1,,1,sell,0,sell,0.5,0,0,0,block 3 (G second),22.0,12.0,Male,1.0,1.0,1.0,"[3, 'block 3 (G second)']",0,1,1,0.0,7.0,-0.30000000000000004,0.36363636363636365,0.06666666666666667,0.6666666666666666,0.0,4,0.75,1.0,Design 2,Design 2,"Have an option between Design #1 and Design #2,",2.0,,
1800,3378,4,Player object (1170),sell,2023-03-09 03:53:16.024036+00:00,"{""priceA"": 125, ""sharesA"": 0, ""secs_since_round_starts"": 26, ""market"": ""A""}",175.0,6.0,1.0,leux5m59,vmu7c279,FULL STUDY,100.0,s4,1,125,,1,,1,,0,sell,0.5,0,0,0,block 3 (G second),22.0,12.0,Male,1.0,1.0,1.0,"[4, 'block 3 (G second)']",1,0,1,0.5,7.0,-0.30000000000000004,0.5,0.047619047619047616,,0.2,1,0.5,1.0,Design 2,Design 2,"Have an option between Design #1 and Design #2,",2.0,,
1801,3379,4,Player object (1170),buy,2023-03-09 03:53:19.833213+00:00,"{""priceA"": 140, ""sharesA"": 1, ""secs_since_round_starts"": 30, ""market"": ""A""}",35.0,7.0,2.0,leux5m59,vmu7c279,FULL STUDY,100.0,s4,1,140,125.0,-1,,1,sell,0,sell,0.5,0,0,0,block 3 (G second),22.0,12.0,Male,1.0,1.0,1.0,"[4, 'block 3 (G second)']",1,0,1,0.5,7.0,-0.30000000000000004,0.5,0.047619047619047616,,0.2,1,0.5,1.0,Design 2,Design 2,"Have an option between Design #1 and Design #2,",2.0,,
1802,3384,4,Player object (1170),sell,2023-03-09 03:55:21.326968+00:00,"{""priceA"": 65, ""sharesA"": 0, ""secs_since_round_starts"": 152, ""market"": ""A""}",100.0,29.0,5.0,leux5m59,vmu7c279,FULL STUDY,100.0,s4,1,65,85.0,1,-20.0,1,buy,0,sell,0.5,0,0,1,block 3 (G second),22.0,12.0,Male,1.0,1.0,1.0,"[4, 'block 3 (G second)']",1,0,1,0.5,7.0,-0.30000000000000004,0.5,0.047619047619047616,,0.2,1,0.5,1.0,Design 2,Design 2,"Have an option between Design #1 and Design #2,",2.0,,
1803,3389,5,Player object (1290),sell,2023-03-09 03:59:21.703047+00:00,"{""priceA"": 135, ""sharesA"": 0, ""secs_since_round_starts"": 63, ""market"": ""A""}",185.0,13.0,1.0,leux5m59,vmu7c279,FULL STUDY,145.0,s4,1,135,,1,,1,,0,sell,0.5,0,0,0,block 3 (G second),22.0,12.0,Male,1.0,1.0,1.0,"[5, 'block 3 (G second)']",1,1,1,1.0,7.0,-0.30000000000000004,0.125,0.13636363636363635,0.0,0.0,4,0.75,1.0,Design 2,Design 2,"Have an option between Design #1 and Design #2,",2.0,,
1804,3390,5,Player object (1290),buy,2023-03-09 03:59:45.276478+00:00,"{""priceA"": 125, ""sharesA"": 1, ""secs_since_round_starts"": 87, ""market"": ""A""}",60.0,17.0,2.0,leux5m59,vmu7c279,FULL STUDY,145.0,s4,1,125,135.0,-1,,1,sell,0,sell,0.5,0,0,0,block 3 (G second),22.0,12.0,Male,1.0,1.0,1.0,"[5, 'block 3 (G second)']",1,1,1,1.0,7.0,-0.30000000000000004,0.125,0.13636363636363635,0.0,0.0,4,0.75,1.0,Design 2,Design 2,"Have an option between Design #1 and Design #2,",2.0,,
1805,3391,5,Player object (1290),sell,2023-03-09 03:59:57.040771+00:00,"{""priceA"": 100, ""sharesA"": 0, ""secs_since_round_starts"": 99, ""market"": ""A""}",160.0,19.0,3.0,leux5m59,vmu7c279,FULL STUDY,145.0,s4,1,100,125.0,1,-25.0,1,buy,0,sell,0.5,0,0,0,block 3 (G second),22.0,12.0,Male,1.0,1.0,1.0,"[5, 'block 3 (G second)']",1,1,1,1.0,7.0,-0.30000000000000004,0.125,0.13636363636363635,0.0,0.0,4,0.75,1.0,Design 2,Design 2,"Have an option between Design #1 and Design #2,",2.0,,
1806,3392,5,Player object (1290),buy,2023-03-09 03:59:57.321328+00:00,"{""priceA"": 115, ""sharesA"": 1, ""secs_since_round_starts"": 99, ""market"": ""A""}",45.0,20.0,4.0,leux5m59,vmu7c279,FULL STUDY,145.0,s4,1,115,100.0,-1,,1,sell,0,sell,0.5,0,0,0,block 3 (G second),22.0,12.0,Male,1.0,1.0,1.0,"[5, 'block 3 (G second)']",1,1,1,1.0,7.0,-0.30000000000000004,0.125,0.13636363636363635,0.0,0.0,4,0.75,1.0,Design 2,Design 2,"Have an option between Design #1 and Design #2,",2.0,,
1807,3393,5,Player object (1290),sell,2023-03-09 04:00:22.872865+00:00,"{""priceA"": 155, ""sharesA"": 0, ""secs_since_round_starts"": 125, ""market"": ""A""}",200.0,24.0,5.0,leux5m59,vmu7c279,FULL STUDY,145.0,s4,1,155,115.0,1,40.0,1,buy,0,sell,0.5,0,0,0,block 3 (G second),22.0,12.0,Male,1.0,1.0,1.0,"[5, 'block 3 (G second)']",1,1,1,1.0,7.0,-0.30000000000000004,0.125,0.13636363636363635,0.0,0.0,4,0.75,1.0,Design 2,Design 2,"Have an option between Design #1 and Design #2,",2.0,,
1808,3394,5,Player object (1290),buy,2023-03-09 04:00:47.989751+00:00,"{""priceA"": 135, ""sharesA"": 1, ""secs_since_round_starts"": 150, ""market"": ""A""}",65.0,29.0,6.0,leux5m59,vmu7c279,FULL STUDY,145.0,s4,1,135,155.0,-1,,1,sell,0,sell,0.5,0,0,0,block 3 (G second),22.0,12.0,Male,1.0,1.0,1.0,"[5, 'block 3 (G second)']",1,1,1,1.0,7.0,-0.30000000000000004,0.125,0.13636363636363635,0.0,0.0,4,0.75,1.0,Design 2,Design 2,"Have an option between Design #1 and Design #2,",2.0,,
1809,3396,5,Player object (1290),sell,2023-03-09 04:01:12.955085+00:00,"{""priceA"": 125, ""sharesA"": 0, ""secs_since_round_starts"": 175, ""market"": ""A""}",190.0,33.0,7.0,leux5m59,vmu7c279,FULL STUDY,145.0,s4,1,125,135.0,1,-10.0,1,buy,0,sell,0.5,0,0,0,block 3 (G second),22.0,12.0,Male,1.0,1.0,1.0,"[5, 'block 3 (G second)']",1,1,1,1.0,7.0,-0.30000000000000004,0.125,0.13636363636363635,0.0,0.0,4,0.75,1.0,Design 2,Design 2,"Have an option between Design #1 and Design #2,",2.0,,
1810,3397,5,Player object (1290),buy,2023-03-09 04:01:39.147949+00:00,"{""priceA"": 130, ""sharesA"": 1, ""secs_since_round_starts"": 201, ""market"": ""A""}",60.0,38.0,8.0,leux5m59,vmu7c279,FULL STUDY,145.0,s4,1,130,125.0,-1,,1,sell,0,sell,0.5,0,0,0,block 3 (G second),22.0,12.0,Male,1.0,1.0,1.0,"[5, 'block 3 (G second)']",1,1,1,1.0,7.0,-0.30000000000000004,0.125,0.13636363636363635,0.0,0.0,4,0.75,1.0,Design 2,Design 2,"Have an option between Design #1 and Design #2,",2.0,,
1811,3398,5,Player object (1290),sell,2023-03-09 04:02:07.459429+00:00,"{""priceA"": 115, ""sharesA"": 0, ""secs_since_round_starts"": 229, ""market"": ""A""}",175.0,43.0,9.0,leux5m59,vmu7c279,FULL STUDY,145.0,s4,1,115,130.0,1,-15.0,1,buy,0,sell,0.5,0,0,0,block 3 (G second),22.0,12.0,Male,1.0,1.0,1.0,"[5, 'block 3 (G second)']",1,1,1,1.0,7.0,-0.30000000000000004,0.125,0.13636363636363635,0.0,0.0,4,0.75,1.0,Design 2,Design 2,"Have an option between Design #1 and Design #2,",2.0,,
1812,3399,5,Player object (1290),buy,2023-03-09 04:02:12.208892+00:00,"{""priceA"": 125, ""sharesA"": 1, ""secs_since_round_starts"": 234, ""market"": ""A""}",50.0,44.0,10.0,leux5m59,vmu7c279,FULL STUDY,145.0,s4,1,125,115.0,-1,,1,sell,0,sell,0.5,0,0,0,block 3 (G second),22.0,12.0,Male,1.0,1.0,1.0,"[5, 'block 3 (G second)']",1,1,1,1.0,7.0,-0.30000000000000004,0.125,0.13636363636363635,0.0,0.0,4,0.75,1.0,Design 2,Design 2,"Have an option between Design #1 and Design #2,",2.0,,
1813,3918,2,Player object (940),sell,2023-03-09 19:59:00.308690+00:00,"{""priceA"": 85, ""sharesA"": 0, ""secs_since_round_starts"": 39, ""market"": ""A""}",135.0,8.0,1.0,lw8audd5,vmu7c279,FULL STUDY,130.0,s2,1,85,,1,,1,,0,sell,0.4422758127435268,16,1,0,block 1 (G first),23.0,12.0,Male,1.0,1.0,0.0,"[2, 'block 1 (G first)']",1,0,0,0.5,7.0,-0.30000000000000004,0.2222222222222222,0.16666666666666666,0.0,0.2857142857142857,4,1.0,0.5,Design 1,Design 1,"Have an option between Design #1 and Design #2,",4.0,,
1814,3921,2,Player object (940),buy,2023-03-09 19:59:12.707245+00:00,"{""priceA"": 75, ""sharesA"": 1, ""secs_since_round_starts"": 52, ""market"": ""A""}",60.0,10.0,2.0,lw8audd5,vmu7c279,FULL STUDY,130.0,s2,1,75,85.0,-1,,1,sell,0,sell,0.4825575314143953,16,0,0,block 1 (G first),23.0,12.0,Male,1.0,1.0,0.0,"[2, 'block 1 (G first)']",1,0,0,0.5,7.0,-0.30000000000000004,0.2222222222222222,0.16666666666666666,0.0,0.2857142857142857,4,1.0,0.5,Design 1,Design 1,"Have an option between Design #1 and Design #2,",4.0,,
1815,3922,2,Player object (940),sell,2023-03-09 19:59:15.961207+00:00,"{""priceA"": 65, ""sharesA"": 0, ""secs_since_round_starts"": 55, ""market"": ""A""}",125.0,11.0,3.0,lw8audd5,vmu7c279,FULL STUDY,130.0,s2,1,65,75.0,1,-10.0,1,buy,0,sell,0.4529543903039196,16,0,0,block 1 (G first),23.0,12.0,Male,1.0,1.0,0.0,"[2, 'block 1 (G first)']",1,0,0,0.5,7.0,-0.30000000000000004,0.2222222222222222,0.16666666666666666,0.0,0.2857142857142857,4,1.0,0.5,Design 1,Design 1,"Have an option between Design #1 and Design #2,",4.0,,
1816,3923,2,Player object (940),buy,2023-03-09 19:59:26.368270+00:00,"{""priceA"": 90, ""sharesA"": 1, ""secs_since_round_starts"": 65, ""market"": ""A""}",35.0,13.0,4.0,lw8audd5,vmu7c279,FULL STUDY,130.0,s2,1,90,65.0,-1,,1,sell,0,sell,0.5364461838942041,16,0,0,block 1 (G first),23.0,12.0,Male,1.0,1.0,0.0,"[2, 'block 1 (G first)']",1,0,0,0.5,7.0,-0.30000000000000004,0.2222222222222222,0.16666666666666666,0.0,0.2857142857142857,4,1.0,0.5,Design 1,Design 1,"Have an option between Design #1 and Design #2,",4.0,,
1817,3925,2,Player object (940),sell,2023-03-09 19:59:40.902415+00:00,"{""priceA"": 120, ""sharesA"": 0, ""secs_since_round_starts"": 80, ""market"": ""A""}",155.0,15.0,5.0,lw8audd5,vmu7c279,FULL STUDY,130.0,s2,1,120,90.0,1,30.0,1,buy,0,sell,0.5761373211134116,16,0,0,block 1 (G first),23.0,12.0,Male,1.0,1.0,0.0,"[2, 'block 1 (G first)']",1,0,0,0.5,7.0,-0.30000000000000004,0.2222222222222222,0.16666666666666666,0.0,0.2857142857142857,4,1.0,0.5,Design 1,Design 1,"Have an option between Design #1 and Design #2,",4.0,,
1818,3928,2,Player object (940),buy,2023-03-09 20:00:35.104696+00:00,"{""priceA"": 145, ""sharesA"": 1, ""secs_since_round_starts"": 134, ""market"": ""A""}",10.0,25.0,6.0,lw8audd5,vmu7c279,FULL STUDY,130.0,s2,1,145,120.0,-1,,1,sell,0,sell,0.5294358264188312,16,0,0,block 1 (G first),23.0,12.0,Male,1.0,1.0,0.0,"[2, 'block 1 (G first)']",1,0,0,0.5,7.0,-0.30000000000000004,0.2222222222222222,0.16666666666666666,0.0,0.2857142857142857,4,1.0,0.5,Design 1,Design 1,"Have an option between Design #1 and Design #2,",4.0,,
1819,3929,2,Player object (940),sell,2023-03-09 20:00:43.026794+00:00,"{""priceA"": 125, ""sharesA"": 0, ""secs_since_round_starts"": 142, ""market"": ""A""}",135.0,27.0,7.0,lw8audd5,vmu7c279,FULL STUDY,130.0,s2,1,125,145.0,1,-20.0,1,buy,0,sell,0.4549942201992644,16,1,0,block 1 (G first),23.0,12.0,Male,1.0,1.0,0.0,"[2, 'block 1 (G first)']",1,0,0,0.5,7.0,-0.30000000000000004,0.2222222222222222,0.16666666666666666,0.0,0.2857142857142857,4,1.0,0.5,Design 1,Design 1,"Have an option between Design #1 and Design #2,",4.0,,
1820,3931,2,Player object (940),buy,2023-03-09 20:00:50.226239+00:00,"{""priceA"": 120, ""sharesA"": 1, ""secs_since_round_starts"": 149, ""market"": ""A""}",15.0,28.0,8.0,lw8audd5,vmu7c279,FULL STUDY,130.0,s2,1,120,125.0,-1,,1,sell,0,sell,0.4340892272841542,16,0,0,block 1 (G first),23.0,12.0,Male,1.0,1.0,0.0,"[2, 'block 1 (G first)']",1,0,0,0.5,7.0,-0.30000000000000004,0.2222222222222222,0.16666666666666666,0.0,0.2857142857142857,4,1.0,0.5,Design 1,Design 1,"Have an option between Design #1 and Design #2,",4.0,,
1821,3934,2,Player object (940),sell,2023-03-09 20:01:26.422652+00:00,"{""priceA"": 130, ""sharesA"": 0, ""secs_since_round_starts"": 185, ""market"": ""A""}",145.0,33.0,9.0,lw8audd5,vmu7c279,FULL STUDY,130.0,s2,1,130,120.0,1,10.0,1,buy,0,sell,0.499206602391208,16,0,0,block 1 (G first),23.0,12.0,Male,1.0,1.0,0.0,"[2, 'block 1 (G first)']",1,0,0,0.5,7.0,-0.30000000000000004,0.2222222222222222,0.16666666666666666,0.0,0.2857142857142857,4,1.0,0.5,Design 1,Design 1,"Have an option between Design #1 and Design #2,",4.0,,
1822,3936,2,Player object (940),buy,2023-03-09 20:01:55.680473+00:00,"{""priceA"": 140, ""sharesA"": 1, ""secs_since_round_starts"": 215, ""market"": ""A""}",5.0,38.0,10.0,lw8audd5,vmu7c279,FULL STUDY,130.0,s2,1,140,130.0,-1,,1,sell,0,sell,0.4611129934091434,16,0,0,block 1 (G first),23.0,12.0,Male,1.0,1.0,0.0,"[2, 'block 1 (G first)']",1,0,0,0.5,7.0,-0.30000000000000004,0.2222222222222222,0.16666666666666666,0.0,0.2857142857142857,4,1.0,0.5,Design 1,Design 1,"Have an option between Design #1 and Design #2,",4.0,,
1823,3940,2,Player object (940),sell,2023-03-09 20:02:34.479594+00:00,"{""priceA"": 140, ""sharesA"": 0, ""secs_since_round_starts"": 253, ""market"": ""A""}",145.0,45.0,11.0,lw8audd5,vmu7c279,FULL STUDY,130.0,s2,1,140,140.0,1,0.0,1,buy,0,sell,0.5210834711709403,16,0,0,block 1 (G first),23.0,12.0,Male,1.0,1.0,0.0,"[2, 'block 1 (G first)']",1,0,0,0.5,7.0,-0.30000000000000004,0.2222222222222222,0.16666666666666666,0.0,0.2857142857142857,4,1.0,0.5,Design 1,Design 1,"Have an option between Design #1 and Design #2,",4.0,,
1824,3942,2,Player object (940),buy,2023-03-09 20:03:05.428477+00:00,"{""priceA"": 140, ""sharesA"": 1, ""secs_since_round_starts"": 284, ""market"": ""A""}",5.0,51.0,12.0,lw8audd5,vmu7c279,FULL STUDY,130.0,s2,1,140,140.0,-1,,1,sell,0,sell,0.4693918893964308,16,0,0,block 1 (G first),23.0,12.0,Male,1.0,1.0,0.0,"[2, 'block 1 (G first)']",1,0,0,0.5,7.0,-0.30000000000000004,0.2222222222222222,0.16666666666666666,0.0,0.2857142857142857,4,1.0,0.5,Design 1,Design 1,"Have an option between Design #1 and Design #2,",4.0,,
1825,3950,3,Player object (1060),sell,2023-03-09 20:04:37.490423+00:00,"{""priceA"": 90, ""sharesA"": 0, ""secs_since_round_starts"": 35, ""market"": ""A""}",140.0,7.0,1.0,lw8audd5,vmu7c279,FULL STUDY,240.0,s2,1,90,,1,,1,,0,sell,0.4580966810292103,19,0,0,block 1 (G first),23.0,12.0,Male,1.0,1.0,0.0,"[3, 'block 1 (G first)']",1,1,0,1.0,7.0,-0.30000000000000004,0.375,0.16666666666666666,,0.0,5,0.75,0.5,Design 1,Design 1,"Have an option between Design #1 and Design #2,",4.0,,
1826,3951,3,Player object (1060),buy,2023-03-09 20:04:42.144541+00:00,"{""priceA"": 100, ""sharesA"": 1, ""secs_since_round_starts"": 40, ""market"": ""A""}",40.0,8.0,2.0,lw8audd5,vmu7c279,FULL STUDY,240.0,s2,1,100,90.0,-1,,1,sell,0,sell,0.5057155770500936,19,0,0,block 1 (G first),23.0,12.0,Male,1.0,1.0,0.0,"[3, 'block 1 (G first)']",1,1,0,1.0,7.0,-0.30000000000000004,0.375,0.16666666666666666,,0.0,5,0.75,0.5,Design 1,Design 1,"Have an option between Design #1 and Design #2,",4.0,,
1827,3952,3,Player object (1060),sell,2023-03-09 20:04:57.219647+00:00,"{""priceA"": 110, ""sharesA"": 0, ""secs_since_round_starts"": 55, ""market"": ""A""}",150.0,11.0,3.0,lw8audd5,vmu7c279,FULL STUDY,240.0,s2,1,110,100.0,1,10.0,1,buy,0,sell,0.5295922419004607,19,0,0,block 1 (G first),23.0,12.0,Male,1.0,1.0,0.0,"[3, 'block 1 (G first)']",1,1,0,1.0,7.0,-0.30000000000000004,0.375,0.16666666666666666,,0.0,5,0.75,0.5,Design 1,Design 1,"Have an option between Design #1 and Design #2,",4.0,,
1828,3954,3,Player object (1060),buy,2023-03-09 20:05:26.630633+00:00,"{""priceA"": 100, ""sharesA"": 1, ""secs_since_round_starts"": 85, ""market"": ""A""}",50.0,16.0,4.0,lw8audd5,vmu7c279,FULL STUDY,240.0,s2,1,100,110.0,-1,,1,sell,0,sell,0.4486815727575955,19,1,0,block 1 (G first),23.0,12.0,Male,1.0,1.0,0.0,"[3, 'block 1 (G first)']",1,1,0,1.0,7.0,-0.30000000000000004,0.375,0.16666666666666666,,0.0,5,0.75,0.5,Design 1,Design 1,"Have an option between Design #1 and Design #2,",4.0,,
1829,3955,3,Player object (1060),sell,2023-03-09 20:05:31.121308+00:00,"{""priceA"": 105, ""sharesA"": 0, ""secs_since_round_starts"": 89, ""market"": ""A""}",155.0,17.0,5.0,lw8audd5,vmu7c279,FULL STUDY,240.0,s2,1,105,100.0,1,5.0,1,buy,0,sell,0.4990675303551922,19,0,0,block 1 (G first),23.0,12.0,Male,1.0,1.0,0.0,"[3, 'block 1 (G first)']",1,1,0,1.0,7.0,-0.30000000000000004,0.375,0.16666666666666666,,0.0,5,0.75,0.5,Design 1,Design 1,"Have an option between Design #1 and Design #2,",4.0,,
1830,3957,3,Player object (1060),buy,2023-03-09 20:05:51.226336+00:00,"{""priceA"": 100, ""sharesA"": 1, ""secs_since_round_starts"": 109, ""market"": ""A""}",55.0,21.0,6.0,lw8audd5,vmu7c279,FULL STUDY,240.0,s2,1,100,105.0,-1,,1,sell,0,sell,0.4692484881524699,19,0,0,block 1 (G first),23.0,12.0,Male,1.0,1.0,0.0,"[3, 'block 1 (G first)']",1,1,0,1.0,7.0,-0.30000000000000004,0.375,0.16666666666666666,,0.0,5,0.75,0.5,Design 1,Design 1,"Have an option between Design #1 and Design #2,",4.0,,
1831,3959,3,Player object (1060),sell,2023-03-09 20:06:13.002107+00:00,"{""priceA"": 110, ""sharesA"": 0, ""secs_since_round_starts"": 131, ""market"": ""A""}",165.0,25.0,7.0,lw8audd5,vmu7c279,FULL STUDY,240.0,s2,1,110,100.0,1,10.0,1,buy,0,sell,0.4872943409941583,19,0,0,block 1 (G first),23.0,12.0,Male,1.0,1.0,0.0,"[3, 'block 1 (G first)']",1,1,0,1.0,7.0,-0.30000000000000004,0.375,0.16666666666666666,,0.0,5,0.75,0.5,Design 1,Design 1,"Have an option between Design #1 and Design #2,",4.0,,
1832,3962,3,Player object (1060),buy,2023-03-09 20:06:57.134766+00:00,"{""priceA"": 100, ""sharesA"": 1, ""secs_since_round_starts"": 175, ""market"": ""A""}",65.0,33.0,8.0,lw8audd5,vmu7c279,FULL STUDY,240.0,s2,1,100,110.0,-1,,1,sell,0,sell,0.4476889957041811,19,1,0,block 1 (G first),23.0,12.0,Male,1.0,1.0,0.0,"[3, 'block 1 (G first)']",1,1,0,1.0,7.0,-0.30000000000000004,0.375,0.16666666666666666,,0.0,5,0.75,0.5,Design 1,Design 1,"Have an option between Design #1 and Design #2,",4.0,,
1833,3964,3,Player object (1060),sell,2023-03-09 20:07:33.787196+00:00,"{""priceA"": 115, ""sharesA"": 0, ""secs_since_round_starts"": 212, ""market"": ""A""}",180.0,39.0,9.0,lw8audd5,vmu7c279,FULL STUDY,240.0,s2,1,115,100.0,1,15.0,1,buy,0,sell,0.5221490272476892,19,0,0,block 1 (G first),23.0,12.0,Male,1.0,1.0,0.0,"[3, 'block 1 (G first)']",1,1,0,1.0,7.0,-0.30000000000000004,0.375,0.16666666666666666,,0.0,5,0.75,0.5,Design 1,Design 1,"Have an option between Design #1 and Design #2,",4.0,,
1834,3966,3,Player object (1060),buy,2023-03-09 20:07:40.724421+00:00,"{""priceA"": 95, ""sharesA"": 1, ""secs_since_round_starts"": 219, ""market"": ""A""}",85.0,41.0,10.0,lw8audd5,vmu7c279,FULL STUDY,240.0,s2,1,95,115.0,-1,,1,sell,0,sell,0.4514823197003955,19,0,0,block 1 (G first),23.0,12.0,Male,1.0,1.0,0.0,"[3, 'block 1 (G first)']",1,1,0,1.0,7.0,-0.30000000000000004,0.375,0.16666666666666666,,0.0,5,0.75,0.5,Design 1,Design 1,"Have an option between Design #1 and Design #2,",4.0,,
1835,3967,3,Player object (1060),sell,2023-03-09 20:07:52.832946+00:00,"{""priceA"": 120, ""sharesA"": 0, ""secs_since_round_starts"": 231, ""market"": ""A""}",205.0,43.0,11.0,lw8audd5,vmu7c279,FULL STUDY,240.0,s2,1,120,95.0,1,25.0,1,buy,0,sell,0.5357259670782416,19,0,0,block 1 (G first),23.0,12.0,Male,1.0,1.0,0.0,"[3, 'block 1 (G first)']",1,1,0,1.0,7.0,-0.30000000000000004,0.375,0.16666666666666666,,0.0,5,0.75,0.5,Design 1,Design 1,"Have an option between Design #1 and Design #2,",4.0,,
1836,3970,3,Player object (1060),buy,2023-03-09 20:08:25.247025+00:00,"{""priceA"": 110, ""sharesA"": 1, ""secs_since_round_starts"": 263, ""market"": ""A""}",95.0,49.0,12.0,lw8audd5,vmu7c279,FULL STUDY,240.0,s2,1,110,120.0,-1,,1,sell,0,sell,0.4374794566672981,19,1,0,block 1 (G first),23.0,12.0,Male,1.0,1.0,0.0,"[3, 'block 1 (G first)']",1,1,0,1.0,7.0,-0.30000000000000004,0.375,0.16666666666666666,,0.0,5,0.75,0.5,Design 1,Design 1,"Have an option between Design #1 and Design #2,",4.0,,
1837,3973,3,Player object (1060),sell,2023-03-09 20:08:53.616027+00:00,"{""priceA"": 145, ""sharesA"": 0, ""secs_since_round_starts"": 291, ""market"": ""A""}",240.0,54.0,13.0,lw8audd5,vmu7c279,FULL STUDY,240.0,s2,1,145,110.0,1,35.0,1,buy,0,sell,0.52846438705912,19,0,0,block 1 (G first),23.0,12.0,Male,1.0,1.0,0.0,"[3, 'block 1 (G first)']",1,1,0,1.0,7.0,-0.30000000000000004,0.375,0.16666666666666666,,0.0,5,0.75,0.5,Design 1,Design 1,"Have an option between Design #1 and Design #2,",4.0,,
1838,3976,3,Player object (1060),buy,2023-03-09 20:09:14.698855+00:00,"{""priceA"": 115, ""sharesA"": 1, ""secs_since_round_starts"": 313, ""market"": ""A""}",125.0,58.0,14.0,lw8audd5,vmu7c279,FULL STUDY,240.0,s2,1,115,145.0,-1,,1,sell,0,sell,0.442461876115205,19,1,0,block 1 (G first),23.0,12.0,Male,1.0,1.0,0.0,"[3, 'block 1 (G first)']",1,1,0,1.0,7.0,-0.30000000000000004,0.375,0.16666666666666666,,0.0,5,0.75,0.5,Design 1,Design 1,"Have an option between Design #1 and Design #2,",4.0,,
1839,3977,3,Player object (1060),sell,2023-03-09 20:09:29.443498+00:00,"{""priceA"": 115, ""sharesA"": 0, ""secs_since_round_starts"": 327, ""market"": ""A""}",240.0,60.0,15.0,lw8audd5,vmu7c279,FULL STUDY,240.0,s2,1,115,115.0,1,0.0,1,buy,0,sell,0.4613046310449969,19,0,0,block 1 (G first),23.0,12.0,Male,1.0,1.0,0.0,"[3, 'block 1 (G first)']",1,1,0,1.0,7.0,-0.30000000000000004,0.375,0.16666666666666666,,0.0,5,0.75,0.5,Design 1,Design 1,"Have an option between Design #1 and Design #2,",4.0,,
1840,3981,4,Player object (1180),sell,2023-03-09 20:10:14.727728+00:00,"{""priceA"": 70, ""sharesA"": 0, ""secs_since_round_starts"": 42, ""market"": ""A""}",120.0,9.0,1.0,lw8audd5,vmu7c279,FULL STUDY,145.0,s2,1,70,,1,,1,,0,sell,0.5440818519127735,14,0,1,block 1 (G first),23.0,12.0,Male,1.0,1.0,0.0,"[4, 'block 1 (G first)']",0,0,0,1.0,7.0,-0.30000000000000004,0.6,0.14285714285714285,1.0,0.25,2,1.0,0.75,Design 1,Design 1,"Have an option between Design #1 and Design #2,",4.0,,
1841,3982,4,Player object (1180),buy,2023-03-09 20:10:46.350658+00:00,"{""priceA"": 95, ""sharesA"": 1, ""secs_since_round_starts"": 74, ""market"": ""A""}",25.0,15.0,2.0,lw8audd5,vmu7c279,FULL STUDY,145.0,s2,1,95,70.0,-1,,1,sell,0,sell,0.5493972040799432,14,0,0,block 1 (G first),23.0,12.0,Male,1.0,1.0,0.0,"[4, 'block 1 (G first)']",0,0,0,1.0,7.0,-0.30000000000000004,0.6,0.14285714285714285,1.0,0.25,2,1.0,0.75,Design 1,Design 1,"Have an option between Design #1 and Design #2,",4.0,,
1842,3986,4,Player object (1180),sell,2023-03-09 20:12:03.118952+00:00,"{""priceA"": 90, ""sharesA"": 0, ""secs_since_round_starts"": 151, ""market"": ""A""}",115.0,29.0,3.0,lw8audd5,vmu7c279,FULL STUDY,145.0,s2,1,90,95.0,1,-5.0,1,buy,0,sell,0.5712793841154561,14,0,0,block 1 (G first),23.0,12.0,Male,1.0,1.0,0.0,"[4, 'block 1 (G first)']",0,0,0,1.0,7.0,-0.30000000000000004,0.6,0.14285714285714285,1.0,0.25,2,1.0,0.75,Design 1,Design 1,"Have an option between Design #1 and Design #2,",4.0,,
1843,3989,4,Player object (1180),buy,2023-03-09 20:12:42.741633+00:00,"{""priceA"": 85, ""sharesA"": 1, ""secs_since_round_starts"": 190, ""market"": ""A""}",30.0,36.0,4.0,lw8audd5,vmu7c279,FULL STUDY,145.0,s2,1,85,90.0,-1,,1,sell,0,sell,0.4885269486642424,14,0,0,block 1 (G first),23.0,12.0,Male,1.0,1.0,0.0,"[4, 'block 1 (G first)']",0,0,0,1.0,7.0,-0.30000000000000004,0.6,0.14285714285714285,1.0,0.25,2,1.0,0.75,Design 1,Design 1,"Have an option between Design #1 and Design #2,",4.0,,
1844,3990,4,Player object (1180),sell,2023-03-09 20:12:45.899282+00:00,"{""priceA"": 70, ""sharesA"": 0, ""secs_since_round_starts"": 194, ""market"": ""A""}",100.0,37.0,5.0,lw8audd5,vmu7c279,FULL STUDY,145.0,s2,1,70,85.0,1,-15.0,1,buy,0,sell,0.4570673777008929,14,0,0,block 1 (G first),23.0,12.0,Male,1.0,1.0,0.0,"[4, 'block 1 (G first)']",0,0,0,1.0,7.0,-0.30000000000000004,0.6,0.14285714285714285,1.0,0.25,2,1.0,0.75,Design 1,Design 1,"Have an option between Design #1 and Design #2,",4.0,,
1845,3991,4,Player object (1180),buy,2023-03-09 20:12:57.914934+00:00,"{""priceA"": 80, ""sharesA"": 1, ""secs_since_round_starts"": 206, ""market"": ""A""}",20.0,39.0,6.0,lw8audd5,vmu7c279,FULL STUDY,145.0,s2,1,80,70.0,-1,,1,sell,0,sell,0.4897180556691627,14,0,0,block 1 (G first),23.0,12.0,Male,1.0,1.0,0.0,"[4, 'block 1 (G first)']",0,0,0,1.0,7.0,-0.30000000000000004,0.6,0.14285714285714285,1.0,0.25,2,1.0,0.75,Design 1,Design 1,"Have an option between Design #1 and Design #2,",4.0,,
1846,3994,4,Player object (1180),sell,2023-03-09 20:13:13.429362+00:00,"{""priceA"": 95, ""sharesA"": 0, ""secs_since_round_starts"": 221, ""market"": ""A""}",115.0,42.0,8.0,lw8audd5,vmu7c279,FULL STUDY,145.0,s2,1,95,80.0,1,15.0,1,buy,0,sell,0.5388552795609507,14,0,0,block 1 (G first),23.0,12.0,Male,1.0,1.0,0.0,"[4, 'block 1 (G first)']",0,0,0,1.0,7.0,-0.30000000000000004,0.6,0.14285714285714285,1.0,0.25,2,1.0,0.75,Design 1,Design 1,"Have an option between Design #1 and Design #2,",4.0,,
1847,3998,4,Player object (1180),buy,2023-03-09 20:14:14.268479+00:00,"{""priceA"": 75, ""sharesA"": 1, ""secs_since_round_starts"": 282, ""market"": ""A""}",40.0,53.0,9.0,lw8audd5,vmu7c279,FULL STUDY,145.0,s2,1,75,95.0,-1,,1,sell,0,sell,0.4439854633835125,14,1,0,block 1 (G first),23.0,12.0,Male,1.0,1.0,0.0,"[4, 'block 1 (G first)']",0,0,0,1.0,7.0,-0.30000000000000004,0.6,0.14285714285714285,1.0,0.25,2,1.0,0.75,Design 1,Design 1,"Have an option between Design #1 and Design #2,",4.0,,
1848,4000,4,Player object (1180),sell,2023-03-09 20:14:22.869438+00:00,"{""priceA"": 85, ""sharesA"": 0, ""secs_since_round_starts"": 291, ""market"": ""A""}",125.0,54.0,10.0,lw8audd5,vmu7c279,FULL STUDY,145.0,s2,1,85,75.0,1,10.0,1,buy,0,sell,0.4957421237757241,14,0,0,block 1 (G first),23.0,12.0,Male,1.0,1.0,0.0,"[4, 'block 1 (G first)']",0,0,0,1.0,7.0,-0.30000000000000004,0.6,0.14285714285714285,1.0,0.25,2,1.0,0.75,Design 1,Design 1,"Have an option between Design #1 and Design #2,",4.0,,
1849,4001,4,Player object (1180),buy,2023-03-09 20:14:35.877305+00:00,"{""priceA"": 55, ""sharesA"": 1, ""secs_since_round_starts"": 304, ""market"": ""A""}",70.0,57.0,11.0,lw8audd5,vmu7c279,FULL STUDY,145.0,s2,1,55,85.0,-1,,1,sell,0,sell,0.4231688687101841,14,1,0,block 1 (G first),23.0,12.0,Male,1.0,1.0,0.0,"[4, 'block 1 (G first)']",0,0,0,1.0,7.0,-0.30000000000000004,0.6,0.14285714285714285,1.0,0.25,2,1.0,0.75,Design 1,Design 1,"Have an option between Design #1 and Design #2,",4.0,,
1850,4004,4,Player object (1180),sell,2023-03-09 20:14:52.171194+00:00,"{""priceA"": 75, ""sharesA"": 0, ""secs_since_round_starts"": 320, ""market"": ""A""}",145.0,60.0,12.0,lw8audd5,vmu7c279,FULL STUDY,145.0,s2,1,75,55.0,1,20.0,1,buy,0,sell,0.5499940505093152,14,0,1,block 1 (G first),23.0,12.0,Male,1.0,1.0,0.0,"[4, 'block 1 (G first)']",0,0,0,1.0,7.0,-0.30000000000000004,0.6,0.14285714285714285,1.0,0.25,2,1.0,0.75,Design 1,Design 1,"Have an option between Design #1 and Design #2,",4.0,,
1851,4008,5,Player object (1300),sell,2023-03-09 20:15:50.850499+00:00,"{""priceA"": 95, ""sharesA"": 0, ""secs_since_round_starts"": 51, ""market"": ""A""}",145.0,6.0,1.0,lw8audd5,vmu7c279,FULL STUDY,210.0,s2,1,95,,1,,1,,0,sell,0.5560314405213382,17,0,1,block 1 (G first),23.0,12.0,Male,1.0,1.0,0.0,"[5, 'block 1 (G first)']",0,1,0,0.5,7.0,-0.30000000000000004,0.3125,0.23076923076923078,0.6666666666666666,0.5,4,0.5,0.5,Design 1,Design 1,"Have an option between Design #1 and Design #2,",4.0,,
1852,4009,5,Player object (1300),buy,2023-03-09 20:16:11.540319+00:00,"{""priceA"": 75, ""sharesA"": 1, ""secs_since_round_starts"": 72, ""market"": ""A""}",70.0,10.0,2.0,lw8audd5,vmu7c279,FULL STUDY,210.0,s2,1,75,95.0,-1,,1,sell,0,sell,0.4488309348307913,17,1,0,block 1 (G first),23.0,12.0,Male,1.0,1.0,0.0,"[5, 'block 1 (G first)']",0,1,0,0.5,7.0,-0.30000000000000004,0.3125,0.23076923076923078,0.6666666666666666,0.5,4,0.5,0.5,Design 1,Design 1,"Have an option between Design #1 and Design #2,",4.0,,
1853,4011,5,Player object (1300),sell,2023-03-09 20:16:29.807955+00:00,"{""priceA"": 85, ""sharesA"": 0, ""secs_since_round_starts"": 90, ""market"": ""A""}",155.0,13.0,3.0,lw8audd5,vmu7c279,FULL STUDY,210.0,s2,1,85,75.0,1,10.0,1,buy,0,sell,0.4890232705715233,17,0,0,block 1 (G first),23.0,12.0,Male,1.0,1.0,0.0,"[5, 'block 1 (G first)']",0,1,0,0.5,7.0,-0.30000000000000004,0.3125,0.23076923076923078,0.6666666666666666,0.5,4,0.5,0.5,Design 1,Design 1,"Have an option between Design #1 and Design #2,",4.0,,
1854,4013,5,Player object (1300),buy,2023-03-09 20:16:40.126261+00:00,"{""priceA"": 90, ""sharesA"": 1, ""secs_since_round_starts"": 101, ""market"": ""A""}",65.0,15.0,4.0,lw8audd5,vmu7c279,FULL STUDY,210.0,s2,1,90,85.0,-1,,1,sell,0,sell,0.505231414156075,17,0,0,block 1 (G first),23.0,12.0,Male,1.0,1.0,0.0,"[5, 'block 1 (G first)']",0,1,0,0.5,7.0,-0.30000000000000004,0.3125,0.23076923076923078,0.6666666666666666,0.5,4,0.5,0.5,Design 1,Design 1,"Have an option between Design #1 and Design #2,",4.0,,
1855,4014,5,Player object (1300),sell,2023-03-09 20:16:48.888223+00:00,"{""priceA"": 85, ""sharesA"": 0, ""secs_since_round_starts"": 109, ""market"": ""A""}",150.0,16.0,5.0,lw8audd5,vmu7c279,FULL STUDY,210.0,s2,1,85,90.0,1,-5.0,1,buy,0,sell,0.4686291671454359,17,0,0,block 1 (G first),23.0,12.0,Male,1.0,1.0,0.0,"[5, 'block 1 (G first)']",0,1,0,0.5,7.0,-0.30000000000000004,0.3125,0.23076923076923078,0.6666666666666666,0.5,4,0.5,0.5,Design 1,Design 1,"Have an option between Design #1 and Design #2,",4.0,,
1856,4015,5,Player object (1300),buy,2023-03-09 20:16:56.113885+00:00,"{""priceA"": 70, ""sharesA"": 1, ""secs_since_round_starts"": 117, ""market"": ""A""}",80.0,18.0,6.0,lw8audd5,vmu7c279,FULL STUDY,210.0,s2,1,70,85.0,-1,,1,sell,0,sell,0.42621223683237,17,1,0,block 1 (G first),23.0,12.0,Male,1.0,1.0,0.0,"[5, 'block 1 (G first)']",0,1,0,0.5,7.0,-0.30000000000000004,0.3125,0.23076923076923078,0.6666666666666666,0.5,4,0.5,0.5,Design 1,Design 1,"Have an option between Design #1 and Design #2,",4.0,,
1857,4017,5,Player object (1300),sell,2023-03-09 20:17:12.452524+00:00,"{""priceA"": 105, ""sharesA"": 0, ""secs_since_round_starts"": 133, ""market"": ""A""}",185.0,21.0,7.0,lw8audd5,vmu7c279,FULL STUDY,210.0,s2,1,105,70.0,1,35.0,1,buy,0,sell,0.5510362930796925,17,0,1,block 1 (G first),23.0,12.0,Male,1.0,1.0,0.0,"[5, 'block 1 (G first)']",0,1,0,0.5,7.0,-0.30000000000000004,0.3125,0.23076923076923078,0.6666666666666666,0.5,4,0.5,0.5,Design 1,Design 1,"Have an option between Design #1 and Design #2,",4.0,,
1858,4020,5,Player object (1300),buy,2023-03-09 20:17:50.872273+00:00,"{""priceA"": 85, ""sharesA"": 1, ""secs_since_round_starts"": 171, ""market"": ""A""}",100.0,28.0,8.0,lw8audd5,vmu7c279,FULL STUDY,210.0,s2,1,85,105.0,-1,,1,sell,0,sell,0.4496194529460131,17,1,0,block 1 (G first),23.0,12.0,Male,1.0,1.0,0.0,"[5, 'block 1 (G first)']",0,1,0,0.5,7.0,-0.30000000000000004,0.3125,0.23076923076923078,0.6666666666666666,0.5,4,0.5,0.5,Design 1,Design 1,"Have an option between Design #1 and Design #2,",4.0,,
1859,4022,5,Player object (1300),sell,2023-03-09 20:18:22.682456+00:00,"{""priceA"": 110, ""sharesA"": 0, ""secs_since_round_starts"": 203, ""market"": ""A""}",210.0,33.0,9.0,lw8audd5,vmu7c279,FULL STUDY,210.0,s2,1,110,85.0,1,25.0,1,buy,0,sell,0.5480287979668599,17,0,1,block 1 (G first),23.0,12.0,Male,1.0,1.0,0.0,"[5, 'block 1 (G first)']",0,1,0,0.5,7.0,-0.30000000000000004,0.3125,0.23076923076923078,0.6666666666666666,0.5,4,0.5,0.5,Design 1,Design 1,"Have an option between Design #1 and Design #2,",4.0,,
1860,4025,5,Player object (1300),buy,2023-03-09 20:18:47.544420+00:00,"{""priceA"": 80, ""sharesA"": 1, ""secs_since_round_starts"": 228, ""market"": ""A""}",130.0,38.0,10.0,lw8audd5,vmu7c279,FULL STUDY,210.0,s2,1,80,110.0,-1,,1,sell,0,sell,0.4515999245786187,17,1,0,block 1 (G first),23.0,12.0,Male,1.0,1.0,0.0,"[5, 'block 1 (G first)']",0,1,0,0.5,7.0,-0.30000000000000004,0.3125,0.23076923076923078,0.6666666666666666,0.5,4,0.5,0.5,Design 1,Design 1,"Have an option between Design #1 and Design #2,",4.0,,
1861,4026,5,Player object (1300),sell,2023-03-09 20:19:18.642949+00:00,"{""priceA"": 110, ""sharesA"": 0, ""secs_since_round_starts"": 259, ""market"": ""A""}",240.0,43.0,11.0,lw8audd5,vmu7c279,FULL STUDY,210.0,s2,1,110,80.0,1,30.0,1,buy,0,sell,0.571300234525265,17,0,0,block 1 (G first),23.0,12.0,Male,1.0,1.0,0.0,"[5, 'block 1 (G first)']",0,1,0,0.5,7.0,-0.30000000000000004,0.3125,0.23076923076923078,0.6666666666666666,0.5,4,0.5,0.5,Design 1,Design 1,"Have an option between Design #1 and Design #2,",4.0,,
1862,4027,5,Player object (1300),buy,2023-03-09 20:19:22.301292+00:00,"{""priceA"": 105, ""sharesA"": 1, ""secs_since_round_starts"": 263, ""market"": ""A""}",135.0,44.0,12.0,lw8audd5,vmu7c279,FULL STUDY,210.0,s2,1,105,110.0,-1,,1,sell,0,sell,0.515125859635568,17,0,0,block 1 (G first),23.0,12.0,Male,1.0,1.0,0.0,"[5, 'block 1 (G first)']",0,1,0,0.5,7.0,-0.30000000000000004,0.3125,0.23076923076923078,0.6666666666666666,0.5,4,0.5,0.5,Design 1,Design 1,"Have an option between Design #1 and Design #2,",4.0,,
1863,4028,5,Player object (1300),sell,2023-03-09 20:19:31.872525+00:00,"{""priceA"": 95, ""sharesA"": 0, ""secs_since_round_starts"": 272, ""market"": ""A""}",230.0,46.0,13.0,lw8audd5,vmu7c279,FULL STUDY,210.0,s2,1,95,105.0,1,-10.0,1,buy,0,sell,0.4967862103563366,17,0,0,block 1 (G first),23.0,12.0,Male,1.0,1.0,0.0,"[5, 'block 1 (G first)']",0,1,0,0.5,7.0,-0.30000000000000004,0.3125,0.23076923076923078,0.6666666666666666,0.5,4,0.5,0.5,Design 1,Design 1,"Have an option between Design #1 and Design #2,",4.0,,
1864,4030,5,Player object (1300),buy,2023-03-09 20:19:42.480789+00:00,"{""priceA"": 75, ""sharesA"": 1, ""secs_since_round_starts"": 283, ""market"": ""A""}",155.0,48.0,14.0,lw8audd5,vmu7c279,FULL STUDY,210.0,s2,1,75,95.0,-1,,1,sell,0,sell,0.4393932183506925,17,1,0,block 1 (G first),23.0,12.0,Male,1.0,1.0,0.0,"[5, 'block 1 (G first)']",0,1,0,0.5,7.0,-0.30000000000000004,0.3125,0.23076923076923078,0.6666666666666666,0.5,4,0.5,0.5,Design 1,Design 1,"Have an option between Design #1 and Design #2,",4.0,,
1865,4035,5,Player object (1300),sell,2023-03-09 20:20:10.367225+00:00,"{""priceA"": 85, ""sharesA"": 0, ""secs_since_round_starts"": 311, ""market"": ""A""}",240.0,53.0,15.0,lw8audd5,vmu7c279,FULL STUDY,210.0,s2,1,85,75.0,1,10.0,1,buy,0,sell,0.4927925471404216,17,0,0,block 1 (G first),23.0,12.0,Male,1.0,1.0,0.0,"[5, 'block 1 (G first)']",0,1,0,0.5,7.0,-0.30000000000000004,0.3125,0.23076923076923078,0.6666666666666666,0.5,4,0.5,0.5,Design 1,Design 1,"Have an option between Design #1 and Design #2,",4.0,,
1866,4036,5,Player object (1300),buy,2023-03-09 20:20:16.270802+00:00,"{""priceA"": 95, ""sharesA"": 1, ""secs_since_round_starts"": 317, ""market"": ""A""}",145.0,54.0,16.0,lw8audd5,vmu7c279,FULL STUDY,210.0,s2,1,95,85.0,-1,,1,sell,0,sell,0.5299980248683189,17,0,0,block 1 (G first),23.0,12.0,Male,1.0,1.0,0.0,"[5, 'block 1 (G first)']",0,1,0,0.5,7.0,-0.30000000000000004,0.3125,0.23076923076923078,0.6666666666666666,0.5,4,0.5,0.5,Design 1,Design 1,"Have an option between Design #1 and Design #2,",4.0,,
1867,1600,2,Player object (879),sell,2023-03-06 02:09:54.856741+00:00,"{""priceA"": 155, ""sharesA"": 0, ""secs_since_round_starts"": 372, ""market"": ""A""}",205.0,46.0,1.0,mbj7g6v1,vmu7c279,FULL STUDY,205.0,s2,1,155,,1,,1,,0,sell,0.5495494947508355,16,0,1,block 3 (G second),21.0,11.0,Male,1.0,1.0,1.0,"[2, 'block 3 (G second)']",0,0,1,0.5,5.0,-0.41666666666666663,0.02631578947368421,0.0,0.125,0.0,4,1.0,0.25,Design 2,Design 2,"Have an option between Design #1 and Design #2,",5.0,,
1868,1603,2,Player object (879),buy,2023-03-06 02:10:27.602804+00:00,"{""priceA"": 125, ""sharesA"": 1, ""secs_since_round_starts"": 404, ""market"": ""A""}",80.0,52.0,2.0,mbj7g6v1,vmu7c279,FULL STUDY,205.0,s2,1,125,155.0,-1,,1,sell,0,sell,0.4439176376077041,16,1,0,block 3 (G second),21.0,11.0,Male,1.0,1.0,1.0,"[2, 'block 3 (G second)']",0,0,1,0.5,5.0,-0.41666666666666663,0.02631578947368421,0.0,0.125,0.0,4,1.0,0.25,Design 2,Design 2,"Have an option between Design #1 and Design #2,",5.0,,
1869,1607,3,Player object (999),sell,2023-03-06 02:12:36.480305+00:00,"{""priceA"": 110, ""sharesA"": 0, ""secs_since_round_starts"": 77, ""market"": ""A""}",160.0,11.0,1.0,mbj7g6v1,vmu7c279,FULL STUDY,185.0,s2,1,110,,1,,1,,0,sell,0.5295922419004607,19,0,0,block 3 (G second),21.0,11.0,Male,1.0,1.0,1.0,"[3, 'block 3 (G second)']",0,1,1,0.5,5.0,-0.41666666666666663,0.3076923076923077,0.0,0.0,0.0,5,0.75,1.0,Design 2,Design 2,"Have an option between Design #1 and Design #2,",5.0,,
1870,1608,3,Player object (999),buy,2023-03-06 02:13:03.647786+00:00,"{""priceA"": 100, ""sharesA"": 1, ""secs_since_round_starts"": 104, ""market"": ""A""}",60.0,16.0,2.0,mbj7g6v1,vmu7c279,FULL STUDY,185.0,s2,1,100,110.0,-1,,1,sell,0,sell,0.4486815727575955,19,1,0,block 3 (G second),21.0,11.0,Male,1.0,1.0,1.0,"[3, 'block 3 (G second)']",0,1,1,0.5,5.0,-0.41666666666666663,0.3076923076923077,0.0,0.0,0.0,5,0.75,1.0,Design 2,Design 2,"Have an option between Design #1 and Design #2,",5.0,,
1871,1609,3,Player object (999),sell,2023-03-06 02:13:54.032461+00:00,"{""priceA"": 110, ""sharesA"": 0, ""secs_since_round_starts"": 154, ""market"": ""A""}",170.0,25.0,3.0,mbj7g6v1,vmu7c279,FULL STUDY,185.0,s2,1,110,100.0,1,10.0,1,buy,0,sell,0.4872943409941583,19,0,0,block 3 (G second),21.0,11.0,Male,1.0,1.0,1.0,"[3, 'block 3 (G second)']",0,1,1,0.5,5.0,-0.41666666666666663,0.3076923076923077,0.0,0.0,0.0,5,0.75,1.0,Design 2,Design 2,"Have an option between Design #1 and Design #2,",5.0,,
1872,1611,3,Player object (999),buy,2023-03-06 02:14:47.119877+00:00,"{""priceA"": 100, ""sharesA"": 1, ""secs_since_round_starts"": 207, ""market"": ""A""}",70.0,33.0,4.0,mbj7g6v1,vmu7c279,FULL STUDY,185.0,s2,1,100,110.0,-1,,1,sell,0,sell,0.4476889957041811,19,1,0,block 3 (G second),21.0,11.0,Male,1.0,1.0,1.0,"[3, 'block 3 (G second)']",0,1,1,0.5,5.0,-0.41666666666666663,0.3076923076923077,0.0,0.0,0.0,5,0.75,1.0,Design 2,Design 2,"Have an option between Design #1 and Design #2,",5.0,,
1873,1612,3,Player object (999),sell,2023-03-06 02:15:35.412403+00:00,"{""priceA"": 105, ""sharesA"": 0, ""secs_since_round_starts"": 256, ""market"": ""A""}",175.0,42.0,5.0,mbj7g6v1,vmu7c279,FULL STUDY,185.0,s2,1,105,100.0,1,5.0,1,buy,0,sell,0.5010477910686952,19,0,0,block 3 (G second),21.0,11.0,Male,1.0,1.0,1.0,"[3, 'block 3 (G second)']",0,1,1,0.5,5.0,-0.41666666666666663,0.3076923076923077,0.0,0.0,0.0,5,0.75,1.0,Design 2,Design 2,"Have an option between Design #1 and Design #2,",5.0,,
1874,1613,3,Player object (999),buy,2023-03-06 02:17:05.439671+00:00,"{""priceA"": 115, ""sharesA"": 1, ""secs_since_round_starts"": 346, ""market"": ""A""}",60.0,58.0,6.0,mbj7g6v1,vmu7c279,FULL STUDY,185.0,s2,1,115,105.0,-1,,1,sell,0,sell,0.442461876115205,19,1,0,block 3 (G second),21.0,11.0,Male,1.0,1.0,1.0,"[3, 'block 3 (G second)']",0,1,1,0.5,5.0,-0.41666666666666663,0.3076923076923077,0.0,0.0,0.0,5,0.75,1.0,Design 2,Design 2,"Have an option between Design #1 and Design #2,",5.0,,
1875,1614,3,Player object (999),sell,2023-03-06 02:17:10.847750+00:00,"{""priceA"": 125, ""sharesA"": 0, ""secs_since_round_starts"": 351, ""market"": ""A""}",185.0,59.0,7.0,mbj7g6v1,vmu7c279,FULL STUDY,185.0,s2,1,125,115.0,1,10.0,1,buy,0,sell,0.4946618842475483,19,0,0,block 3 (G second),21.0,11.0,Male,1.0,1.0,1.0,"[3, 'block 3 (G second)']",0,1,1,0.5,5.0,-0.41666666666666663,0.3076923076923077,0.0,0.0,0.0,5,0.75,1.0,Design 2,Design 2,"Have an option between Design #1 and Design #2,",5.0,,
1876,1615,3,Player object (999),buy,2023-03-06 02:17:14.530669+00:00,"{""priceA"": 115, ""sharesA"": 1, ""secs_since_round_starts"": 355, ""market"": ""A""}",70.0,60.0,8.0,mbj7g6v1,vmu7c279,FULL STUDY,185.0,s2,1,115,125.0,-1,,1,sell,0,sell,0.4613046310449969,19,0,0,block 3 (G second),21.0,11.0,Male,1.0,1.0,1.0,"[3, 'block 3 (G second)']",0,1,1,0.5,5.0,-0.41666666666666663,0.3076923076923077,0.0,0.0,0.0,5,0.75,1.0,Design 2,Design 2,"Have an option between Design #1 and Design #2,",5.0,,
1877,1619,4,Player object (1119),sell,2023-03-06 02:18:16.649251+00:00,"{""priceA"": 80, ""sharesA"": 0, ""secs_since_round_starts"": 55, ""market"": ""A""}",130.0,10.0,1.0,mbj7g6v1,vmu7c279,FULL STUDY,115.0,s2,1,80,,1,,1,,0,sell,0.5652817482669988,14,0,0,block 3 (G second),21.0,11.0,Male,1.0,1.0,1.0,"[4, 'block 3 (G second)']",1,0,1,0.5,5.0,-0.41666666666666663,1.0,0.1,1.0,0.1111111111111111,2,1.0,1.0,Design 2,Design 2,"Have an option between Design #1 and Design #2,",5.0,,
1878,1620,4,Player object (1119),buy,2023-03-06 02:18:47.634131+00:00,"{""priceA"": 90, ""sharesA"": 1, ""secs_since_round_starts"": 85, ""market"": ""A""}",40.0,16.0,2.0,mbj7g6v1,vmu7c279,FULL STUDY,115.0,s2,1,90,80.0,-1,,1,sell,0,sell,0.4995738325599586,14,0,0,block 3 (G second),21.0,11.0,Male,1.0,1.0,1.0,"[4, 'block 3 (G second)']",1,0,1,0.5,5.0,-0.41666666666666663,1.0,0.1,1.0,0.1111111111111111,2,1.0,1.0,Design 2,Design 2,"Have an option between Design #1 and Design #2,",5.0,,
1879,1621,4,Player object (1119),sell,2023-03-06 02:19:55.058482+00:00,"{""priceA"": 80, ""sharesA"": 0, ""secs_since_round_starts"": 153, ""market"": ""A""}",120.0,28.0,3.0,mbj7g6v1,vmu7c279,FULL STUDY,115.0,s2,1,80,90.0,1,-10.0,1,buy,0,sell,0.5529051331090981,14,0,1,block 3 (G second),21.0,11.0,Male,1.0,1.0,1.0,"[4, 'block 3 (G second)']",1,0,1,0.5,5.0,-0.41666666666666663,1.0,0.1,1.0,0.1111111111111111,2,1.0,1.0,Design 2,Design 2,"Have an option between Design #1 and Design #2,",5.0,,
1880,1623,4,Player object (1119),buy,2023-03-06 02:20:38.897675+00:00,"{""priceA"": 85, ""sharesA"": 1, ""secs_since_round_starts"": 197, ""market"": ""A""}",35.0,36.0,4.0,mbj7g6v1,vmu7c279,FULL STUDY,115.0,s2,1,85,80.0,-1,,1,sell,0,sell,0.4885269486642424,14,0,0,block 3 (G second),21.0,11.0,Male,1.0,1.0,1.0,"[4, 'block 3 (G second)']",1,0,1,0.5,5.0,-0.41666666666666663,1.0,0.1,1.0,0.1111111111111111,2,1.0,1.0,Design 2,Design 2,"Have an option between Design #1 and Design #2,",5.0,,
1881,1624,4,Player object (1119),sell,2023-03-06 02:20:58.580856+00:00,"{""priceA"": 80, ""sharesA"": 0, ""secs_since_round_starts"": 216, ""market"": ""A""}",115.0,39.0,5.0,mbj7g6v1,vmu7c279,FULL STUDY,115.0,s2,1,80,85.0,1,-5.0,1,buy,0,sell,0.4897180556691627,14,0,0,block 3 (G second),21.0,11.0,Male,1.0,1.0,1.0,"[4, 'block 3 (G second)']",1,0,1,0.5,5.0,-0.41666666666666663,1.0,0.1,1.0,0.1111111111111111,2,1.0,1.0,Design 2,Design 2,"Have an option between Design #1 and Design #2,",5.0,,
1882,1625,4,Player object (1119),buy,2023-03-06 02:21:00.738107+00:00,"{""priceA"": 75, ""sharesA"": 1, ""secs_since_round_starts"": 219, ""market"": ""A""}",40.0,40.0,6.0,mbj7g6v1,vmu7c279,FULL STUDY,115.0,s2,1,75,80.0,-1,,1,sell,0,sell,0.4578892350765483,14,0,0,block 3 (G second),21.0,11.0,Male,1.0,1.0,1.0,"[4, 'block 3 (G second)']",1,0,1,0.5,5.0,-0.41666666666666663,1.0,0.1,1.0,0.1111111111111111,2,1.0,1.0,Design 2,Design 2,"Have an option between Design #1 and Design #2,",5.0,,
1883,1626,4,Player object (1119),sell,2023-03-06 02:21:06.419587+00:00,"{""priceA"": 80, ""sharesA"": 0, ""secs_since_round_starts"": 224, ""market"": ""A""}",120.0,41.0,7.0,mbj7g6v1,vmu7c279,FULL STUDY,115.0,s2,1,80,75.0,1,5.0,1,buy,0,sell,0.5055693706451859,14,0,0,block 3 (G second),21.0,11.0,Male,1.0,1.0,1.0,"[4, 'block 3 (G second)']",1,0,1,0.5,5.0,-0.41666666666666663,1.0,0.1,1.0,0.1111111111111111,2,1.0,1.0,Design 2,Design 2,"Have an option between Design #1 and Design #2,",5.0,,
1884,1627,4,Player object (1119),buy,2023-03-06 02:21:13.923744+00:00,"{""priceA"": 95, ""sharesA"": 1, ""secs_since_round_starts"": 232, ""market"": ""A""}",25.0,42.0,8.0,mbj7g6v1,vmu7c279,FULL STUDY,115.0,s2,1,95,80.0,-1,,1,sell,0,sell,0.5388552795609507,14,0,0,block 3 (G second),21.0,11.0,Male,1.0,1.0,1.0,"[4, 'block 3 (G second)']",1,0,1,0.5,5.0,-0.41666666666666663,1.0,0.1,1.0,0.1111111111111111,2,1.0,1.0,Design 2,Design 2,"Have an option between Design #1 and Design #2,",5.0,,
1885,1628,4,Player object (1119),sell,2023-03-06 02:21:17.697793+00:00,"{""priceA"": 100, ""sharesA"": 0, ""secs_since_round_starts"": 236, ""market"": ""A""}",125.0,43.0,9.0,mbj7g6v1,vmu7c279,FULL STUDY,115.0,s2,1,100,95.0,1,5.0,1,buy,0,sell,0.5617190733230237,14,0,1,block 3 (G second),21.0,11.0,Male,1.0,1.0,1.0,"[4, 'block 3 (G second)']",1,0,1,0.5,5.0,-0.41666666666666663,1.0,0.1,1.0,0.1111111111111111,2,1.0,1.0,Design 2,Design 2,"Have an option between Design #1 and Design #2,",5.0,,
1886,1629,4,Player object (1119),buy,2023-03-06 02:21:34.852009+00:00,"{""priceA"": 95, ""sharesA"": 1, ""secs_since_round_starts"": 253, ""market"": ""A""}",30.0,46.0,10.0,mbj7g6v1,vmu7c279,FULL STUDY,115.0,s2,1,95,100.0,-1,,1,sell,0,sell,0.4784785382548627,14,0,0,block 3 (G second),21.0,11.0,Male,1.0,1.0,1.0,"[4, 'block 3 (G second)']",1,0,1,0.5,5.0,-0.41666666666666663,1.0,0.1,1.0,0.1111111111111111,2,1.0,1.0,Design 2,Design 2,"Have an option between Design #1 and Design #2,",5.0,,
1887,1630,4,Player object (1119),sell,2023-03-06 02:21:45.894775+00:00,"{""priceA"": 100, ""sharesA"": 0, ""secs_since_round_starts"": 264, ""market"": ""A""}",130.0,48.0,11.0,mbj7g6v1,vmu7c279,FULL STUDY,115.0,s2,1,100,95.0,1,5.0,1,buy,0,sell,0.500105737602651,14,0,0,block 3 (G second),21.0,11.0,Male,1.0,1.0,1.0,"[4, 'block 3 (G second)']",1,0,1,0.5,5.0,-0.41666666666666663,1.0,0.1,1.0,0.1111111111111111,2,1.0,1.0,Design 2,Design 2,"Have an option between Design #1 and Design #2,",5.0,,
1888,1631,4,Player object (1119),buy,2023-03-06 02:22:06.624289+00:00,"{""priceA"": 90, ""sharesA"": 1, ""secs_since_round_starts"": 285, ""market"": ""A""}",40.0,52.0,12.0,mbj7g6v1,vmu7c279,FULL STUDY,115.0,s2,1,90,100.0,-1,,1,sell,0,sell,0.4694909620846048,14,0,0,block 3 (G second),21.0,11.0,Male,1.0,1.0,1.0,"[4, 'block 3 (G second)']",1,0,1,0.5,5.0,-0.41666666666666663,1.0,0.1,1.0,0.1111111111111111,2,1.0,1.0,Design 2,Design 2,"Have an option between Design #1 and Design #2,",5.0,,
1889,1635,5,Player object (1239),sell,2023-03-06 02:23:37.503847+00:00,"{""priceA"": 100, ""sharesA"": 0, ""secs_since_round_starts"": 39, ""market"": ""A""}",150.0,7.0,1.0,mbj7g6v1,vmu7c279,FULL STUDY,215.0,s2,1,100,,1,,1,,0,sell,0.5733994727268583,17,0,0,block 3 (G second),21.0,11.0,Male,1.0,1.0,1.0,"[5, 'block 3 (G second)']",1,1,1,0.0,5.0,-0.41666666666666663,0.5454545454545454,0.0,1.0,0.0,2,1.0,1.0,Design 2,Design 2,"Have an option between Design #1 and Design #2,",5.0,,
1890,1636,5,Player object (1239),buy,2023-03-06 02:23:41.885818+00:00,"{""priceA"": 90, ""sharesA"": 1, ""secs_since_round_starts"": 43, ""market"": ""A""}",60.0,8.0,2.0,mbj7g6v1,vmu7c279,FULL STUDY,215.0,s2,1,90,100.0,-1,,1,sell,0,sell,0.5166236645513725,17,0,0,block 3 (G second),21.0,11.0,Male,1.0,1.0,1.0,"[5, 'block 3 (G second)']",1,1,1,0.0,5.0,-0.41666666666666663,0.5454545454545454,0.0,1.0,0.0,2,1.0,1.0,Design 2,Design 2,"Have an option between Design #1 and Design #2,",5.0,,
1891,1637,5,Player object (1239),sell,2023-03-06 02:24:05.795620+00:00,"{""priceA"": 100, ""sharesA"": 0, ""secs_since_round_starts"": 67, ""market"": ""A""}",160.0,12.0,3.0,mbj7g6v1,vmu7c279,FULL STUDY,215.0,s2,1,100,90.0,1,10.0,1,buy,0,sell,0.5344269279803172,17,0,0,block 3 (G second),21.0,11.0,Male,1.0,1.0,1.0,"[5, 'block 3 (G second)']",1,1,1,0.0,5.0,-0.41666666666666663,0.5454545454545454,0.0,1.0,0.0,2,1.0,1.0,Design 2,Design 2,"Have an option between Design #1 and Design #2,",5.0,,
1892,1638,5,Player object (1239),buy,2023-03-06 02:24:15.054650+00:00,"{""priceA"": 80, ""sharesA"": 1, ""secs_since_round_starts"": 77, ""market"": ""A""}",80.0,14.0,4.0,mbj7g6v1,vmu7c279,FULL STUDY,215.0,s2,1,80,100.0,-1,,1,sell,0,sell,0.457409789643144,17,0,0,block 3 (G second),21.0,11.0,Male,1.0,1.0,1.0,"[5, 'block 3 (G second)']",1,1,1,0.0,5.0,-0.41666666666666663,0.5454545454545454,0.0,1.0,0.0,2,1.0,1.0,Design 2,Design 2,"Have an option between Design #1 and Design #2,",5.0,,
1893,1639,5,Player object (1239),sell,2023-03-06 02:24:28.425773+00:00,"{""priceA"": 85, ""sharesA"": 0, ""secs_since_round_starts"": 90, ""market"": ""A""}",165.0,16.0,5.0,mbj7g6v1,vmu7c279,FULL STUDY,215.0,s2,1,85,80.0,1,5.0,1,buy,0,sell,0.4686291671454359,17,0,0,block 3 (G second),21.0,11.0,Male,1.0,1.0,1.0,"[5, 'block 3 (G second)']",1,1,1,0.0,5.0,-0.41666666666666663,0.5454545454545454,0.0,1.0,0.0,2,1.0,1.0,Design 2,Design 2,"Have an option between Design #1 and Design #2,",5.0,,
1894,1640,5,Player object (1239),buy,2023-03-06 02:24:33.454476+00:00,"{""priceA"": 80, ""sharesA"": 1, ""secs_since_round_starts"": 95, ""market"": ""A""}",85.0,17.0,6.0,mbj7g6v1,vmu7c279,FULL STUDY,215.0,s2,1,80,85.0,-1,,1,sell,0,sell,0.4433955626702647,17,0,0,block 3 (G second),21.0,11.0,Male,1.0,1.0,1.0,"[5, 'block 3 (G second)']",1,1,1,0.0,5.0,-0.41666666666666663,0.5454545454545454,0.0,1.0,0.0,2,1.0,1.0,Design 2,Design 2,"Have an option between Design #1 and Design #2,",5.0,,
1895,1641,5,Player object (1239),sell,2023-03-06 02:24:48.214846+00:00,"{""priceA"": 95, ""sharesA"": 0, ""secs_since_round_starts"": 110, ""market"": ""A""}",180.0,20.0,7.0,mbj7g6v1,vmu7c279,FULL STUDY,215.0,s2,1,95,80.0,1,15.0,1,buy,0,sell,0.5232479875730728,17,0,0,block 3 (G second),21.0,11.0,Male,1.0,1.0,1.0,"[5, 'block 3 (G second)']",1,1,1,0.0,5.0,-0.41666666666666663,0.5454545454545454,0.0,1.0,0.0,2,1.0,1.0,Design 2,Design 2,"Have an option between Design #1 and Design #2,",5.0,,
1896,1642,5,Player object (1239),buy,2023-03-06 02:25:25.975224+00:00,"{""priceA"": 100, ""sharesA"": 1, ""secs_since_round_starts"": 147, ""market"": ""A""}",80.0,27.0,8.0,mbj7g6v1,vmu7c279,FULL STUDY,215.0,s2,1,100,95.0,-1,,1,sell,0,sell,0.4777068930880888,17,0,0,block 3 (G second),21.0,11.0,Male,1.0,1.0,1.0,"[5, 'block 3 (G second)']",1,1,1,0.0,5.0,-0.41666666666666663,0.5454545454545454,0.0,1.0,0.0,2,1.0,1.0,Design 2,Design 2,"Have an option between Design #1 and Design #2,",5.0,,
1897,1644,5,Player object (1239),sell,2023-03-06 02:26:26.177748+00:00,"{""priceA"": 110, ""sharesA"": 0, ""secs_since_round_starts"": 208, ""market"": ""A""}",190.0,33.0,9.0,mbj7g6v1,vmu7c279,FULL STUDY,215.0,s2,1,110,100.0,1,10.0,1,buy,0,sell,0.5480287979668599,17,0,1,block 3 (G second),21.0,11.0,Male,1.0,1.0,1.0,"[5, 'block 3 (G second)']",1,1,1,0.0,5.0,-0.41666666666666663,0.5454545454545454,0.0,1.0,0.0,2,1.0,1.0,Design 2,Design 2,"Have an option between Design #1 and Design #2,",5.0,,
1898,1645,5,Player object (1239),buy,2023-03-06 02:26:55.230773+00:00,"{""priceA"": 80, ""sharesA"": 1, ""secs_since_round_starts"": 237, ""market"": ""A""}",110.0,38.0,10.0,mbj7g6v1,vmu7c279,FULL STUDY,215.0,s2,1,80,110.0,-1,,1,sell,0,sell,0.4515999245786187,17,1,0,block 3 (G second),21.0,11.0,Male,1.0,1.0,1.0,"[5, 'block 3 (G second)']",1,1,1,0.0,5.0,-0.41666666666666663,0.5454545454545454,0.0,1.0,0.0,2,1.0,1.0,Design 2,Design 2,"Have an option between Design #1 and Design #2,",5.0,,
1899,1646,5,Player object (1239),sell,2023-03-06 02:27:14.261693+00:00,"{""priceA"": 100, ""sharesA"": 0, ""secs_since_round_starts"": 256, ""market"": ""A""}",210.0,42.0,11.0,mbj7g6v1,vmu7c279,FULL STUDY,215.0,s2,1,100,80.0,1,20.0,1,buy,0,sell,0.5529358605422235,17,0,1,block 3 (G second),21.0,11.0,Male,1.0,1.0,1.0,"[5, 'block 3 (G second)']",1,1,1,0.0,5.0,-0.41666666666666663,0.5454545454545454,0.0,1.0,0.0,2,1.0,1.0,Design 2,Design 2,"Have an option between Design #1 and Design #2,",5.0,,
1900,1647,5,Player object (1239),buy,2023-03-06 02:27:45.895621+00:00,"{""priceA"": 75, ""sharesA"": 1, ""secs_since_round_starts"": 287, ""market"": ""A""}",135.0,48.0,12.0,mbj7g6v1,vmu7c279,FULL STUDY,215.0,s2,1,75,100.0,-1,,1,sell,0,sell,0.4393932183506925,17,1,0,block 3 (G second),21.0,11.0,Male,1.0,1.0,1.0,"[5, 'block 3 (G second)']",1,1,1,0.0,5.0,-0.41666666666666663,0.5454545454545454,0.0,1.0,0.0,2,1.0,1.0,Design 2,Design 2,"Have an option between Design #1 and Design #2,",5.0,,
1901,1648,5,Player object (1239),sell,2023-03-06 02:28:17.253232+00:00,"{""priceA"": 85, ""sharesA"": 0, ""secs_since_round_starts"": 319, ""market"": ""A""}",220.0,53.0,13.0,mbj7g6v1,vmu7c279,FULL STUDY,215.0,s2,1,85,75.0,1,10.0,1,buy,0,sell,0.4927925471404216,17,0,0,block 3 (G second),21.0,11.0,Male,1.0,1.0,1.0,"[5, 'block 3 (G second)']",1,1,1,0.0,5.0,-0.41666666666666663,0.5454545454545454,0.0,1.0,0.0,2,1.0,1.0,Design 2,Design 2,"Have an option between Design #1 and Design #2,",5.0,,
1902,1649,5,Player object (1239),buy,2023-03-06 02:28:47.728252+00:00,"{""priceA"": 70, ""sharesA"": 1, ""secs_since_round_starts"": 349, ""market"": ""A""}",150.0,59.0,14.0,mbj7g6v1,vmu7c279,FULL STUDY,215.0,s2,1,70,85.0,-1,,1,sell,0,sell,0.4327023062729965,17,1,0,block 3 (G second),21.0,11.0,Male,1.0,1.0,1.0,"[5, 'block 3 (G second)']",1,1,1,0.0,5.0,-0.41666666666666663,0.5454545454545454,0.0,1.0,0.0,2,1.0,1.0,Design 2,Design 2,"Have an option between Design #1 and Design #2,",5.0,,
1903,153,2,Player object (843),sell,2023-02-22 21:53:50.059243+00:00,"{""priceA"": 100, ""sharesA"": 0, ""secs_since_round_starts"": 96, ""market"": ""A""}",150.0,7.0,1.0,mi0088eg,vmu7c279,FULL STUDY,170.0,s2,1,100,,1,,1,,0,sell,0.4669924949471701,16,0,0,block 1 (G first),22.0,12.0,Male,1.0,1.0,1.0,"[2, 'block 1 (G first)']",1,0,0,0.0,7.0,-0.30000000000000004,0.125,0.058823529411764705,0.0,0.0,4,1.0,0.5,Design 2,Design 2,"Have an option between Design #1 and Design #2,",4.0,,
1904,154,2,Player object (843),buy,2023-02-22 21:54:01.721694+00:00,"{""priceA"": 70, ""sharesA"": 1, ""secs_since_round_starts"": 107, ""market"": ""A""}",80.0,9.0,2.0,mi0088eg,vmu7c279,FULL STUDY,170.0,s2,1,70,100.0,-1,,1,sell,0,sell,0.4254536939069079,16,0,0,block 1 (G first),22.0,12.0,Male,1.0,1.0,1.0,"[2, 'block 1 (G first)']",1,0,0,0.0,7.0,-0.30000000000000004,0.125,0.058823529411764705,0.0,0.0,4,1.0,0.5,Design 2,Design 2,"Have an option between Design #1 and Design #2,",4.0,,
1905,155,2,Player object (843),sell,2023-02-22 21:54:30.794129+00:00,"{""priceA"": 120, ""sharesA"": 0, ""secs_since_round_starts"": 136, ""market"": ""A""}",200.0,15.0,3.0,mi0088eg,vmu7c279,FULL STUDY,170.0,s2,1,120,70.0,1,50.0,1,buy,0,sell,0.5761373211134116,16,0,0,block 1 (G first),22.0,12.0,Male,1.0,1.0,1.0,"[2, 'block 1 (G first)']",1,0,0,0.0,7.0,-0.30000000000000004,0.125,0.058823529411764705,0.0,0.0,4,1.0,0.5,Design 2,Design 2,"Have an option between Design #1 and Design #2,",4.0,,
1906,156,2,Player object (843),buy,2023-02-22 21:55:31.363220+00:00,"{""priceA"": 140, ""sharesA"": 1, ""secs_since_round_starts"": 197, ""market"": ""A""}",60.0,26.0,4.0,mi0088eg,vmu7c279,FULL STUDY,170.0,s2,1,140,120.0,-1,,1,sell,0,sell,0.4855198313469848,16,0,0,block 1 (G first),22.0,12.0,Male,1.0,1.0,1.0,"[2, 'block 1 (G first)']",1,0,0,0.0,7.0,-0.30000000000000004,0.125,0.058823529411764705,0.0,0.0,4,1.0,0.5,Design 2,Design 2,"Have an option between Design #1 and Design #2,",4.0,,
1907,158,2,Player object (843),sell,2023-02-22 21:56:20.037311+00:00,"{""priceA"": 125, ""sharesA"": 0, ""secs_since_round_starts"": 246, ""market"": ""A""}",185.0,34.0,5.0,mi0088eg,vmu7c279,FULL STUDY,170.0,s2,1,125,140.0,1,-15.0,1,buy,0,sell,0.4644502626891607,16,0,0,block 1 (G first),22.0,12.0,Male,1.0,1.0,1.0,"[2, 'block 1 (G first)']",1,0,0,0.0,7.0,-0.30000000000000004,0.125,0.058823529411764705,0.0,0.0,4,1.0,0.5,Design 2,Design 2,"Have an option between Design #1 and Design #2,",4.0,,
1908,159,2,Player object (843),buy,2023-02-22 21:57:51.252544+00:00,"{""priceA"": 140, ""sharesA"": 1, ""secs_since_round_starts"": 337, ""market"": ""A""}",45.0,51.0,6.0,mi0088eg,vmu7c279,FULL STUDY,170.0,s2,1,140,125.0,-1,,1,sell,0,sell,0.4693918893964308,16,0,0,block 1 (G first),22.0,12.0,Male,1.0,1.0,1.0,"[2, 'block 1 (G first)']",1,0,0,0.0,7.0,-0.30000000000000004,0.125,0.058823529411764705,0.0,0.0,4,1.0,0.5,Design 2,Design 2,"Have an option between Design #1 and Design #2,",4.0,,
1909,163,3,Player object (963),sell,2023-02-22 21:59:27.261283+00:00,"{""priceA"": 100, ""sharesA"": 0, ""secs_since_round_starts"": 37, ""market"": ""A""}",150.0,8.0,1.0,mi0088eg,vmu7c279,FULL STUDY,210.0,s2,1,100,,1,,1,,0,sell,0.5057155770500936,19,0,0,block 1 (G first),22.0,12.0,Male,1.0,1.0,1.0,"[3, 'block 1 (G first)']",1,1,0,0.5,7.0,-0.30000000000000004,0.4444444444444444,0.08333333333333333,0.5,0.0,2,0.5,0.75,Design 2,Design 2,"Have an option between Design #1 and Design #2,",4.0,,
1910,164,3,Player object (963),buy,2023-02-22 22:00:39.490375+00:00,"{""priceA"": 100, ""sharesA"": 1, ""secs_since_round_starts"": 109, ""market"": ""A""}",50.0,21.0,2.0,mi0088eg,vmu7c279,FULL STUDY,210.0,s2,1,100,100.0,-1,,1,sell,0,sell,0.4692484881524699,19,0,0,block 1 (G first),22.0,12.0,Male,1.0,1.0,1.0,"[3, 'block 1 (G first)']",1,1,0,0.5,7.0,-0.30000000000000004,0.4444444444444444,0.08333333333333333,0.5,0.0,2,0.5,0.75,Design 2,Design 2,"Have an option between Design #1 and Design #2,",4.0,,
1911,165,3,Player object (963),sell,2023-02-22 22:00:58.055180+00:00,"{""priceA"": 115, ""sharesA"": 0, ""secs_since_round_starts"": 128, ""market"": ""A""}",165.0,24.0,3.0,mi0088eg,vmu7c279,FULL STUDY,210.0,s2,1,115,100.0,1,15.0,1,buy,0,sell,0.5319650978870379,19,0,0,block 1 (G first),22.0,12.0,Male,1.0,1.0,1.0,"[3, 'block 1 (G first)']",1,1,0,0.5,7.0,-0.30000000000000004,0.4444444444444444,0.08333333333333333,0.5,0.0,2,0.5,0.75,Design 2,Design 2,"Have an option between Design #1 and Design #2,",4.0,,
1912,166,3,Player object (963),buy,2023-02-22 22:01:32.993671+00:00,"{""priceA"": 120, ""sharesA"": 1, ""secs_since_round_starts"": 163, ""market"": ""A""}",45.0,30.0,4.0,mi0088eg,vmu7c279,FULL STUDY,210.0,s2,1,120,115.0,-1,,1,sell,0,sell,0.570054331362491,19,0,1,block 1 (G first),22.0,12.0,Male,1.0,1.0,1.0,"[3, 'block 1 (G first)']",1,1,0,0.5,7.0,-0.30000000000000004,0.4444444444444444,0.08333333333333333,0.5,0.0,2,0.5,0.75,Design 2,Design 2,"Have an option between Design #1 and Design #2,",4.0,,
1913,168,3,Player object (963),sell,2023-02-22 22:02:09.537350+00:00,"{""priceA"": 100, ""sharesA"": 0, ""secs_since_round_starts"": 199, ""market"": ""A""}",145.0,36.0,5.0,mi0088eg,vmu7c279,FULL STUDY,210.0,s2,1,100,120.0,1,-20.0,1,buy,0,sell,0.440139794868048,19,0,0,block 1 (G first),22.0,12.0,Male,1.0,1.0,1.0,"[3, 'block 1 (G first)']",1,1,0,0.5,7.0,-0.30000000000000004,0.4444444444444444,0.08333333333333333,0.5,0.0,2,0.5,0.75,Design 2,Design 2,"Have an option between Design #1 and Design #2,",4.0,,
1914,169,3,Player object (963),buy,2023-02-22 22:02:32.861843+00:00,"{""priceA"": 95, ""sharesA"": 1, ""secs_since_round_starts"": 222, ""market"": ""A""}",50.0,41.0,6.0,mi0088eg,vmu7c279,FULL STUDY,210.0,s2,1,95,100.0,-1,,1,sell,0,sell,0.4514823197003955,19,0,0,block 1 (G first),22.0,12.0,Male,1.0,1.0,1.0,"[3, 'block 1 (G first)']",1,1,0,0.5,7.0,-0.30000000000000004,0.4444444444444444,0.08333333333333333,0.5,0.0,2,0.5,0.75,Design 2,Design 2,"Have an option between Design #1 and Design #2,",4.0,,
1915,170,3,Player object (963),sell,2023-02-22 22:02:54.575986+00:00,"{""priceA"": 125, ""sharesA"": 0, ""secs_since_round_starts"": 244, ""market"": ""A""}",175.0,45.0,7.0,mi0088eg,vmu7c279,FULL STUDY,210.0,s2,1,125,95.0,1,30.0,1,buy,0,sell,0.5067886105922249,19,0,0,block 1 (G first),22.0,12.0,Male,1.0,1.0,1.0,"[3, 'block 1 (G first)']",1,1,0,0.5,7.0,-0.30000000000000004,0.4444444444444444,0.08333333333333333,0.5,0.0,2,0.5,0.75,Design 2,Design 2,"Have an option between Design #1 and Design #2,",4.0,,
1916,171,3,Player object (963),buy,2023-02-22 22:03:21.861138+00:00,"{""priceA"": 125, ""sharesA"": 1, ""secs_since_round_starts"": 272, ""market"": ""A""}",50.0,50.0,8.0,mi0088eg,vmu7c279,FULL STUDY,210.0,s2,1,125,125.0,-1,,1,sell,0,sell,0.4911246412164243,19,0,0,block 1 (G first),22.0,12.0,Male,1.0,1.0,1.0,"[3, 'block 1 (G first)']",1,1,0,0.5,7.0,-0.30000000000000004,0.4444444444444444,0.08333333333333333,0.5,0.0,2,0.5,0.75,Design 2,Design 2,"Have an option between Design #1 and Design #2,",4.0,,
1917,172,3,Player object (963),sell,2023-02-22 22:03:51.384018+00:00,"{""priceA"": 150, ""sharesA"": 0, ""secs_since_round_starts"": 301, ""market"": ""A""}",200.0,55.0,9.0,mi0088eg,vmu7c279,FULL STUDY,210.0,s2,1,150,125.0,1,25.0,1,buy,0,sell,0.5546141592279494,19,0,1,block 1 (G first),22.0,12.0,Male,1.0,1.0,1.0,"[3, 'block 1 (G first)']",1,1,0,0.5,7.0,-0.30000000000000004,0.4444444444444444,0.08333333333333333,0.5,0.0,2,0.5,0.75,Design 2,Design 2,"Have an option between Design #1 and Design #2,",4.0,,
1918,173,3,Player object (963),buy,2023-02-22 22:04:06.754144+00:00,"{""priceA"": 115, ""sharesA"": 1, ""secs_since_round_starts"": 317, ""market"": ""A""}",85.0,58.0,10.0,mi0088eg,vmu7c279,FULL STUDY,210.0,s2,1,115,150.0,-1,,1,sell,0,sell,0.442461876115205,19,1,0,block 1 (G first),22.0,12.0,Male,1.0,1.0,1.0,"[3, 'block 1 (G first)']",1,1,0,0.5,7.0,-0.30000000000000004,0.4444444444444444,0.08333333333333333,0.5,0.0,2,0.5,0.75,Design 2,Design 2,"Have an option between Design #1 and Design #2,",4.0,,
1919,174,3,Player object (963),sell,2023-02-22 22:04:15.418475+00:00,"{""priceA"": 125, ""sharesA"": 0, ""secs_since_round_starts"": 325, ""market"": ""A""}",210.0,59.0,11.0,mi0088eg,vmu7c279,FULL STUDY,210.0,s2,1,125,115.0,1,10.0,1,buy,0,sell,0.4946618842475483,19,0,0,block 1 (G first),22.0,12.0,Male,1.0,1.0,1.0,"[3, 'block 1 (G first)']",1,1,0,0.5,7.0,-0.30000000000000004,0.4444444444444444,0.08333333333333333,0.5,0.0,2,0.5,0.75,Design 2,Design 2,"Have an option between Design #1 and Design #2,",4.0,,
1920,178,4,Player object (1083),sell,2023-02-22 22:06:16.269113+00:00,"{""priceA"": 45, ""sharesA"": 0, ""secs_since_round_starts"": 42, ""market"": ""A""}",95.0,7.0,1.0,mi0088eg,vmu7c279,FULL STUDY,90.0,s2,1,45,,1,,1,,0,sell,0.4686531252667821,14,0,0,block 1 (G first),22.0,12.0,Male,1.0,1.0,1.0,"[4, 'block 1 (G first)']",0,0,0,0.5,7.0,-0.30000000000000004,0.0,0.18181818181818182,0.0,0.0,2,1.0,0.75,Design 2,Design 2,"Have an option between Design #1 and Design #2,",4.0,,
1921,179,4,Player object (1083),buy,2023-02-22 22:07:25.402841+00:00,"{""priceA"": 70, ""sharesA"": 1, ""secs_since_round_starts"": 112, ""market"": ""A""}",25.0,20.0,2.0,mi0088eg,vmu7c279,FULL STUDY,90.0,s2,1,70,45.0,-1,,1,sell,0,sell,0.4604462199730844,14,0,0,block 1 (G first),22.0,12.0,Male,1.0,1.0,1.0,"[4, 'block 1 (G first)']",0,0,0,0.5,7.0,-0.30000000000000004,0.0,0.18181818181818182,0.0,0.0,2,1.0,0.75,Design 2,Design 2,"Have an option between Design #1 and Design #2,",4.0,,
1922,180,4,Player object (1083),sell,2023-02-22 22:08:01.349879+00:00,"{""priceA"": 55, ""sharesA"": 0, ""secs_since_round_starts"": 147, ""market"": ""A""}",80.0,26.0,3.0,mi0088eg,vmu7c279,FULL STUDY,90.0,s2,1,55,70.0,1,-15.0,1,buy,0,sell,0.4870054870256314,14,0,0,block 1 (G first),22.0,12.0,Male,1.0,1.0,1.0,"[4, 'block 1 (G first)']",0,0,0,0.5,7.0,-0.30000000000000004,0.0,0.18181818181818182,0.0,0.0,2,1.0,0.75,Design 2,Design 2,"Have an option between Design #1 and Design #2,",4.0,,
1923,182,4,Player object (1083),buy,2023-02-22 22:09:05.477683+00:00,"{""priceA"": 65, ""sharesA"": 1, ""secs_since_round_starts"": 212, ""market"": ""A""}",15.0,38.0,4.0,mi0088eg,vmu7c279,FULL STUDY,90.0,s2,1,65,55.0,-1,,1,sell,0,sell,0.4355009867455686,14,1,0,block 1 (G first),22.0,12.0,Male,1.0,1.0,1.0,"[4, 'block 1 (G first)']",0,0,0,0.5,7.0,-0.30000000000000004,0.0,0.18181818181818182,0.0,0.0,2,1.0,0.75,Design 2,Design 2,"Have an option between Design #1 and Design #2,",4.0,,
1924,186,5,Player object (1203),sell,2023-02-22 22:11:43.126689+00:00,"{""priceA"": 95, ""sharesA"": 0, ""secs_since_round_starts"": 26, ""market"": ""A""}",145.0,6.0,1.0,mi0088eg,vmu7c279,FULL STUDY,200.0,s2,1,95,,1,,1,,0,sell,0.5560314405213382,17,0,1,block 1 (G first),22.0,12.0,Male,1.0,1.0,1.0,"[5, 'block 1 (G first)']",0,1,0,0.5,7.0,-0.30000000000000004,0.3333333333333333,0.2,0.6666666666666666,0.5,5,0.25,1.0,Design 2,Design 2,"Have an option between Design #1 and Design #2,",4.0,,
1925,187,5,Player object (1203),buy,2023-02-22 22:12:02.375166+00:00,"{""priceA"": 75, ""sharesA"": 1, ""secs_since_round_starts"": 46, ""market"": ""A""}",70.0,10.0,2.0,mi0088eg,vmu7c279,FULL STUDY,200.0,s2,1,75,95.0,-1,,1,sell,0,sell,0.4488309348307913,17,1,0,block 1 (G first),22.0,12.0,Male,1.0,1.0,1.0,"[5, 'block 1 (G first)']",0,1,0,0.5,7.0,-0.30000000000000004,0.3333333333333333,0.2,0.6666666666666666,0.5,5,0.25,1.0,Design 2,Design 2,"Have an option between Design #1 and Design #2,",4.0,,
1926,188,5,Player object (1203),sell,2023-02-22 22:12:40.377924+00:00,"{""priceA"": 80, ""sharesA"": 0, ""secs_since_round_starts"": 84, ""market"": ""A""}",150.0,17.0,3.0,mi0088eg,vmu7c279,FULL STUDY,200.0,s2,1,80,75.0,1,5.0,1,buy,0,sell,0.4433955626702647,17,0,0,block 1 (G first),22.0,12.0,Male,1.0,1.0,1.0,"[5, 'block 1 (G first)']",0,1,0,0.5,7.0,-0.30000000000000004,0.3333333333333333,0.2,0.6666666666666666,0.5,5,0.25,1.0,Design 2,Design 2,"Have an option between Design #1 and Design #2,",4.0,,
1927,189,5,Player object (1203),buy,2023-02-22 22:13:14.581564+00:00,"{""priceA"": 95, ""sharesA"": 1, ""secs_since_round_starts"": 118, ""market"": ""A""}",55.0,23.0,4.0,mi0088eg,vmu7c279,FULL STUDY,200.0,s2,1,95,80.0,-1,,1,sell,0,sell,0.5355078155027276,17,0,0,block 1 (G first),22.0,12.0,Male,1.0,1.0,1.0,"[5, 'block 1 (G first)']",0,1,0,0.5,7.0,-0.30000000000000004,0.3333333333333333,0.2,0.6666666666666666,0.5,5,0.25,1.0,Design 2,Design 2,"Have an option between Design #1 and Design #2,",4.0,,
1928,190,5,Player object (1203),sell,2023-02-22 22:13:25.119044+00:00,"{""priceA"": 115, ""sharesA"": 0, ""secs_since_round_starts"": 128, ""market"": ""A""}",170.0,25.0,5.0,mi0088eg,vmu7c279,FULL STUDY,200.0,s2,1,115,95.0,1,20.0,1,buy,0,sell,0.5757035170695836,17,0,1,block 1 (G first),22.0,12.0,Male,1.0,1.0,1.0,"[5, 'block 1 (G first)']",0,1,0,0.5,7.0,-0.30000000000000004,0.3333333333333333,0.2,0.6666666666666666,0.5,5,0.25,1.0,Design 2,Design 2,"Have an option between Design #1 and Design #2,",4.0,,
1929,191,5,Player object (1203),buy,2023-02-22 22:13:42.612967+00:00,"{""priceA"": 85, ""sharesA"": 1, ""secs_since_round_starts"": 146, ""market"": ""A""}",85.0,28.0,6.0,mi0088eg,vmu7c279,FULL STUDY,200.0,s2,1,85,115.0,-1,,1,sell,0,sell,0.4496194529460131,17,1,0,block 1 (G first),22.0,12.0,Male,1.0,1.0,1.0,"[5, 'block 1 (G first)']",0,1,0,0.5,7.0,-0.30000000000000004,0.3333333333333333,0.2,0.6666666666666666,0.5,5,0.25,1.0,Design 2,Design 2,"Have an option between Design #1 and Design #2,",4.0,,
1930,193,5,Player object (1203),sell,2023-02-22 22:14:13.367977+00:00,"{""priceA"": 110, ""sharesA"": 0, ""secs_since_round_starts"": 177, ""market"": ""A""}",195.0,33.0,7.0,mi0088eg,vmu7c279,FULL STUDY,200.0,s2,1,110,85.0,1,25.0,1,buy,0,sell,0.5480287979668599,17,0,1,block 1 (G first),22.0,12.0,Male,1.0,1.0,1.0,"[5, 'block 1 (G first)']",0,1,0,0.5,7.0,-0.30000000000000004,0.3333333333333333,0.2,0.6666666666666666,0.5,5,0.25,1.0,Design 2,Design 2,"Have an option between Design #1 and Design #2,",4.0,,
1931,194,5,Player object (1203),buy,2023-02-22 22:14:31.162409+00:00,"{""priceA"": 95, ""sharesA"": 1, ""secs_since_round_starts"": 194, ""market"": ""A""}",100.0,37.0,8.0,mi0088eg,vmu7c279,FULL STUDY,200.0,s2,1,95,110.0,-1,,1,sell,0,sell,0.4805886028013266,17,0,0,block 1 (G first),22.0,12.0,Male,1.0,1.0,1.0,"[5, 'block 1 (G first)']",0,1,0,0.5,7.0,-0.30000000000000004,0.3333333333333333,0.2,0.6666666666666666,0.5,5,0.25,1.0,Design 2,Design 2,"Have an option between Design #1 and Design #2,",4.0,,
1932,195,5,Player object (1203),sell,2023-02-22 22:15:11.011204+00:00,"{""priceA"": 105, ""sharesA"": 0, ""secs_since_round_starts"": 234, ""market"": ""A""}",205.0,44.0,9.0,mi0088eg,vmu7c279,FULL STUDY,200.0,s2,1,105,95.0,1,10.0,1,buy,0,sell,0.515125859635568,17,0,0,block 1 (G first),22.0,12.0,Male,1.0,1.0,1.0,"[5, 'block 1 (G first)']",0,1,0,0.5,7.0,-0.30000000000000004,0.3333333333333333,0.2,0.6666666666666666,0.5,5,0.25,1.0,Design 2,Design 2,"Have an option between Design #1 and Design #2,",4.0,,
1933,196,5,Player object (1203),buy,2023-02-22 22:15:38.199226+00:00,"{""priceA"": 85, ""sharesA"": 1, ""secs_since_round_starts"": 261, ""market"": ""A""}",120.0,49.0,10.0,mi0088eg,vmu7c279,FULL STUDY,200.0,s2,1,85,105.0,-1,,1,sell,0,sell,0.4924841505562556,17,0,0,block 1 (G first),22.0,12.0,Male,1.0,1.0,1.0,"[5, 'block 1 (G first)']",0,1,0,0.5,7.0,-0.30000000000000004,0.3333333333333333,0.2,0.6666666666666666,0.5,5,0.25,1.0,Design 2,Design 2,"Have an option between Design #1 and Design #2,",4.0,,
1934,197,5,Player object (1203),sell,2023-02-22 22:15:58.599852+00:00,"{""priceA"": 95, ""sharesA"": 0, ""secs_since_round_starts"": 282, ""market"": ""A""}",215.0,52.0,11.0,mi0088eg,vmu7c279,FULL STUDY,200.0,s2,1,95,85.0,1,10.0,1,buy,0,sell,0.5397855680881701,17,0,0,block 1 (G first),22.0,12.0,Male,1.0,1.0,1.0,"[5, 'block 1 (G first)']",0,1,0,0.5,7.0,-0.30000000000000004,0.3333333333333333,0.2,0.6666666666666666,0.5,5,0.25,1.0,Design 2,Design 2,"Have an option between Design #1 and Design #2,",4.0,,
1935,198,5,Player object (1203),buy,2023-02-22 22:16:24.271119+00:00,"{""priceA"": 85, ""sharesA"": 1, ""secs_since_round_starts"": 307, ""market"": ""A""}",130.0,57.0,12.0,mi0088eg,vmu7c279,FULL STUDY,200.0,s2,1,85,95.0,-1,,1,sell,0,sell,0.4825596920859898,17,0,0,block 1 (G first),22.0,12.0,Male,1.0,1.0,1.0,"[5, 'block 1 (G first)']",0,1,0,0.5,7.0,-0.30000000000000004,0.3333333333333333,0.2,0.6666666666666666,0.5,5,0.25,1.0,Design 2,Design 2,"Have an option between Design #1 and Design #2,",4.0,,
1936,199,5,Player object (1203),sell,2023-02-22 22:16:31.405717+00:00,"{""priceA"": 75, ""sharesA"": 0, ""secs_since_round_starts"": 315, ""market"": ""A""}",205.0,58.0,13.0,mi0088eg,vmu7c279,FULL STUDY,200.0,s2,1,75,85.0,1,-10.0,1,buy,0,sell,0.4529558772574278,17,0,0,block 1 (G first),22.0,12.0,Male,1.0,1.0,1.0,"[5, 'block 1 (G first)']",0,1,0,0.5,7.0,-0.30000000000000004,0.3333333333333333,0.2,0.6666666666666666,0.5,5,0.25,1.0,Design 2,Design 2,"Have an option between Design #1 and Design #2,",4.0,,
1937,200,5,Player object (1203),buy,2023-02-22 22:16:35.450723+00:00,"{""priceA"": 70, ""sharesA"": 1, ""secs_since_round_starts"": 319, ""market"": ""A""}",135.0,59.0,14.0,mi0088eg,vmu7c279,FULL STUDY,200.0,s2,1,70,75.0,-1,,1,sell,0,sell,0.4327023062729965,17,1,0,block 1 (G first),22.0,12.0,Male,1.0,1.0,1.0,"[5, 'block 1 (G first)']",0,1,0,0.5,7.0,-0.30000000000000004,0.3333333333333333,0.2,0.6666666666666666,0.5,5,0.25,1.0,Design 2,Design 2,"Have an option between Design #1 and Design #2,",4.0,,
1938,408,2,Player object (854),sell,2023-02-26 00:18:57.040485+00:00,"{""priceA"": 85, ""sharesA"": 0, ""secs_since_round_starts"": 50, ""market"": ""A""}",135.0,8.0,1.0,nlp1gb1k,vmu7c279,FULL STUDY,135.0,s1,1,85,,1,,1,,0,sell,0.4422758127435268,16,1,0,block 3 (G second),20.0,12.0,Male,0.0,0.0,0.0,"[2, 'block 3 (G second)']",0,0,1,0.5,7.0,-0.30000000000000004,0.15,0.36363636363636365,0.0,0.4,5,0.75,0.75,Design 2,Design 2,"Have an option between Design #1 and Design #2,",,2.0,2.0
1939,409,2,Player object (854),buy,2023-02-26 00:19:05.085135+00:00,"{""priceA"": 75, ""sharesA"": 1, ""secs_since_round_starts"": 57, ""market"": ""A""}",60.0,10.0,2.0,nlp1gb1k,vmu7c279,FULL STUDY,135.0,s1,1,75,85.0,-1,,1,sell,0,sell,0.4825575314143953,16,0,0,block 3 (G second),20.0,12.0,Male,0.0,0.0,0.0,"[2, 'block 3 (G second)']",0,0,1,0.5,7.0,-0.30000000000000004,0.15,0.36363636363636365,0.0,0.4,5,0.75,0.75,Design 2,Design 2,"Have an option between Design #1 and Design #2,",,2.0,2.0
1940,410,2,Player object (854),sell,2023-02-26 00:19:38.285182+00:00,"{""priceA"": 105, ""sharesA"": 0, ""secs_since_round_starts"": 91, ""market"": ""A""}",165.0,16.0,3.0,nlp1gb1k,vmu7c279,FULL STUDY,135.0,s1,1,105,75.0,1,30.0,1,buy,0,sell,0.5185790363913291,16,0,0,block 3 (G second),20.0,12.0,Male,0.0,0.0,0.0,"[2, 'block 3 (G second)']",0,0,1,0.5,7.0,-0.30000000000000004,0.15,0.36363636363636365,0.0,0.4,5,0.75,0.75,Design 2,Design 2,"Have an option between Design #1 and Design #2,",,2.0,2.0
1941,411,2,Player object (854),buy,2023-02-26 00:19:47.588617+00:00,"{""priceA"": 110, ""sharesA"": 1, ""secs_since_round_starts"": 100, ""market"": ""A""}",55.0,17.0,4.0,nlp1gb1k,vmu7c279,FULL STUDY,135.0,s1,1,110,105.0,-1,,1,sell,0,sell,0.5478276073026133,16,0,0,block 3 (G second),20.0,12.0,Male,0.0,0.0,0.0,"[2, 'block 3 (G second)']",0,0,1,0.5,7.0,-0.30000000000000004,0.15,0.36363636363636365,0.0,0.4,5,0.75,0.75,Design 2,Design 2,"Have an option between Design #1 and Design #2,",,2.0,2.0
1942,412,2,Player object (854),sell,2023-02-26 00:20:00.552141+00:00,"{""priceA"": 125, ""sharesA"": 0, ""secs_since_round_starts"": 113, ""market"": ""A""}",180.0,20.0,5.0,nlp1gb1k,vmu7c279,FULL STUDY,135.0,s1,1,125,110.0,1,15.0,1,buy,0,sell,0.5223275507294591,16,0,0,block 3 (G second),20.0,12.0,Male,0.0,0.0,0.0,"[2, 'block 3 (G second)']",0,0,1,0.5,7.0,-0.30000000000000004,0.15,0.36363636363636365,0.0,0.4,5,0.75,0.75,Design 2,Design 2,"Have an option between Design #1 and Design #2,",,2.0,2.0
1943,413,2,Player object (854),buy,2023-02-26 00:20:22.312206+00:00,"{""priceA"": 160, ""sharesA"": 1, ""secs_since_round_starts"": 135, ""market"": ""A""}",20.0,24.0,6.0,nlp1gb1k,vmu7c279,FULL STUDY,135.0,s1,1,160,125.0,-1,,1,sell,0,sell,0.5912834651029929,16,0,0,block 3 (G second),20.0,12.0,Male,0.0,0.0,0.0,"[2, 'block 3 (G second)']",0,0,1,0.5,7.0,-0.30000000000000004,0.15,0.36363636363636365,0.0,0.4,5,0.75,0.75,Design 2,Design 2,"Have an option between Design #1 and Design #2,",,2.0,2.0
1944,414,2,Player object (854),sell,2023-02-26 00:20:30.928723+00:00,"{""priceA"": 145, ""sharesA"": 0, ""secs_since_round_starts"": 143, ""market"": ""A""}",165.0,25.0,7.0,nlp1gb1k,vmu7c279,FULL STUDY,135.0,s1,1,145,160.0,1,-15.0,1,buy,0,sell,0.5294358264188312,16,0,0,block 3 (G second),20.0,12.0,Male,0.0,0.0,0.0,"[2, 'block 3 (G second)']",0,0,1,0.5,7.0,-0.30000000000000004,0.15,0.36363636363636365,0.0,0.4,5,0.75,0.75,Design 2,Design 2,"Have an option between Design #1 and Design #2,",,2.0,2.0
1945,415,2,Player object (854),buy,2023-02-26 00:20:56.437875+00:00,"{""priceA"": 125, ""sharesA"": 1, ""secs_since_round_starts"": 169, ""market"": ""A""}",40.0,30.0,8.0,nlp1gb1k,vmu7c279,FULL STUDY,135.0,s1,1,125,145.0,-1,,1,sell,0,sell,0.4785999259850118,16,0,0,block 3 (G second),20.0,12.0,Male,0.0,0.0,0.0,"[2, 'block 3 (G second)']",0,0,1,0.5,7.0,-0.30000000000000004,0.15,0.36363636363636365,0.0,0.4,5,0.75,0.75,Design 2,Design 2,"Have an option between Design #1 and Design #2,",,2.0,2.0
1946,417,2,Player object (854),sell,2023-02-26 00:21:23.730080+00:00,"{""priceA"": 125, ""sharesA"": 0, ""secs_since_round_starts"": 196, ""market"": ""A""}",165.0,34.0,9.0,nlp1gb1k,vmu7c279,FULL STUDY,135.0,s1,1,125,125.0,1,0.0,1,buy,0,sell,0.4644502626891607,16,0,0,block 3 (G second),20.0,12.0,Male,0.0,0.0,0.0,"[2, 'block 3 (G second)']",0,0,1,0.5,7.0,-0.30000000000000004,0.15,0.36363636363636365,0.0,0.4,5,0.75,0.75,Design 2,Design 2,"Have an option between Design #1 and Design #2,",,2.0,2.0
1947,418,2,Player object (854),buy,2023-02-26 00:21:31.278750+00:00,"{""priceA"": 140, ""sharesA"": 1, ""secs_since_round_starts"": 204, ""market"": ""A""}",25.0,35.0,10.0,nlp1gb1k,vmu7c279,FULL STUDY,135.0,s1,1,140,125.0,-1,,1,sell,0,sell,0.5101876173062244,16,0,0,block 3 (G second),20.0,12.0,Male,0.0,0.0,0.0,"[2, 'block 3 (G second)']",0,0,1,0.5,7.0,-0.30000000000000004,0.15,0.36363636363636365,0.0,0.4,5,0.75,0.75,Design 2,Design 2,"Have an option between Design #1 and Design #2,",,2.0,2.0
1948,419,2,Player object (854),sell,2023-02-26 00:21:52.974975+00:00,"{""priceA"": 125, ""sharesA"": 0, ""secs_since_round_starts"": 225, ""market"": ""A""}",150.0,39.0,11.0,nlp1gb1k,vmu7c279,FULL STUDY,135.0,s1,1,125,140.0,1,-15.0,1,buy,0,sell,0.4382592777609274,16,1,0,block 3 (G second),20.0,12.0,Male,0.0,0.0,0.0,"[2, 'block 3 (G second)']",0,0,1,0.5,7.0,-0.30000000000000004,0.15,0.36363636363636365,0.0,0.4,5,0.75,0.75,Design 2,Design 2,"Have an option between Design #1 and Design #2,",,2.0,2.0
1949,420,2,Player object (854),buy,2023-02-26 00:22:10.422668+00:00,"{""priceA"": 130, ""sharesA"": 1, ""secs_since_round_starts"": 243, ""market"": ""A""}",20.0,42.0,12.0,nlp1gb1k,vmu7c279,FULL STUDY,135.0,s1,1,130,125.0,-1,,1,sell,0,sell,0.4369837361437204,16,0,0,block 3 (G second),20.0,12.0,Male,0.0,0.0,0.0,"[2, 'block 3 (G second)']",0,0,1,0.5,7.0,-0.30000000000000004,0.15,0.36363636363636365,0.0,0.4,5,0.75,0.75,Design 2,Design 2,"Have an option between Design #1 and Design #2,",,2.0,2.0
1950,421,2,Player object (854),sell,2023-02-26 00:22:36.710657+00:00,"{""priceA"": 140, ""sharesA"": 0, ""secs_since_round_starts"": 269, ""market"": ""A""}",160.0,47.0,13.0,nlp1gb1k,vmu7c279,FULL STUDY,135.0,s1,1,140,130.0,1,10.0,1,buy,0,sell,0.4996814899229063,16,0,0,block 3 (G second),20.0,12.0,Male,0.0,0.0,0.0,"[2, 'block 3 (G second)']",0,0,1,0.5,7.0,-0.30000000000000004,0.15,0.36363636363636365,0.0,0.4,5,0.75,0.75,Design 2,Design 2,"Have an option between Design #1 and Design #2,",,2.0,2.0
1951,422,2,Player object (854),buy,2023-02-26 00:22:42.716814+00:00,"{""priceA"": 155, ""sharesA"": 1, ""secs_since_round_starts"": 275, ""market"": ""A""}",5.0,48.0,14.0,nlp1gb1k,vmu7c279,FULL STUDY,135.0,s1,1,155,140.0,-1,,1,sell,0,sell,0.5347792584548927,16,0,0,block 3 (G second),20.0,12.0,Male,0.0,0.0,0.0,"[2, 'block 3 (G second)']",0,0,1,0.5,7.0,-0.30000000000000004,0.15,0.36363636363636365,0.0,0.4,5,0.75,0.75,Design 2,Design 2,"Have an option between Design #1 and Design #2,",,2.0,2.0
1952,423,2,Player object (854),sell,2023-02-26 00:22:57.611245+00:00,"{""priceA"": 140, ""sharesA"": 0, ""secs_since_round_starts"": 290, ""market"": ""A""}",145.0,51.0,15.0,nlp1gb1k,vmu7c279,FULL STUDY,135.0,s1,1,140,155.0,1,-15.0,1,buy,0,sell,0.4693918893964308,16,0,0,block 3 (G second),20.0,12.0,Male,0.0,0.0,0.0,"[2, 'block 3 (G second)']",0,0,1,0.5,7.0,-0.30000000000000004,0.15,0.36363636363636365,0.0,0.4,5,0.75,0.75,Design 2,Design 2,"Have an option between Design #1 and Design #2,",,2.0,2.0
1953,424,2,Player object (854),buy,2023-02-26 00:23:08.116484+00:00,"{""priceA"": 135, ""sharesA"": 1, ""secs_since_round_starts"": 301, ""market"": ""A""}",10.0,53.0,16.0,nlp1gb1k,vmu7c279,FULL STUDY,135.0,s1,1,135,140.0,-1,,1,sell,0,sell,0.4956940487416096,16,0,0,block 3 (G second),20.0,12.0,Male,0.0,0.0,0.0,"[2, 'block 3 (G second)']",0,0,1,0.5,7.0,-0.30000000000000004,0.15,0.36363636363636365,0.0,0.4,5,0.75,0.75,Design 2,Design 2,"Have an option between Design #1 and Design #2,",,2.0,2.0
1954,428,3,Player object (974),sell,2023-02-26 00:25:17.373921+00:00,"{""priceA"": 110, ""sharesA"": 0, ""secs_since_round_starts"": 80, ""market"": ""A""}",160.0,15.0,1.0,nlp1gb1k,vmu7c279,FULL STUDY,155.0,s1,1,110,,1,,1,,0,sell,0.4763410641166328,19,0,0,block 3 (G second),20.0,12.0,Male,0.0,0.0,0.0,"[3, 'block 3 (G second)']",0,1,1,0.0,7.0,-0.30000000000000004,0.2857142857142857,0.2777777777777778,0.4,0.0,2,0.5,0.5,Design 2,Design 2,"Have an option between Design #1 and Design #2,",,2.0,2.0
1955,429,3,Player object (974),buy,2023-02-26 00:25:27.818845+00:00,"{""priceA"": 105, ""sharesA"": 1, ""secs_since_round_starts"": 91, ""market"": ""A""}",55.0,17.0,2.0,nlp1gb1k,vmu7c279,FULL STUDY,155.0,s1,1,105,110.0,-1,,1,sell,0,sell,0.4990675303551922,19,0,0,block 3 (G second),20.0,12.0,Male,0.0,0.0,0.0,"[3, 'block 3 (G second)']",0,1,1,0.0,7.0,-0.30000000000000004,0.2857142857142857,0.2777777777777778,0.4,0.0,2,0.5,0.5,Design 2,Design 2,"Have an option between Design #1 and Design #2,",,2.0,2.0
1956,430,3,Player object (974),sell,2023-02-26 00:25:46.108767+00:00,"{""priceA"": 115, ""sharesA"": 0, ""secs_since_round_starts"": 109, ""market"": ""A""}",170.0,20.0,3.0,nlp1gb1k,vmu7c279,FULL STUDY,155.0,s1,1,115,105.0,1,10.0,1,buy,0,sell,0.5061230669509241,19,0,0,block 3 (G second),20.0,12.0,Male,0.0,0.0,0.0,"[3, 'block 3 (G second)']",0,1,1,0.0,7.0,-0.30000000000000004,0.2857142857142857,0.2777777777777778,0.4,0.0,2,0.5,0.5,Design 2,Design 2,"Have an option between Design #1 and Design #2,",,2.0,2.0
1957,433,3,Player object (974),buy,2023-02-26 00:26:05.997876+00:00,"{""priceA"": 115, ""sharesA"": 1, ""secs_since_round_starts"": 129, ""market"": ""A""}",55.0,24.0,5.0,nlp1gb1k,vmu7c279,FULL STUDY,155.0,s1,1,115,100.0,-1,,1,sell,0,sell,0.5319650978870379,19,0,0,block 3 (G second),20.0,12.0,Male,0.0,0.0,0.0,"[3, 'block 3 (G second)']",0,1,1,0.0,7.0,-0.30000000000000004,0.2857142857142857,0.2777777777777778,0.4,0.0,2,0.5,0.5,Design 2,Design 2,"Have an option between Design #1 and Design #2,",,2.0,2.0
1958,434,3,Player object (974),sell,2023-02-26 00:26:27.757485+00:00,"{""priceA"": 110, ""sharesA"": 0, ""secs_since_round_starts"": 150, ""market"": ""A""}",165.0,28.0,6.0,nlp1gb1k,vmu7c279,FULL STUDY,155.0,s1,1,110,115.0,1,-5.0,1,buy,0,sell,0.5233413838959273,19,0,0,block 3 (G second),20.0,12.0,Male,0.0,0.0,0.0,"[3, 'block 3 (G second)']",0,1,1,0.0,7.0,-0.30000000000000004,0.2857142857142857,0.2777777777777778,0.4,0.0,2,0.5,0.5,Design 2,Design 2,"Have an option between Design #1 and Design #2,",,2.0,2.0
1959,435,3,Player object (974),buy,2023-02-26 00:26:34.129722+00:00,"{""priceA"": 115, ""sharesA"": 1, ""secs_since_round_starts"": 157, ""market"": ""A""}",50.0,29.0,7.0,nlp1gb1k,vmu7c279,FULL STUDY,155.0,s1,1,115,110.0,-1,,1,sell,0,sell,0.5511004178331719,19,0,0,block 3 (G second),20.0,12.0,Male,0.0,0.0,0.0,"[3, 'block 3 (G second)']",0,1,1,0.0,7.0,-0.30000000000000004,0.2857142857142857,0.2777777777777778,0.4,0.0,2,0.5,0.5,Design 2,Design 2,"Have an option between Design #1 and Design #2,",,2.0,2.0
1960,437,3,Player object (974),sell,2023-02-26 00:26:58.332797+00:00,"{""priceA"": 110, ""sharesA"": 0, ""secs_since_round_starts"": 181, ""market"": ""A""}",160.0,32.0,8.0,nlp1gb1k,vmu7c279,FULL STUDY,155.0,s1,1,110,115.0,1,-5.0,1,buy,0,sell,0.4748947710808772,19,0,0,block 3 (G second),20.0,12.0,Male,0.0,0.0,0.0,"[3, 'block 3 (G second)']",0,1,1,0.0,7.0,-0.30000000000000004,0.2857142857142857,0.2777777777777778,0.4,0.0,2,0.5,0.5,Design 2,Design 2,"Have an option between Design #1 and Design #2,",,2.0,2.0
1961,438,3,Player object (974),buy,2023-02-26 00:27:07.185150+00:00,"{""priceA"": 110, ""sharesA"": 1, ""secs_since_round_starts"": 190, ""market"": ""A""}",50.0,34.0,9.0,nlp1gb1k,vmu7c279,FULL STUDY,155.0,s1,1,110,110.0,-1,,1,sell,0,sell,0.4983651933170437,19,0,0,block 3 (G second),20.0,12.0,Male,0.0,0.0,0.0,"[3, 'block 3 (G second)']",0,1,1,0.0,7.0,-0.30000000000000004,0.2857142857142857,0.2777777777777778,0.4,0.0,2,0.5,0.5,Design 2,Design 2,"Have an option between Design #1 and Design #2,",,2.0,2.0
1962,439,3,Player object (974),sell,2023-02-26 00:27:46.927944+00:00,"{""priceA"": 95, ""sharesA"": 0, ""secs_since_round_starts"": 230, ""market"": ""A""}",145.0,41.0,10.0,nlp1gb1k,vmu7c279,FULL STUDY,155.0,s1,1,95,110.0,1,-15.0,1,buy,0,sell,0.4514823197003955,19,0,0,block 3 (G second),20.0,12.0,Male,0.0,0.0,0.0,"[3, 'block 3 (G second)']",0,1,1,0.0,7.0,-0.30000000000000004,0.2857142857142857,0.2777777777777778,0.4,0.0,2,0.5,0.5,Design 2,Design 2,"Have an option between Design #1 and Design #2,",,2.0,2.0
1963,440,3,Player object (974),buy,2023-02-26 00:27:57.845469+00:00,"{""priceA"": 120, ""sharesA"": 1, ""secs_since_round_starts"": 241, ""market"": ""A""}",25.0,43.0,11.0,nlp1gb1k,vmu7c279,FULL STUDY,155.0,s1,1,120,95.0,-1,,1,sell,0,sell,0.5357259670782416,19,0,0,block 3 (G second),20.0,12.0,Male,0.0,0.0,0.0,"[3, 'block 3 (G second)']",0,1,1,0.0,7.0,-0.30000000000000004,0.2857142857142857,0.2777777777777778,0.4,0.0,2,0.5,0.5,Design 2,Design 2,"Have an option between Design #1 and Design #2,",,2.0,2.0
1964,441,3,Player object (974),sell,2023-02-26 00:28:05.550471+00:00,"{""priceA"": 135, ""sharesA"": 0, ""secs_since_round_starts"": 249, ""market"": ""A""}",160.0,44.0,12.0,nlp1gb1k,vmu7c279,FULL STUDY,155.0,s1,1,135,120.0,1,15.0,1,buy,0,sell,0.5595824488336746,19,0,1,block 3 (G second),20.0,12.0,Male,0.0,0.0,0.0,"[3, 'block 3 (G second)']",0,1,1,0.0,7.0,-0.30000000000000004,0.2857142857142857,0.2777777777777778,0.4,0.0,2,0.5,0.5,Design 2,Design 2,"Have an option between Design #1 and Design #2,",,2.0,2.0
1965,444,3,Player object (974),buy,2023-02-26 00:28:21.232754+00:00,"{""priceA"": 130, ""sharesA"": 1, ""secs_since_round_starts"": 264, ""market"": ""A""}",30.0,47.0,14.0,nlp1gb1k,vmu7c279,FULL STUDY,155.0,s1,1,130,135.0,-1,,1,sell,0,sell,0.4927309765460438,19,0,0,block 3 (G second),20.0,12.0,Male,0.0,0.0,0.0,"[3, 'block 3 (G second)']",0,1,1,0.0,7.0,-0.30000000000000004,0.2857142857142857,0.2777777777777778,0.4,0.0,2,0.5,0.5,Design 2,Design 2,"Have an option between Design #1 and Design #2,",,2.0,2.0
1966,445,3,Player object (974),sell,2023-02-26 00:28:25.203970+00:00,"{""priceA"": 125, ""sharesA"": 0, ""secs_since_round_starts"": 268, ""market"": ""A""}",155.0,48.0,15.0,nlp1gb1k,vmu7c279,FULL STUDY,155.0,s1,1,125,130.0,1,-5.0,1,buy,0,sell,0.4599698795591006,19,0,0,block 3 (G second),20.0,12.0,Male,0.0,0.0,0.0,"[3, 'block 3 (G second)']",0,1,1,0.0,7.0,-0.30000000000000004,0.2857142857142857,0.2777777777777778,0.4,0.0,2,0.5,0.5,Design 2,Design 2,"Have an option between Design #1 and Design #2,",,2.0,2.0
1967,446,3,Player object (974),buy,2023-02-26 00:28:36.413041+00:00,"{""priceA"": 125, ""sharesA"": 1, ""secs_since_round_starts"": 280, ""market"": ""A""}",30.0,50.0,16.0,nlp1gb1k,vmu7c279,FULL STUDY,155.0,s1,1,125,125.0,-1,,1,sell,0,sell,0.4911246412164243,19,0,0,block 3 (G second),20.0,12.0,Male,0.0,0.0,0.0,"[3, 'block 3 (G second)']",0,1,1,0.0,7.0,-0.30000000000000004,0.2857142857142857,0.2777777777777778,0.4,0.0,2,0.5,0.5,Design 2,Design 2,"Have an option between Design #1 and Design #2,",,2.0,2.0
1968,447,3,Player object (974),sell,2023-02-26 00:28:45.592850+00:00,"{""priceA"": 115, ""sharesA"": 0, ""secs_since_round_starts"": 289, ""market"": ""A""}",145.0,52.0,17.0,nlp1gb1k,vmu7c279,FULL STUDY,155.0,s1,1,115,125.0,1,-10.0,1,buy,0,sell,0.4367228334197354,19,0,0,block 3 (G second),20.0,12.0,Male,0.0,0.0,0.0,"[3, 'block 3 (G second)']",0,1,1,0.0,7.0,-0.30000000000000004,0.2857142857142857,0.2777777777777778,0.4,0.0,2,0.5,0.5,Design 2,Design 2,"Have an option between Design #1 and Design #2,",,2.0,2.0
1969,448,3,Player object (974),buy,2023-02-26 00:28:54.625041+00:00,"{""priceA"": 130, ""sharesA"": 1, ""secs_since_round_starts"": 298, ""market"": ""A""}",15.0,53.0,18.0,nlp1gb1k,vmu7c279,FULL STUDY,155.0,s1,1,130,115.0,-1,,1,sell,0,sell,0.4905868559773416,19,0,0,block 3 (G second),20.0,12.0,Male,0.0,0.0,0.0,"[3, 'block 3 (G second)']",0,1,1,0.0,7.0,-0.30000000000000004,0.2857142857142857,0.2777777777777778,0.4,0.0,2,0.5,0.5,Design 2,Design 2,"Have an option between Design #1 and Design #2,",,2.0,2.0
1970,449,3,Player object (974),sell,2023-02-26 00:29:07.192091+00:00,"{""priceA"": 150, ""sharesA"": 0, ""secs_since_round_starts"": 310, ""market"": ""A""}",165.0,55.0,19.0,nlp1gb1k,vmu7c279,FULL STUDY,155.0,s1,1,150,130.0,1,20.0,1,buy,0,sell,0.5546141592279494,19,0,1,block 3 (G second),20.0,12.0,Male,0.0,0.0,0.0,"[3, 'block 3 (G second)']",0,1,1,0.0,7.0,-0.30000000000000004,0.2857142857142857,0.2777777777777778,0.4,0.0,2,0.5,0.5,Design 2,Design 2,"Have an option between Design #1 and Design #2,",,2.0,2.0
1971,450,3,Player object (974),buy,2023-02-26 00:29:25.966273+00:00,"{""priceA"": 125, ""sharesA"": 1, ""secs_since_round_starts"": 329, ""market"": ""A""}",40.0,59.0,20.0,nlp1gb1k,vmu7c279,FULL STUDY,155.0,s1,1,125,150.0,-1,,1,sell,0,sell,0.4946618842475483,19,0,0,block 3 (G second),20.0,12.0,Male,0.0,0.0,0.0,"[3, 'block 3 (G second)']",0,1,1,0.0,7.0,-0.30000000000000004,0.2857142857142857,0.2777777777777778,0.4,0.0,2,0.5,0.5,Design 2,Design 2,"Have an option between Design #1 and Design #2,",,2.0,2.0
1972,455,4,Player object (1094),sell,2023-02-26 00:31:17.207172+00:00,"{""priceA"": 90, ""sharesA"": 0, ""secs_since_round_starts"": 97, ""market"": ""A""}",140.0,12.0,2.0,nlp1gb1k,vmu7c279,FULL STUDY,160.0,s1,1,90,40.0,1,50.0,1,,0,sell,0.5210961257750505,14,0,0,block 3 (G second),20.0,12.0,Male,0.0,0.0,0.0,"[4, 'block 3 (G second)']",1,0,1,0.0,7.0,-0.30000000000000004,0.36363636363636365,0.26666666666666666,0.25,0.0,1,0.75,0.75,Design 2,Design 2,"Have an option between Design #1 and Design #2,",,2.0,2.0
1973,456,4,Player object (1094),buy,2023-02-26 00:31:30.279421+00:00,"{""priceA"": 90, ""sharesA"": 1, ""secs_since_round_starts"": 110, ""market"": ""A""}",50.0,14.0,3.0,nlp1gb1k,vmu7c279,FULL STUDY,160.0,s1,1,90,90.0,-1,,1,sell,0,sell,0.5208618681016636,14,0,0,block 3 (G second),20.0,12.0,Male,0.0,0.0,0.0,"[4, 'block 3 (G second)']",1,0,1,0.0,7.0,-0.30000000000000004,0.36363636363636365,0.26666666666666666,0.25,0.0,1,0.75,0.75,Design 2,Design 2,"Have an option between Design #1 and Design #2,",,2.0,2.0
1974,457,4,Player object (1094),sell,2023-02-26 00:31:35.005705+00:00,"{""priceA"": 95, ""sharesA"": 0, ""secs_since_round_starts"": 115, ""market"": ""A""}",145.0,15.0,4.0,nlp1gb1k,vmu7c279,FULL STUDY,160.0,s1,1,95,90.0,1,5.0,1,buy,0,sell,0.5493972040799432,14,0,0,block 3 (G second),20.0,12.0,Male,0.0,0.0,0.0,"[4, 'block 3 (G second)']",1,0,1,0.0,7.0,-0.30000000000000004,0.36363636363636365,0.26666666666666666,0.25,0.0,1,0.75,0.75,Design 2,Design 2,"Have an option between Design #1 and Design #2,",,2.0,2.0
1975,458,4,Player object (1094),buy,2023-02-26 00:31:55.641248+00:00,"{""priceA"": 85, ""sharesA"": 1, ""secs_since_round_starts"": 136, ""market"": ""A""}",60.0,19.0,5.0,nlp1gb1k,vmu7c279,FULL STUDY,160.0,s1,1,85,95.0,-1,,1,sell,0,sell,0.4934202415852731,14,0,0,block 3 (G second),20.0,12.0,Male,0.0,0.0,0.0,"[4, 'block 3 (G second)']",1,0,1,0.0,7.0,-0.30000000000000004,0.36363636363636365,0.26666666666666666,0.25,0.0,1,0.75,0.75,Design 2,Design 2,"Have an option between Design #1 and Design #2,",,2.0,2.0
1976,459,4,Player object (1094),sell,2023-02-26 00:32:01.644614+00:00,"{""priceA"": 70, ""sharesA"": 0, ""secs_since_round_starts"": 141, ""market"": ""A""}",130.0,20.0,6.0,nlp1gb1k,vmu7c279,FULL STUDY,160.0,s1,1,70,85.0,1,-15.0,1,buy,0,sell,0.4604462199730844,14,0,0,block 3 (G second),20.0,12.0,Male,0.0,0.0,0.0,"[4, 'block 3 (G second)']",1,0,1,0.0,7.0,-0.30000000000000004,0.36363636363636365,0.26666666666666666,0.25,0.0,1,0.75,0.75,Design 2,Design 2,"Have an option between Design #1 and Design #2,",,2.0,2.0
1977,460,4,Player object (1094),buy,2023-02-26 00:32:17.385825+00:00,"{""priceA"": 65, ""sharesA"": 1, ""secs_since_round_starts"": 157, ""market"": ""A""}",65.0,23.0,7.0,nlp1gb1k,vmu7c279,FULL STUDY,160.0,s1,1,65,70.0,-1,,1,sell,0,sell,0.4803954371098747,14,0,0,block 3 (G second),20.0,12.0,Male,0.0,0.0,0.0,"[4, 'block 3 (G second)']",1,0,1,0.0,7.0,-0.30000000000000004,0.36363636363636365,0.26666666666666666,0.25,0.0,1,0.75,0.75,Design 2,Design 2,"Have an option between Design #1 and Design #2,",,2.0,2.0
1978,463,4,Player object (1094),sell,2023-02-26 00:32:56.562285+00:00,"{""priceA"": 85, ""sharesA"": 0, ""secs_since_round_starts"": 197, ""market"": ""A""}",150.0,30.0,9.0,nlp1gb1k,vmu7c279,FULL STUDY,160.0,s1,1,85,55.0,1,30.0,1,buy,0,sell,0.5151109892827086,14,0,0,block 3 (G second),20.0,12.0,Male,0.0,0.0,0.0,"[4, 'block 3 (G second)']",1,0,1,0.0,7.0,-0.30000000000000004,0.36363636363636365,0.26666666666666666,0.25,0.0,1,0.75,0.75,Design 2,Design 2,"Have an option between Design #1 and Design #2,",,2.0,2.0
1979,465,4,Player object (1094),buy,2023-02-26 00:33:29.574662+00:00,"{""priceA"": 100, ""sharesA"": 1, ""secs_since_round_starts"": 230, ""market"": ""A""}",50.0,35.0,10.0,nlp1gb1k,vmu7c279,FULL STUDY,160.0,s1,1,100,85.0,-1,,1,sell,0,sell,0.5337204628349665,14,0,0,block 3 (G second),20.0,12.0,Male,0.0,0.0,0.0,"[4, 'block 3 (G second)']",1,0,1,0.0,7.0,-0.30000000000000004,0.36363636363636365,0.26666666666666666,0.25,0.0,1,0.75,0.75,Design 2,Design 2,"Have an option between Design #1 and Design #2,",,2.0,2.0
1980,467,4,Player object (1094),sell,2023-02-26 00:33:41.488669+00:00,"{""priceA"": 85, ""sharesA"": 0, ""secs_since_round_starts"": 242, ""market"": ""A""}",135.0,36.0,11.0,nlp1gb1k,vmu7c279,FULL STUDY,160.0,s1,1,85,100.0,1,-15.0,1,buy,0,sell,0.4885269486642424,14,0,0,block 3 (G second),20.0,12.0,Male,0.0,0.0,0.0,"[4, 'block 3 (G second)']",1,0,1,0.0,7.0,-0.30000000000000004,0.36363636363636365,0.26666666666666666,0.25,0.0,1,0.75,0.75,Design 2,Design 2,"Have an option between Design #1 and Design #2,",,2.0,2.0
1981,468,4,Player object (1094),buy,2023-02-26 00:33:55.632761+00:00,"{""priceA"": 80, ""sharesA"": 1, ""secs_since_round_starts"": 256, ""market"": ""A""}",55.0,39.0,12.0,nlp1gb1k,vmu7c279,FULL STUDY,160.0,s1,1,80,85.0,-1,,1,sell,0,sell,0.4897180556691627,14,0,0,block 3 (G second),20.0,12.0,Male,0.0,0.0,0.0,"[4, 'block 3 (G second)']",1,0,1,0.0,7.0,-0.30000000000000004,0.36363636363636365,0.26666666666666666,0.25,0.0,1,0.75,0.75,Design 2,Design 2,"Have an option between Design #1 and Design #2,",,2.0,2.0
1982,469,4,Player object (1094),sell,2023-02-26 00:34:20.423933+00:00,"{""priceA"": 100, ""sharesA"": 0, ""secs_since_round_starts"": 280, ""market"": ""A""}",155.0,43.0,13.0,nlp1gb1k,vmu7c279,FULL STUDY,160.0,s1,1,100,80.0,1,20.0,1,buy,0,sell,0.5617190733230237,14,0,1,block 3 (G second),20.0,12.0,Male,0.0,0.0,0.0,"[4, 'block 3 (G second)']",1,0,1,0.0,7.0,-0.30000000000000004,0.36363636363636365,0.26666666666666666,0.25,0.0,1,0.75,0.75,Design 2,Design 2,"Have an option between Design #1 and Design #2,",,2.0,2.0
1983,472,4,Player object (1094),buy,2023-02-26 00:34:46.188775+00:00,"{""priceA"": 100, ""sharesA"": 1, ""secs_since_round_starts"": 306, ""market"": ""A""}",55.0,48.0,15.0,nlp1gb1k,vmu7c279,FULL STUDY,160.0,s1,1,100,100.0,-1,,1,sell,0,sell,0.500105737602651,14,0,0,block 3 (G second),20.0,12.0,Male,0.0,0.0,0.0,"[4, 'block 3 (G second)']",1,0,1,0.0,7.0,-0.30000000000000004,0.36363636363636365,0.26666666666666666,0.25,0.0,1,0.75,0.75,Design 2,Design 2,"Have an option between Design #1 and Design #2,",,2.0,2.0
1984,474,4,Player object (1094),sell,2023-02-26 00:35:06.449642+00:00,"{""priceA"": 105, ""sharesA"": 0, ""secs_since_round_starts"": 327, ""market"": ""A""}",160.0,51.0,16.0,nlp1gb1k,vmu7c279,FULL STUDY,160.0,s1,1,105,100.0,1,5.0,1,buy,0,sell,0.5064720763559888,14,0,0,block 3 (G second),20.0,12.0,Male,0.0,0.0,0.0,"[4, 'block 3 (G second)']",1,0,1,0.0,7.0,-0.30000000000000004,0.36363636363636365,0.26666666666666666,0.25,0.0,1,0.75,0.75,Design 2,Design 2,"Have an option between Design #1 and Design #2,",,2.0,2.0
1985,475,4,Player object (1094),buy,2023-02-26 00:35:23.807657+00:00,"{""priceA"": 85, ""sharesA"": 1, ""secs_since_round_starts"": 344, ""market"": ""A""}",75.0,54.0,17.0,nlp1gb1k,vmu7c279,FULL STUDY,160.0,s1,1,85,105.0,-1,,1,sell,0,sell,0.4957421237757241,14,0,0,block 3 (G second),20.0,12.0,Male,0.0,0.0,0.0,"[4, 'block 3 (G second)']",1,0,1,0.0,7.0,-0.30000000000000004,0.36363636363636365,0.26666666666666666,0.25,0.0,1,0.75,0.75,Design 2,Design 2,"Have an option between Design #1 and Design #2,",,2.0,2.0
1986,476,4,Player object (1094),sell,2023-02-26 00:35:28.521028+00:00,"{""priceA"": 70, ""sharesA"": 0, ""secs_since_round_starts"": 349, ""market"": ""A""}",145.0,55.0,18.0,nlp1gb1k,vmu7c279,FULL STUDY,160.0,s1,1,70,85.0,1,-15.0,1,buy,0,sell,0.4620518023886796,14,0,0,block 3 (G second),20.0,12.0,Male,0.0,0.0,0.0,"[4, 'block 3 (G second)']",1,0,1,0.0,7.0,-0.30000000000000004,0.36363636363636365,0.26666666666666666,0.25,0.0,1,0.75,0.75,Design 2,Design 2,"Have an option between Design #1 and Design #2,",,2.0,2.0
1987,477,4,Player object (1094),buy,2023-02-26 00:35:46.283058+00:00,"{""priceA"": 60, ""sharesA"": 1, ""secs_since_round_starts"": 366, ""market"": ""A""}",85.0,58.0,19.0,nlp1gb1k,vmu7c279,FULL STUDY,160.0,s1,1,60,70.0,-1,,1,sell,0,sell,0.4809250988502129,14,0,0,block 3 (G second),20.0,12.0,Male,0.0,0.0,0.0,"[4, 'block 3 (G second)']",1,0,1,0.0,7.0,-0.30000000000000004,0.36363636363636365,0.26666666666666666,0.25,0.0,1,0.75,0.75,Design 2,Design 2,"Have an option between Design #1 and Design #2,",,2.0,2.0
1988,481,5,Player object (1214),sell,2023-02-26 00:37:02.691781+00:00,"{""priceA"": 75, ""sharesA"": 0, ""secs_since_round_starts"": 57, ""market"": ""A""}",125.0,10.0,1.0,nlp1gb1k,vmu7c279,FULL STUDY,150.0,s1,1,75,,1,,1,,0,sell,0.4488309348307913,17,1,0,block 3 (G second),20.0,12.0,Male,0.0,0.0,0.0,"[5, 'block 3 (G second)']",1,1,1,0.0,7.0,-0.30000000000000004,0.25,0.35714285714285715,0.6666666666666666,0.3333333333333333,5,0.25,0.75,Design 2,Design 2,"Have an option between Design #1 and Design #2,",,2.0,2.0
1989,482,5,Player object (1214),buy,2023-02-26 00:37:03.565442+00:00,"{""priceA"": 85, ""sharesA"": 1, ""secs_since_round_starts"": 58, ""market"": ""A""}",40.0,11.0,2.0,nlp1gb1k,vmu7c279,FULL STUDY,150.0,s1,1,85,75.0,-1,,1,sell,0,sell,0.4991731929932316,17,0,0,block 3 (G second),20.0,12.0,Male,0.0,0.0,0.0,"[5, 'block 3 (G second)']",1,1,1,0.0,7.0,-0.30000000000000004,0.25,0.35714285714285715,0.6666666666666666,0.3333333333333333,5,0.25,0.75,Design 2,Design 2,"Have an option between Design #1 and Design #2,",,2.0,2.0
1990,485,5,Player object (1214),sell,2023-02-26 00:37:35.838113+00:00,"{""priceA"": 85, ""sharesA"": 0, ""secs_since_round_starts"": 90, ""market"": ""A""}",125.0,16.0,4.0,nlp1gb1k,vmu7c279,FULL STUDY,150.0,s1,1,85,85.0,1,0.0,1,buy,0,sell,0.4686291671454359,17,0,0,block 3 (G second),20.0,12.0,Male,0.0,0.0,0.0,"[5, 'block 3 (G second)']",1,1,1,0.0,7.0,-0.30000000000000004,0.25,0.35714285714285715,0.6666666666666666,0.3333333333333333,5,0.25,0.75,Design 2,Design 2,"Have an option between Design #1 and Design #2,",,2.0,2.0
1991,486,5,Player object (1214),buy,2023-02-26 00:37:49.268227+00:00,"{""priceA"": 80, ""sharesA"": 1, ""secs_since_round_starts"": 104, ""market"": ""A""}",45.0,19.0,5.0,nlp1gb1k,vmu7c279,FULL STUDY,150.0,s1,1,80,85.0,-1,,1,sell,0,sell,0.4830991506082083,17,0,0,block 3 (G second),20.0,12.0,Male,0.0,0.0,0.0,"[5, 'block 3 (G second)']",1,1,1,0.0,7.0,-0.30000000000000004,0.25,0.35714285714285715,0.6666666666666666,0.3333333333333333,5,0.25,0.75,Design 2,Design 2,"Have an option between Design #1 and Design #2,",,2.0,2.0
1992,487,5,Player object (1214),sell,2023-02-26 00:38:03.456959+00:00,"{""priceA"": 105, ""sharesA"": 0, ""secs_since_round_starts"": 118, ""market"": ""A""}",150.0,21.0,6.0,nlp1gb1k,vmu7c279,FULL STUDY,150.0,s1,1,105,80.0,1,25.0,1,buy,0,sell,0.5510362930796925,17,0,1,block 3 (G second),20.0,12.0,Male,0.0,0.0,0.0,"[5, 'block 3 (G second)']",1,1,1,0.0,7.0,-0.30000000000000004,0.25,0.35714285714285715,0.6666666666666666,0.3333333333333333,5,0.25,0.75,Design 2,Design 2,"Have an option between Design #1 and Design #2,",,2.0,2.0
1993,490,5,Player object (1214),buy,2023-02-26 00:38:52.846359+00:00,"{""priceA"": 70, ""sharesA"": 1, ""secs_since_round_starts"": 167, ""market"": ""A""}",80.0,30.0,8.0,nlp1gb1k,vmu7c279,FULL STUDY,150.0,s1,1,70,105.0,-1,,1,sell,0,sell,0.4174526841611717,17,0,0,block 3 (G second),20.0,12.0,Male,0.0,0.0,0.0,"[5, 'block 3 (G second)']",1,1,1,0.0,7.0,-0.30000000000000004,0.25,0.35714285714285715,0.6666666666666666,0.3333333333333333,5,0.25,0.75,Design 2,Design 2,"Have an option between Design #1 and Design #2,",,2.0,2.0
1994,492,5,Player object (1214),sell,2023-02-26 00:39:18.466667+00:00,"{""priceA"": 125, ""sharesA"": 0, ""secs_since_round_starts"": 193, ""market"": ""A""}",205.0,35.0,9.0,nlp1gb1k,vmu7c279,FULL STUDY,150.0,s1,1,125,70.0,1,55.0,1,buy,0,sell,0.5814696428244381,17,0,0,block 3 (G second),20.0,12.0,Male,0.0,0.0,0.0,"[5, 'block 3 (G second)']",1,1,1,0.0,7.0,-0.30000000000000004,0.25,0.35714285714285715,0.6666666666666666,0.3333333333333333,5,0.25,0.75,Design 2,Design 2,"Have an option between Design #1 and Design #2,",,2.0,2.0
1995,493,5,Player object (1214),buy,2023-02-26 00:39:22.918102+00:00,"{""priceA"": 110, ""sharesA"": 1, ""secs_since_round_starts"": 197, ""market"": ""A""}",95.0,36.0,10.0,nlp1gb1k,vmu7c279,FULL STUDY,150.0,s1,1,110,125.0,-1,,1,sell,0,sell,0.5223936301876935,17,0,0,block 3 (G second),20.0,12.0,Male,0.0,0.0,0.0,"[5, 'block 3 (G second)']",1,1,1,0.0,7.0,-0.30000000000000004,0.25,0.35714285714285715,0.6666666666666666,0.3333333333333333,5,0.25,0.75,Design 2,Design 2,"Have an option between Design #1 and Design #2,",,2.0,2.0
1996,495,5,Player object (1214),sell,2023-02-26 00:39:32.446574+00:00,"{""priceA"": 95, ""sharesA"": 0, ""secs_since_round_starts"": 207, ""market"": ""A""}",190.0,37.0,11.0,nlp1gb1k,vmu7c279,FULL STUDY,150.0,s1,1,95,110.0,1,-15.0,1,buy,0,sell,0.4805886028013266,17,0,0,block 3 (G second),20.0,12.0,Male,0.0,0.0,0.0,"[5, 'block 3 (G second)']",1,1,1,0.0,7.0,-0.30000000000000004,0.25,0.35714285714285715,0.6666666666666666,0.3333333333333333,5,0.25,0.75,Design 2,Design 2,"Have an option between Design #1 and Design #2,",,2.0,2.0
1997,498,5,Player object (1214),buy,2023-02-26 00:39:47.834385+00:00,"{""priceA"": 80, ""sharesA"": 1, ""secs_since_round_starts"": 222, ""market"": ""A""}",110.0,40.0,13.0,nlp1gb1k,vmu7c279,FULL STUDY,150.0,s1,1,80,70.0,-1,,1,sell,0,sell,0.4870698015370814,17,0,0,block 3 (G second),20.0,12.0,Male,0.0,0.0,0.0,"[5, 'block 3 (G second)']",1,1,1,0.0,7.0,-0.30000000000000004,0.25,0.35714285714285715,0.6666666666666666,0.3333333333333333,5,0.25,0.75,Design 2,Design 2,"Have an option between Design #1 and Design #2,",,2.0,2.0
1998,499,5,Player object (1214),sell,2023-02-26 00:40:01.432604+00:00,"{""priceA"": 100, ""sharesA"": 0, ""secs_since_round_starts"": 236, ""market"": ""A""}",210.0,42.0,14.0,nlp1gb1k,vmu7c279,FULL STUDY,150.0,s1,1,100,80.0,1,20.0,1,buy,0,sell,0.5529358605422235,17,0,1,block 3 (G second),20.0,12.0,Male,0.0,0.0,0.0,"[5, 'block 3 (G second)']",1,1,1,0.0,7.0,-0.30000000000000004,0.25,0.35714285714285715,0.6666666666666666,0.3333333333333333,5,0.25,0.75,Design 2,Design 2,"Have an option between Design #1 and Design #2,",,2.0,2.0
1999,500,5,Player object (1214),buy,2023-02-26 00:40:17.419120+00:00,"{""priceA"": 110, ""sharesA"": 1, ""secs_since_round_starts"": 252, ""market"": ""A""}",100.0,45.0,15.0,nlp1gb1k,vmu7c279,FULL STUDY,150.0,s1,1,110,100.0,-1,,1,sell,0,sell,0.5454506058480159,17,0,0,block 3 (G second),20.0,12.0,Male,0.0,0.0,0.0,"[5, 'block 3 (G second)']",1,1,1,0.0,7.0,-0.30000000000000004,0.25,0.35714285714285715,0.6666666666666666,0.3333333333333333,5,0.25,0.75,Design 2,Design 2,"Have an option between Design #1 and Design #2,",,2.0,2.0
2000,502,5,Player object (1214),sell,2023-02-26 00:40:27.002560+00:00,"{""priceA"": 95, ""sharesA"": 0, ""secs_since_round_starts"": 261, ""market"": ""A""}",195.0,46.0,16.0,nlp1gb1k,vmu7c279,FULL STUDY,150.0,s1,1,95,110.0,1,-15.0,1,buy,0,sell,0.4967862103563366,17,0,0,block 3 (G second),20.0,12.0,Male,0.0,0.0,0.0,"[5, 'block 3 (G second)']",1,1,1,0.0,7.0,-0.30000000000000004,0.25,0.35714285714285715,0.6666666666666666,0.3333333333333333,5,0.25,0.75,Design 2,Design 2,"Have an option between Design #1 and Design #2,",,2.0,2.0
2001,503,5,Player object (1214),buy,2023-02-26 00:40:42.941756+00:00,"{""priceA"": 85, ""sharesA"": 1, ""secs_since_round_starts"": 277, ""market"": ""A""}",110.0,49.0,17.0,nlp1gb1k,vmu7c279,FULL STUDY,150.0,s1,1,85,95.0,-1,,1,sell,0,sell,0.4924841505562556,17,0,0,block 3 (G second),20.0,12.0,Male,0.0,0.0,0.0,"[5, 'block 3 (G second)']",1,1,1,0.0,7.0,-0.30000000000000004,0.25,0.35714285714285715,0.6666666666666666,0.3333333333333333,5,0.25,0.75,Design 2,Design 2,"Have an option between Design #1 and Design #2,",,2.0,2.0
2002,506,5,Player object (1214),sell,2023-02-26 00:41:06.079987+00:00,"{""priceA"": 85, ""sharesA"": 0, ""secs_since_round_starts"": 300, ""market"": ""A""}",195.0,53.0,19.0,nlp1gb1k,vmu7c279,FULL STUDY,150.0,s1,1,85,70.0,1,15.0,1,buy,0,sell,0.4927925471404216,17,0,0,block 3 (G second),20.0,12.0,Male,0.0,0.0,0.0,"[5, 'block 3 (G second)']",1,1,1,0.0,7.0,-0.30000000000000004,0.25,0.35714285714285715,0.6666666666666666,0.3333333333333333,5,0.25,0.75,Design 2,Design 2,"Have an option between Design #1 and Design #2,",,2.0,2.0
2003,507,5,Player object (1214),buy,2023-02-26 00:41:10.434062+00:00,"{""priceA"": 95, ""sharesA"": 1, ""secs_since_round_starts"": 305, ""market"": ""A""}",100.0,54.0,20.0,nlp1gb1k,vmu7c279,FULL STUDY,150.0,s1,1,95,85.0,-1,,1,sell,0,sell,0.5299980248683189,17,0,0,block 3 (G second),20.0,12.0,Male,0.0,0.0,0.0,"[5, 'block 3 (G second)']",1,1,1,0.0,7.0,-0.30000000000000004,0.25,0.35714285714285715,0.6666666666666666,0.3333333333333333,5,0.25,0.75,Design 2,Design 2,"Have an option between Design #1 and Design #2,",,2.0,2.0
2004,509,5,Player object (1214),sell,2023-02-26 00:41:23.337042+00:00,"{""priceA"": 80, ""sharesA"": 0, ""secs_since_round_starts"": 318, ""market"": ""A""}",180.0,55.0,21.0,nlp1gb1k,vmu7c279,FULL STUDY,150.0,s1,1,80,95.0,1,-15.0,1,buy,0,sell,0.4859141076178286,17,0,0,block 3 (G second),20.0,12.0,Male,0.0,0.0,0.0,"[5, 'block 3 (G second)']",1,1,1,0.0,7.0,-0.30000000000000004,0.25,0.35714285714285715,0.6666666666666666,0.3333333333333333,5,0.25,0.75,Design 2,Design 2,"Have an option between Design #1 and Design #2,",,2.0,2.0
2005,510,5,Player object (1214),buy,2023-02-26 00:41:28.150277+00:00,"{""priceA"": 95, ""sharesA"": 1, ""secs_since_round_starts"": 322, ""market"": ""A""}",85.0,56.0,22.0,nlp1gb1k,vmu7c279,FULL STUDY,150.0,s1,1,95,80.0,-1,,1,sell,0,sell,0.5252108989343294,17,0,0,block 3 (G second),20.0,12.0,Male,0.0,0.0,0.0,"[5, 'block 3 (G second)']",1,1,1,0.0,7.0,-0.30000000000000004,0.25,0.35714285714285715,0.6666666666666666,0.3333333333333333,5,0.25,0.75,Design 2,Design 2,"Have an option between Design #1 and Design #2,",,2.0,2.0
2006,513,5,Player object (1214),sell,2023-02-26 00:41:47.515654+00:00,"{""priceA"": 65, ""sharesA"": 0, ""secs_since_round_starts"": 342, ""market"": ""A""}",150.0,60.0,24.0,nlp1gb1k,vmu7c279,FULL STUDY,150.0,s1,1,65,75.0,1,-10.0,1,buy,0,sell,0.4189820782479906,17,0,0,block 3 (G second),20.0,12.0,Male,0.0,0.0,0.0,"[5, 'block 3 (G second)']",1,1,1,0.0,7.0,-0.30000000000000004,0.25,0.35714285714285715,0.6666666666666666,0.3333333333333333,5,0.25,0.75,Design 2,Design 2,"Have an option between Design #1 and Design #2,",,2.0,2.0
2007,5242,2,Player object (1523),sell,2023-03-10 13:22:54.203473+00:00,"{""priceA"": 120, ""sharesA"": 0, ""secs_since_round_starts"": 91, ""market"": ""A""}",170.0,15.0,1.0,op23dxig,t7od4xlw,FULL STUDY,170.0,s3,1,120,,1,,1,,0,sell,0.5761373211134116,16,0,0,block 4 (G second),23.0,12.0,Female,0.0,0.0,0.0,"[2, 'block 4 (G second)']",0,1,1,0.5,3.0,-0.7,0.25,0.0,0.0,0.0,2,0.5,0.25,Design 2,Design 1,"Have an option between Design #1 and Design #2,",2.0,2.0,3.0
2008,5265,3,Player object (1703),sell,2023-03-10 13:28:13.802699+00:00,"{""priceA"": 130, ""sharesA"": 0, ""secs_since_round_starts"": 63, ""market"": ""A""}",180.0,13.0,1.0,op23dxig,t7od4xlw,FULL STUDY,180.0,s3,1,130,,1,,1,,0,sell,0.5729625045047859,19,0,1,block 4 (G second),23.0,12.0,Female,0.0,0.0,0.0,"[3, 'block 4 (G second)']",0,0,1,0.5,3.0,-0.7,0.25,0.0,1.0,0.0,2,0.5,0.25,Design 2,Design 1,"Have an option between Design #1 and Design #2,",2.0,2.0,3.0
2009,5324,4,Player object (1883),sell,2023-03-10 13:37:10.835545+00:00,"{""priceA"": 105, ""sharesA"": 0, ""secs_since_round_starts"": 271, ""market"": ""A""}",155.0,49.0,1.0,op23dxig,t7od4xlw,FULL STUDY,165.0,s3,1,105,,1,,1,,0,sell,0.5350732746090608,14,0,0,block 4 (G second),23.0,12.0,Female,0.0,0.0,0.0,"[4, 'block 4 (G second)']",1,1,1,0.5,3.0,-0.7,0.25,0.0,0.0,0.0,2,1.0,0.25,Design 2,Design 1,"Have an option between Design #1 and Design #2,",2.0,2.0,3.0
2010,5328,4,Player object (1883),buy,2023-03-10 13:37:48.166925+00:00,"{""priceA"": 65, ""sharesA"": 1, ""secs_since_round_starts"": 309, ""market"": ""A""}",90.0,56.0,2.0,op23dxig,t7od4xlw,FULL STUDY,165.0,s3,1,65,105.0,-1,,1,sell,0,sell,0.4388999887324031,14,0,0,block 4 (G second),23.0,12.0,Female,0.0,0.0,0.0,"[4, 'block 4 (G second)']",1,1,1,0.5,3.0,-0.7,0.25,0.0,0.0,0.0,2,1.0,0.25,Design 2,Design 1,"Have an option between Design #1 and Design #2,",2.0,2.0,3.0
2011,5349,5,Player object (2063),sell,2023-03-10 13:40:28.102582+00:00,"{""priceA"": 105, ""sharesA"": 0, ""secs_since_round_starts"": 130, ""market"": ""A""}",155.0,24.0,1.0,op23dxig,t7od4xlw,FULL STUDY,230.0,s3,1,105,,1,,1,,0,sell,0.5594334008058068,17,0,0,block 4 (G second),23.0,12.0,Female,0.0,0.0,0.0,"[5, 'block 4 (G second)']",1,0,1,0.5,3.0,-0.7,0.15,0.0,0.0,0.0,2,1.0,0.25,Design 2,Design 1,"Have an option between Design #1 and Design #2,",2.0,2.0,3.0
2012,5353,5,Player object (2063),buy,2023-03-10 13:40:59.107528+00:00,"{""priceA"": 70, ""sharesA"": 1, ""secs_since_round_starts"": 161, ""market"": ""A""}",85.0,30.0,2.0,op23dxig,t7od4xlw,FULL STUDY,230.0,s3,1,70,105.0,-1,,1,sell,0,sell,0.4174526841611717,17,0,0,block 4 (G second),23.0,12.0,Female,0.0,0.0,0.0,"[5, 'block 4 (G second)']",1,0,1,0.5,3.0,-0.7,0.15,0.0,0.0,0.0,2,1.0,0.25,Design 2,Design 1,"Have an option between Design #1 and Design #2,",2.0,2.0,3.0
2013,5362,5,Player object (2063),sell,2023-03-10 13:41:32.372432+00:00,"{""priceA"": 125, ""sharesA"": 0, ""secs_since_round_starts"": 194, ""market"": ""A""}",210.0,35.0,3.0,op23dxig,t7od4xlw,FULL STUDY,230.0,s3,1,125,70.0,1,55.0,1,buy,0,sell,0.5814696428244381,17,0,0,block 4 (G second),23.0,12.0,Female,0.0,0.0,0.0,"[5, 'block 4 (G second)']",1,0,1,0.5,3.0,-0.7,0.15,0.0,0.0,0.0,2,1.0,0.25,Design 2,Design 1,"Have an option between Design #1 and Design #2,",2.0,2.0,3.0
2014,5364,5,Player object (2063),buy,2023-03-10 13:41:49.950837+00:00,"{""priceA"": 80, ""sharesA"": 1, ""secs_since_round_starts"": 211, ""market"": ""A""}",130.0,38.0,4.0,op23dxig,t7od4xlw,FULL STUDY,230.0,s3,1,80,125.0,-1,,1,sell,0,sell,0.4515999245786187,17,1,0,block 4 (G second),23.0,12.0,Female,0.0,0.0,0.0,"[5, 'block 4 (G second)']",1,0,1,0.5,3.0,-0.7,0.15,0.0,0.0,0.0,2,1.0,0.25,Design 2,Design 1,"Have an option between Design #1 and Design #2,",2.0,2.0,3.0
2015,5368,5,Player object (2063),sell,2023-03-10 13:42:24.129055+00:00,"{""priceA"": 110, ""sharesA"": 0, ""secs_since_round_starts"": 246, ""market"": ""A""}",240.0,45.0,5.0,op23dxig,t7od4xlw,FULL STUDY,230.0,s3,1,110,80.0,1,30.0,1,buy,0,sell,0.5454506058480159,17,0,0,block 4 (G second),23.0,12.0,Female,0.0,0.0,0.0,"[5, 'block 4 (G second)']",1,0,1,0.5,3.0,-0.7,0.15,0.0,0.0,0.0,2,1.0,0.25,Design 2,Design 1,"Have an option between Design #1 and Design #2,",2.0,2.0,3.0
2016,5373,5,Player object (2063),buy,2023-03-10 13:42:43.360428+00:00,"{""priceA"": 75, ""sharesA"": 1, ""secs_since_round_starts"": 265, ""market"": ""A""}",165.0,48.0,6.0,op23dxig,t7od4xlw,FULL STUDY,230.0,s3,1,75,110.0,-1,,1,sell,0,sell,0.4393932183506925,17,1,0,block 4 (G second),23.0,12.0,Female,0.0,0.0,0.0,"[5, 'block 4 (G second)']",1,0,1,0.5,3.0,-0.7,0.15,0.0,0.0,0.0,2,1.0,0.25,Design 2,Design 1,"Have an option between Design #1 and Design #2,",2.0,2.0,3.0
2017,1396,2,Player object (877),sell,2023-03-05 22:45:42.389187+00:00,"{""priceA"": 120, ""sharesA"": 0, ""secs_since_round_starts"": 123, ""market"": ""A""}",170.0,15.0,2.0,ot80gep3,vmu7c279,FULL STUDY,205.0,s1,1,120,80.0,1,40.0,1,,0,sell,0.5761373211134116,16,0,0,block 3 (G second),21.0,12.0,Female,1.0,1.0,1.0,"[2, 'block 3 (G second)']",0,0,1,0.5,7.0,-0.30000000000000004,0.38461538461538464,0.043478260869565216,0.0,0.0,4,1.0,1.0,Design 1,Design 2,"Have an option between Design #1 and Design #2,",,5.0,5.0
2018,1397,2,Player object (877),buy,2023-03-05 22:45:47.778556+00:00,"{""priceA"": 105, ""sharesA"": 1, ""secs_since_round_starts"": 129, ""market"": ""A""}",65.0,16.0,3.0,ot80gep3,vmu7c279,FULL STUDY,205.0,s1,1,105,120.0,-1,,1,sell,0,sell,0.5185790363913291,16,0,0,block 3 (G second),21.0,12.0,Female,1.0,1.0,1.0,"[2, 'block 3 (G second)']",0,0,1,0.5,7.0,-0.30000000000000004,0.38461538461538464,0.043478260869565216,0.0,0.0,4,1.0,1.0,Design 1,Design 2,"Have an option between Design #1 and Design #2,",,5.0,5.0
2019,1400,2,Player object (877),sell,2023-03-05 22:45:59.179573+00:00,"{""priceA"": 125, ""sharesA"": 0, ""secs_since_round_starts"": 140, ""market"": ""A""}",190.0,18.0,5.0,ot80gep3,vmu7c279,FULL STUDY,205.0,s1,1,125,110.0,1,15.0,1,buy,0,sell,0.5678304910935957,16,0,0,block 3 (G second),21.0,12.0,Female,1.0,1.0,1.0,"[2, 'block 3 (G second)']",0,0,1,0.5,7.0,-0.30000000000000004,0.38461538461538464,0.043478260869565216,0.0,0.0,4,1.0,1.0,Design 1,Design 2,"Have an option between Design #1 and Design #2,",,5.0,5.0
2020,1401,2,Player object (877),buy,2023-03-05 22:46:09.703844+00:00,"{""priceA"": 125, ""sharesA"": 1, ""secs_since_round_starts"": 151, ""market"": ""A""}",65.0,20.0,6.0,ot80gep3,vmu7c279,FULL STUDY,205.0,s1,1,125,125.0,-1,,1,sell,0,sell,0.5223275507294591,16,0,0,block 3 (G second),21.0,12.0,Female,1.0,1.0,1.0,"[2, 'block 3 (G second)']",0,0,1,0.5,7.0,-0.30000000000000004,0.38461538461538464,0.043478260869565216,0.0,0.0,4,1.0,1.0,Design 1,Design 2,"Have an option between Design #1 and Design #2,",,5.0,5.0
2021,1402,2,Player object (877),sell,2023-03-05 22:46:15.288475+00:00,"{""priceA"": 130, ""sharesA"": 0, ""secs_since_round_starts"": 156, ""market"": ""A""}",195.0,21.0,7.0,ot80gep3,vmu7c279,FULL STUDY,205.0,s1,1,130,125.0,1,5.0,1,buy,0,sell,0.5504042050217014,16,0,0,block 3 (G second),21.0,12.0,Female,1.0,1.0,1.0,"[2, 'block 3 (G second)']",0,0,1,0.5,7.0,-0.30000000000000004,0.38461538461538464,0.043478260869565216,0.0,0.0,4,1.0,1.0,Design 1,Design 2,"Have an option between Design #1 and Design #2,",,5.0,5.0
2022,1403,2,Player object (877),buy,2023-03-05 22:46:27.607608+00:00,"{""priceA"": 150, ""sharesA"": 1, ""secs_since_round_starts"": 169, ""market"": ""A""}",45.0,23.0,8.0,ot80gep3,vmu7c279,FULL STUDY,205.0,s1,1,150,130.0,-1,,1,sell,0,sell,0.5825581483921976,16,0,1,block 3 (G second),21.0,12.0,Female,1.0,1.0,1.0,"[2, 'block 3 (G second)']",0,0,1,0.5,7.0,-0.30000000000000004,0.38461538461538464,0.043478260869565216,0.0,0.0,4,1.0,1.0,Design 1,Design 2,"Have an option between Design #1 and Design #2,",,5.0,5.0
2023,1407,2,Player object (877),sell,2023-03-05 22:47:43.229540+00:00,"{""priceA"": 140, ""sharesA"": 0, ""secs_since_round_starts"": 244, ""market"": ""A""}",185.0,35.0,10.0,ot80gep3,vmu7c279,FULL STUDY,205.0,s1,1,140,145.0,1,-5.0,1,buy,0,sell,0.5101876173062244,16,0,0,block 3 (G second),21.0,12.0,Female,1.0,1.0,1.0,"[2, 'block 3 (G second)']",0,0,1,0.5,7.0,-0.30000000000000004,0.38461538461538464,0.043478260869565216,0.0,0.0,4,1.0,1.0,Design 1,Design 2,"Have an option between Design #1 and Design #2,",,5.0,5.0
2024,1410,2,Player object (877),buy,2023-03-05 22:48:05.099615+00:00,"{""priceA"": 125, ""sharesA"": 1, ""secs_since_round_starts"": 266, ""market"": ""A""}",60.0,39.0,12.0,ot80gep3,vmu7c279,FULL STUDY,205.0,s1,1,125,150.0,-1,,1,sell,0,sell,0.4382592777609274,16,1,0,block 3 (G second),21.0,12.0,Female,1.0,1.0,1.0,"[2, 'block 3 (G second)']",0,0,1,0.5,7.0,-0.30000000000000004,0.38461538461538464,0.043478260869565216,0.0,0.0,4,1.0,1.0,Design 1,Design 2,"Have an option between Design #1 and Design #2,",,5.0,5.0
2025,1411,2,Player object (877),sell,2023-03-05 22:48:10.702055+00:00,"{""priceA"": 140, ""sharesA"": 0, ""secs_since_round_starts"": 272, ""market"": ""A""}",200.0,40.0,13.0,ot80gep3,vmu7c279,FULL STUDY,205.0,s1,1,140,125.0,1,15.0,1,buy,0,sell,0.4916787423410894,16,0,0,block 3 (G second),21.0,12.0,Female,1.0,1.0,1.0,"[2, 'block 3 (G second)']",0,0,1,0.5,7.0,-0.30000000000000004,0.38461538461538464,0.043478260869565216,0.0,0.0,4,1.0,1.0,Design 1,Design 2,"Have an option between Design #1 and Design #2,",,5.0,5.0
2026,1412,2,Player object (877),buy,2023-03-05 22:48:16.586462+00:00,"{""priceA"": 135, ""sharesA"": 1, ""secs_since_round_starts"": 278, ""market"": ""A""}",65.0,41.0,14.0,ot80gep3,vmu7c279,FULL STUDY,205.0,s1,1,135,140.0,-1,,1,sell,0,sell,0.4592429496222846,16,0,0,block 3 (G second),21.0,12.0,Female,1.0,1.0,1.0,"[2, 'block 3 (G second)']",0,0,1,0.5,7.0,-0.30000000000000004,0.38461538461538464,0.043478260869565216,0.0,0.0,4,1.0,1.0,Design 1,Design 2,"Have an option between Design #1 and Design #2,",,5.0,5.0
2027,1413,2,Player object (877),sell,2023-03-05 22:48:40.088338+00:00,"{""priceA"": 140, ""sharesA"": 0, ""secs_since_round_starts"": 301, ""market"": ""A""}",205.0,45.0,15.0,ot80gep3,vmu7c279,FULL STUDY,205.0,s1,1,140,135.0,1,5.0,1,buy,0,sell,0.5210834711709403,16,0,0,block 3 (G second),21.0,12.0,Female,1.0,1.0,1.0,"[2, 'block 3 (G second)']",0,0,1,0.5,7.0,-0.30000000000000004,0.38461538461538464,0.043478260869565216,0.0,0.0,4,1.0,1.0,Design 1,Design 2,"Have an option between Design #1 and Design #2,",,5.0,5.0
2028,1414,2,Player object (877),buy,2023-03-05 22:49:16.659501+00:00,"{""priceA"": 125, ""sharesA"": 1, ""secs_since_round_starts"": 338, ""market"": ""A""}",80.0,52.0,16.0,ot80gep3,vmu7c279,FULL STUDY,205.0,s1,1,125,140.0,-1,,1,sell,0,sell,0.4439176376077041,16,1,0,block 3 (G second),21.0,12.0,Female,1.0,1.0,1.0,"[2, 'block 3 (G second)']",0,0,1,0.5,7.0,-0.30000000000000004,0.38461538461538464,0.043478260869565216,0.0,0.0,4,1.0,1.0,Design 1,Design 2,"Have an option between Design #1 and Design #2,",,5.0,5.0
2029,1420,3,Player object (997),sell,2023-03-05 22:50:55.452093+00:00,"{""priceA"": 110, ""sharesA"": 0, ""secs_since_round_starts"": 43, ""market"": ""A""}",160.0,9.0,2.0,ot80gep3,vmu7c279,FULL STUDY,215.0,s1,1,110,90.0,1,20.0,1,,0,sell,0.5389563723055646,19,0,0,block 3 (G second),21.0,12.0,Female,1.0,1.0,1.0,"[3, 'block 3 (G second)']",0,1,1,0.5,7.0,-0.30000000000000004,0.45454545454545453,0.0,1.0,0.0,1,0.25,0.75,Design 1,Design 2,"Have an option between Design #1 and Design #2,",,5.0,5.0
2030,1421,3,Player object (997),buy,2023-03-05 22:51:33.777361+00:00,"{""priceA"": 100, ""sharesA"": 1, ""secs_since_round_starts"": 82, ""market"": ""A""}",60.0,16.0,3.0,ot80gep3,vmu7c279,FULL STUDY,215.0,s1,1,100,110.0,-1,,1,sell,0,sell,0.4486815727575955,19,1,0,block 3 (G second),21.0,12.0,Female,1.0,1.0,1.0,"[3, 'block 3 (G second)']",0,1,1,0.5,7.0,-0.30000000000000004,0.45454545454545453,0.0,1.0,0.0,1,0.25,0.75,Design 1,Design 2,"Have an option between Design #1 and Design #2,",,5.0,5.0
2031,1422,3,Player object (997),sell,2023-03-05 22:51:50.508723+00:00,"{""priceA"": 120, ""sharesA"": 0, ""secs_since_round_starts"": 98, ""market"": ""A""}",180.0,19.0,4.0,ot80gep3,vmu7c279,FULL STUDY,215.0,s1,1,120,100.0,1,20.0,1,buy,0,sell,0.5586446427659006,19,0,1,block 3 (G second),21.0,12.0,Female,1.0,1.0,1.0,"[3, 'block 3 (G second)']",0,1,1,0.5,7.0,-0.30000000000000004,0.45454545454545453,0.0,1.0,0.0,1,0.25,0.75,Design 1,Design 2,"Have an option between Design #1 and Design #2,",,5.0,5.0
2032,1423,3,Player object (997),buy,2023-03-05 22:52:01.517452+00:00,"{""priceA"": 100, ""sharesA"": 1, ""secs_since_round_starts"": 109, ""market"": ""A""}",80.0,21.0,5.0,ot80gep3,vmu7c279,FULL STUDY,215.0,s1,1,100,120.0,-1,,1,sell,0,sell,0.4692484881524699,19,0,0,block 3 (G second),21.0,12.0,Female,1.0,1.0,1.0,"[3, 'block 3 (G second)']",0,1,1,0.5,7.0,-0.30000000000000004,0.45454545454545453,0.0,1.0,0.0,1,0.25,0.75,Design 1,Design 2,"Have an option between Design #1 and Design #2,",,5.0,5.0
2033,1424,3,Player object (997),sell,2023-03-05 22:52:24.415367+00:00,"{""priceA"": 110, ""sharesA"": 0, ""secs_since_round_starts"": 132, ""market"": ""A""}",190.0,25.0,6.0,ot80gep3,vmu7c279,FULL STUDY,215.0,s1,1,110,100.0,1,10.0,1,buy,0,sell,0.4872943409941583,19,0,0,block 3 (G second),21.0,12.0,Female,1.0,1.0,1.0,"[3, 'block 3 (G second)']",0,1,1,0.5,7.0,-0.30000000000000004,0.45454545454545453,0.0,1.0,0.0,1,0.25,0.75,Design 1,Design 2,"Have an option between Design #1 and Design #2,",,5.0,5.0
2034,1426,3,Player object (997),buy,2023-03-05 22:53:13.990718+00:00,"{""priceA"": 100, ""sharesA"": 1, ""secs_since_round_starts"": 182, ""market"": ""A""}",90.0,33.0,7.0,ot80gep3,vmu7c279,FULL STUDY,215.0,s1,1,100,110.0,-1,,1,sell,0,sell,0.4476889957041811,19,1,0,block 3 (G second),21.0,12.0,Female,1.0,1.0,1.0,"[3, 'block 3 (G second)']",0,1,1,0.5,7.0,-0.30000000000000004,0.45454545454545453,0.0,1.0,0.0,1,0.25,0.75,Design 1,Design 2,"Have an option between Design #1 and Design #2,",,5.0,5.0
2035,1427,3,Player object (997),sell,2023-03-05 22:53:47.065096+00:00,"{""priceA"": 115, ""sharesA"": 0, ""secs_since_round_starts"": 215, ""market"": ""A""}",205.0,39.0,8.0,ot80gep3,vmu7c279,FULL STUDY,215.0,s1,1,115,100.0,1,15.0,1,buy,0,sell,0.5221490272476892,19,0,0,block 3 (G second),21.0,12.0,Female,1.0,1.0,1.0,"[3, 'block 3 (G second)']",0,1,1,0.5,7.0,-0.30000000000000004,0.45454545454545453,0.0,1.0,0.0,1,0.25,0.75,Design 1,Design 2,"Have an option between Design #1 and Design #2,",,5.0,5.0
2036,1428,3,Player object (997),buy,2023-03-05 22:53:51.437233+00:00,"{""priceA"": 100, ""sharesA"": 1, ""secs_since_round_starts"": 219, ""market"": ""A""}",105.0,40.0,9.0,ot80gep3,vmu7c279,FULL STUDY,215.0,s1,1,100,115.0,-1,,1,sell,0,sell,0.4804175727303482,19,0,0,block 3 (G second),21.0,12.0,Female,1.0,1.0,1.0,"[3, 'block 3 (G second)']",0,1,1,0.5,7.0,-0.30000000000000004,0.45454545454545453,0.0,1.0,0.0,1,0.25,0.75,Design 1,Design 2,"Have an option between Design #1 and Design #2,",,5.0,5.0
2037,1429,3,Player object (997),sell,2023-03-05 22:54:07.830674+00:00,"{""priceA"": 120, ""sharesA"": 0, ""secs_since_round_starts"": 236, ""market"": ""A""}",225.0,43.0,10.0,ot80gep3,vmu7c279,FULL STUDY,215.0,s1,1,120,100.0,1,20.0,1,buy,0,sell,0.5357259670782416,19,0,0,block 3 (G second),21.0,12.0,Female,1.0,1.0,1.0,"[3, 'block 3 (G second)']",0,1,1,0.5,7.0,-0.30000000000000004,0.45454545454545453,0.0,1.0,0.0,1,0.25,0.75,Design 1,Design 2,"Have an option between Design #1 and Design #2,",,5.0,5.0
2038,1430,3,Player object (997),buy,2023-03-05 22:55:35.838404+00:00,"{""priceA"": 125, ""sharesA"": 1, ""secs_since_round_starts"": 324, ""market"": ""A""}",100.0,59.0,11.0,ot80gep3,vmu7c279,FULL STUDY,215.0,s1,1,125,120.0,-1,,1,sell,0,sell,0.4946618842475483,19,0,0,block 3 (G second),21.0,12.0,Female,1.0,1.0,1.0,"[3, 'block 3 (G second)']",0,1,1,0.5,7.0,-0.30000000000000004,0.45454545454545453,0.0,1.0,0.0,1,0.25,0.75,Design 1,Design 2,"Have an option between Design #1 and Design #2,",,5.0,5.0
2039,1436,4,Player object (1117),sell,2023-03-05 22:56:29.221018+00:00,"{""priceA"": 45, ""sharesA"": 0, ""secs_since_round_starts"": 39, ""market"": ""A""}",95.0,7.0,2.0,ot80gep3,vmu7c279,FULL STUDY,110.0,s1,1,45,40.0,1,5.0,1,,0,sell,0.4686531252667821,14,0,0,block 3 (G second),21.0,12.0,Female,1.0,1.0,1.0,"[4, 'block 3 (G second)']",1,0,1,0.5,7.0,-0.30000000000000004,1.0,0.10714285714285714,1.0,0.14285714285714285,2,1.0,0.5,Design 1,Design 2,"Have an option between Design #1 and Design #2,",,5.0,5.0
2040,1437,4,Player object (1117),buy,2023-03-05 22:56:33.408281+00:00,"{""priceA"": 55, ""sharesA"": 1, ""secs_since_round_starts"": 44, ""market"": ""A""}",40.0,8.0,3.0,ot80gep3,vmu7c279,FULL STUDY,110.0,s1,1,55,45.0,-1,,1,sell,0,sell,0.5131395645435063,14,0,0,block 3 (G second),21.0,12.0,Female,1.0,1.0,1.0,"[4, 'block 3 (G second)']",1,0,1,0.5,7.0,-0.30000000000000004,1.0,0.10714285714285714,1.0,0.14285714285714285,2,1.0,0.5,Design 1,Design 2,"Have an option between Design #1 and Design #2,",,5.0,5.0
2041,1438,4,Player object (1117),sell,2023-03-05 22:56:38.308386+00:00,"{""priceA"": 70, ""sharesA"": 0, ""secs_since_round_starts"": 48, ""market"": ""A""}",110.0,9.0,4.0,ot80gep3,vmu7c279,FULL STUDY,110.0,s1,1,70,55.0,1,15.0,1,buy,0,sell,0.5440818519127735,14,0,1,block 3 (G second),21.0,12.0,Female,1.0,1.0,1.0,"[4, 'block 3 (G second)']",1,0,1,0.5,7.0,-0.30000000000000004,1.0,0.10714285714285714,1.0,0.14285714285714285,2,1.0,0.5,Design 1,Design 2,"Have an option between Design #1 and Design #2,",,5.0,5.0
2042,1439,4,Player object (1117),buy,2023-03-05 22:56:46.955586+00:00,"{""priceA"": 80, ""sharesA"": 1, ""secs_since_round_starts"": 57, ""market"": ""A""}",30.0,10.0,5.0,ot80gep3,vmu7c279,FULL STUDY,110.0,s1,1,80,70.0,-1,,1,sell,0,sell,0.5652817482669988,14,0,0,block 3 (G second),21.0,12.0,Female,1.0,1.0,1.0,"[4, 'block 3 (G second)']",1,0,1,0.5,7.0,-0.30000000000000004,1.0,0.10714285714285714,1.0,0.14285714285714285,2,1.0,0.5,Design 1,Design 2,"Have an option between Design #1 and Design #2,",,5.0,5.0
2043,1440,4,Player object (1117),sell,2023-03-05 22:56:49.160340+00:00,"{""priceA"": 95, ""sharesA"": 0, ""secs_since_round_starts"": 59, ""market"": ""A""}",125.0,11.0,6.0,ot80gep3,vmu7c279,FULL STUDY,110.0,s1,1,95,80.0,1,15.0,1,buy,0,sell,0.5796571916404338,14,0,0,block 3 (G second),21.0,12.0,Female,1.0,1.0,1.0,"[4, 'block 3 (G second)']",1,0,1,0.5,7.0,-0.30000000000000004,1.0,0.10714285714285714,1.0,0.14285714285714285,2,1.0,0.5,Design 1,Design 2,"Have an option between Design #1 and Design #2,",,5.0,5.0
2044,1441,4,Player object (1117),buy,2023-03-05 22:57:00.647729+00:00,"{""priceA"": 75, ""sharesA"": 1, ""secs_since_round_starts"": 71, ""market"": ""A""}",50.0,13.0,7.0,ot80gep3,vmu7c279,FULL STUDY,110.0,s1,1,75,95.0,-1,,1,sell,0,sell,0.479681559969247,14,0,0,block 3 (G second),21.0,12.0,Female,1.0,1.0,1.0,"[4, 'block 3 (G second)']",1,0,1,0.5,7.0,-0.30000000000000004,1.0,0.10714285714285714,1.0,0.14285714285714285,2,1.0,0.5,Design 1,Design 2,"Have an option between Design #1 and Design #2,",,5.0,5.0
2045,1442,4,Player object (1117),sell,2023-03-05 22:57:05.517007+00:00,"{""priceA"": 90, ""sharesA"": 0, ""secs_since_round_starts"": 76, ""market"": ""A""}",140.0,14.0,8.0,ot80gep3,vmu7c279,FULL STUDY,110.0,s1,1,90,75.0,1,15.0,1,buy,0,sell,0.5208618681016636,14,0,0,block 3 (G second),21.0,12.0,Female,1.0,1.0,1.0,"[4, 'block 3 (G second)']",1,0,1,0.5,7.0,-0.30000000000000004,1.0,0.10714285714285714,1.0,0.14285714285714285,2,1.0,0.5,Design 1,Design 2,"Have an option between Design #1 and Design #2,",,5.0,5.0
2046,1443,4,Player object (1117),buy,2023-03-05 22:57:18.350108+00:00,"{""priceA"": 90, ""sharesA"": 1, ""secs_since_round_starts"": 89, ""market"": ""A""}",50.0,16.0,9.0,ot80gep3,vmu7c279,FULL STUDY,110.0,s1,1,90,90.0,-1,,1,sell,0,sell,0.4995738325599586,14,0,0,block 3 (G second),21.0,12.0,Female,1.0,1.0,1.0,"[4, 'block 3 (G second)']",1,0,1,0.5,7.0,-0.30000000000000004,1.0,0.10714285714285714,1.0,0.14285714285714285,2,1.0,0.5,Design 1,Design 2,"Have an option between Design #1 and Design #2,",,5.0,5.0
2047,1447,4,Player object (1117),sell,2023-03-05 22:58:27.604970+00:00,"{""priceA"": 80, ""sharesA"": 0, ""secs_since_round_starts"": 158, ""market"": ""A""}",130.0,28.0,11.0,ot80gep3,vmu7c279,FULL STUDY,110.0,s1,1,80,55.0,1,25.0,1,buy,0,sell,0.5529051331090981,14,0,1,block 3 (G second),21.0,12.0,Female,1.0,1.0,1.0,"[4, 'block 3 (G second)']",1,0,1,0.5,7.0,-0.30000000000000004,1.0,0.10714285714285714,1.0,0.14285714285714285,2,1.0,0.5,Design 1,Design 2,"Have an option between Design #1 and Design #2,",,5.0,5.0
2048,1449,4,Player object (1117),buy,2023-03-05 22:59:15.813486+00:00,"{""priceA"": 85, ""sharesA"": 1, ""secs_since_round_starts"": 206, ""market"": ""A""}",45.0,36.0,12.0,ot80gep3,vmu7c279,FULL STUDY,110.0,s1,1,85,80.0,-1,,1,sell,0,sell,0.4885269486642424,14,0,0,block 3 (G second),21.0,12.0,Female,1.0,1.0,1.0,"[4, 'block 3 (G second)']",1,0,1,0.5,7.0,-0.30000000000000004,1.0,0.10714285714285714,1.0,0.14285714285714285,2,1.0,0.5,Design 1,Design 2,"Have an option between Design #1 and Design #2,",,5.0,5.0
2049,1450,4,Player object (1117),sell,2023-03-05 22:59:44.121917+00:00,"{""priceA"": 80, ""sharesA"": 0, ""secs_since_round_starts"": 234, ""market"": ""A""}",125.0,41.0,13.0,ot80gep3,vmu7c279,FULL STUDY,110.0,s1,1,80,85.0,1,-5.0,1,buy,0,sell,0.5055693706451859,14,0,0,block 3 (G second),21.0,12.0,Female,1.0,1.0,1.0,"[4, 'block 3 (G second)']",1,0,1,0.5,7.0,-0.30000000000000004,1.0,0.10714285714285714,1.0,0.14285714285714285,2,1.0,0.5,Design 1,Design 2,"Have an option between Design #1 and Design #2,",,5.0,5.0
2050,1451,4,Player object (1117),buy,2023-03-05 23:00:43.451621+00:00,"{""priceA"": 90, ""sharesA"": 1, ""secs_since_round_starts"": 294, ""market"": ""A""}",35.0,52.0,14.0,ot80gep3,vmu7c279,FULL STUDY,110.0,s1,1,90,80.0,-1,,1,sell,0,sell,0.4694909620846048,14,0,0,block 3 (G second),21.0,12.0,Female,1.0,1.0,1.0,"[4, 'block 3 (G second)']",1,0,1,0.5,7.0,-0.30000000000000004,1.0,0.10714285714285714,1.0,0.14285714285714285,2,1.0,0.5,Design 1,Design 2,"Have an option between Design #1 and Design #2,",,5.0,5.0
2051,1455,5,Player object (1237),sell,2023-03-05 23:02:13.535608+00:00,"{""priceA"": 90, ""sharesA"": 0, ""secs_since_round_starts"": 37, ""market"": ""A""}",140.0,8.0,1.0,ot80gep3,vmu7c279,FULL STUDY,245.0,s1,1,90,,1,,1,,0,sell,0.5166236645513725,17,0,0,block 3 (G second),21.0,12.0,Female,1.0,1.0,1.0,"[5, 'block 3 (G second)']",1,1,1,0.5,7.0,-0.30000000000000004,0.5,0.07142857142857142,0.5,0.0,5,0.25,1.0,Design 1,Design 2,"Have an option between Design #1 and Design #2,",,5.0,5.0
2052,1456,5,Player object (1237),buy,2023-03-05 23:02:24.169752+00:00,"{""priceA"": 75, ""sharesA"": 1, ""secs_since_round_starts"": 48, ""market"": ""A""}",65.0,10.0,2.0,ot80gep3,vmu7c279,FULL STUDY,245.0,s1,1,75,90.0,-1,,1,sell,0,sell,0.4488309348307913,17,1,0,block 3 (G second),21.0,12.0,Female,1.0,1.0,1.0,"[5, 'block 3 (G second)']",1,1,1,0.5,7.0,-0.30000000000000004,0.5,0.07142857142857142,0.5,0.0,5,0.25,1.0,Design 1,Design 2,"Have an option between Design #1 and Design #2,",,5.0,5.0
2053,1457,5,Player object (1237),sell,2023-03-05 23:02:39.449943+00:00,"{""priceA"": 100, ""sharesA"": 0, ""secs_since_round_starts"": 63, ""market"": ""A""}",165.0,12.0,3.0,ot80gep3,vmu7c279,FULL STUDY,245.0,s1,1,100,75.0,1,25.0,1,buy,0,sell,0.5344269279803172,17,0,0,block 3 (G second),21.0,12.0,Female,1.0,1.0,1.0,"[5, 'block 3 (G second)']",1,1,1,0.5,7.0,-0.30000000000000004,0.5,0.07142857142857142,0.5,0.0,5,0.25,1.0,Design 1,Design 2,"Have an option between Design #1 and Design #2,",,5.0,5.0
2054,1458,5,Player object (1237),buy,2023-03-05 23:02:46.848839+00:00,"{""priceA"": 80, ""sharesA"": 1, ""secs_since_round_starts"": 70, ""market"": ""A""}",85.0,14.0,4.0,ot80gep3,vmu7c279,FULL STUDY,245.0,s1,1,80,100.0,-1,,1,sell,0,sell,0.457409789643144,17,0,0,block 3 (G second),21.0,12.0,Female,1.0,1.0,1.0,"[5, 'block 3 (G second)']",1,1,1,0.5,7.0,-0.30000000000000004,0.5,0.07142857142857142,0.5,0.0,5,0.25,1.0,Design 1,Design 2,"Have an option between Design #1 and Design #2,",,5.0,5.0
2055,1459,5,Player object (1237),sell,2023-03-05 23:02:55.656206+00:00,"{""priceA"": 90, ""sharesA"": 0, ""secs_since_round_starts"": 79, ""market"": ""A""}",175.0,15.0,5.0,ot80gep3,vmu7c279,FULL STUDY,245.0,s1,1,90,80.0,1,10.0,1,buy,0,sell,0.505231414156075,17,0,0,block 3 (G second),21.0,12.0,Female,1.0,1.0,1.0,"[5, 'block 3 (G second)']",1,1,1,0.5,7.0,-0.30000000000000004,0.5,0.07142857142857142,0.5,0.0,5,0.25,1.0,Design 1,Design 2,"Have an option between Design #1 and Design #2,",,5.0,5.0
2056,1460,5,Player object (1237),buy,2023-03-05 23:03:03.398531+00:00,"{""priceA"": 80, ""sharesA"": 1, ""secs_since_round_starts"": 87, ""market"": ""A""}",95.0,17.0,6.0,ot80gep3,vmu7c279,FULL STUDY,245.0,s1,1,80,90.0,-1,,1,sell,0,sell,0.4433955626702647,17,0,0,block 3 (G second),21.0,12.0,Female,1.0,1.0,1.0,"[5, 'block 3 (G second)']",1,1,1,0.5,7.0,-0.30000000000000004,0.5,0.07142857142857142,0.5,0.0,5,0.25,1.0,Design 1,Design 2,"Have an option between Design #1 and Design #2,",,5.0,5.0
2057,1461,5,Player object (1237),sell,2023-03-05 23:03:20.046607+00:00,"{""priceA"": 95, ""sharesA"": 0, ""secs_since_round_starts"": 104, ""market"": ""A""}",190.0,20.0,7.0,ot80gep3,vmu7c279,FULL STUDY,245.0,s1,1,95,80.0,1,15.0,1,buy,0,sell,0.5232479875730728,17,0,0,block 3 (G second),21.0,12.0,Female,1.0,1.0,1.0,"[5, 'block 3 (G second)']",1,1,1,0.5,7.0,-0.30000000000000004,0.5,0.07142857142857142,0.5,0.0,5,0.25,1.0,Design 1,Design 2,"Have an option between Design #1 and Design #2,",,5.0,5.0
2058,1462,5,Player object (1237),buy,2023-03-05 23:03:58.717669+00:00,"{""priceA"": 100, ""sharesA"": 1, ""secs_since_round_starts"": 142, ""market"": ""A""}",90.0,27.0,8.0,ot80gep3,vmu7c279,FULL STUDY,245.0,s1,1,100,95.0,-1,,1,sell,0,sell,0.4777068930880888,17,0,0,block 3 (G second),21.0,12.0,Female,1.0,1.0,1.0,"[5, 'block 3 (G second)']",1,1,1,0.5,7.0,-0.30000000000000004,0.5,0.07142857142857142,0.5,0.0,5,0.25,1.0,Design 1,Design 2,"Have an option between Design #1 and Design #2,",,5.0,5.0
2059,1464,5,Player object (1237),sell,2023-03-05 23:04:33.657499+00:00,"{""priceA"": 110, ""sharesA"": 0, ""secs_since_round_starts"": 177, ""market"": ""A""}",200.0,33.0,9.0,ot80gep3,vmu7c279,FULL STUDY,245.0,s1,1,110,100.0,1,10.0,1,buy,0,sell,0.5480287979668599,17,0,1,block 3 (G second),21.0,12.0,Female,1.0,1.0,1.0,"[5, 'block 3 (G second)']",1,1,1,0.5,7.0,-0.30000000000000004,0.5,0.07142857142857142,0.5,0.0,5,0.25,1.0,Design 1,Design 2,"Have an option between Design #1 and Design #2,",,5.0,5.0
2060,1465,5,Player object (1237),buy,2023-03-05 23:05:00.708237+00:00,"{""priceA"": 80, ""sharesA"": 1, ""secs_since_round_starts"": 204, ""market"": ""A""}",120.0,38.0,10.0,ot80gep3,vmu7c279,FULL STUDY,245.0,s1,1,80,110.0,-1,,1,sell,0,sell,0.4515999245786187,17,1,0,block 3 (G second),21.0,12.0,Female,1.0,1.0,1.0,"[5, 'block 3 (G second)']",1,1,1,0.5,7.0,-0.30000000000000004,0.5,0.07142857142857142,0.5,0.0,5,0.25,1.0,Design 1,Design 2,"Have an option between Design #1 and Design #2,",,5.0,5.0
2061,1467,5,Player object (1237),sell,2023-03-05 23:05:31.942684+00:00,"{""priceA"": 110, ""sharesA"": 0, ""secs_since_round_starts"": 236, ""market"": ""A""}",230.0,43.0,11.0,ot80gep3,vmu7c279,FULL STUDY,245.0,s1,1,110,80.0,1,30.0,1,buy,0,sell,0.571300234525265,17,0,0,block 3 (G second),21.0,12.0,Female,1.0,1.0,1.0,"[5, 'block 3 (G second)']",1,1,1,0.5,7.0,-0.30000000000000004,0.5,0.07142857142857142,0.5,0.0,5,0.25,1.0,Design 1,Design 2,"Have an option between Design #1 and Design #2,",,5.0,5.0
2062,1468,5,Player object (1237),buy,2023-03-05 23:05:59.204264+00:00,"{""priceA"": 75, ""sharesA"": 1, ""secs_since_round_starts"": 263, ""market"": ""A""}",155.0,48.0,12.0,ot80gep3,vmu7c279,FULL STUDY,245.0,s1,1,75,110.0,-1,,1,sell,0,sell,0.4393932183506925,17,1,0,block 3 (G second),21.0,12.0,Female,1.0,1.0,1.0,"[5, 'block 3 (G second)']",1,1,1,0.5,7.0,-0.30000000000000004,0.5,0.07142857142857142,0.5,0.0,5,0.25,1.0,Design 1,Design 2,"Have an option between Design #1 and Design #2,",,5.0,5.0
2063,1471,5,Player object (1237),sell,2023-03-05 23:06:32.366033+00:00,"{""priceA"": 95, ""sharesA"": 0, ""secs_since_round_starts"": 296, ""market"": ""A""}",250.0,54.0,14.0,ot80gep3,vmu7c279,FULL STUDY,245.0,s1,1,95,85.0,1,10.0,1,buy,0,sell,0.5299980248683189,17,0,0,block 3 (G second),21.0,12.0,Female,1.0,1.0,1.0,"[5, 'block 3 (G second)']",1,1,1,0.5,7.0,-0.30000000000000004,0.5,0.07142857142857142,0.5,0.0,5,0.25,1.0,Design 1,Design 2,"Have an option between Design #1 and Design #2,",,5.0,5.0
2064,1472,5,Player object (1237),buy,2023-03-05 23:06:37.765868+00:00,"{""priceA"": 80, ""sharesA"": 1, ""secs_since_round_starts"": 301, ""market"": ""A""}",170.0,55.0,15.0,ot80gep3,vmu7c279,FULL STUDY,245.0,s1,1,80,95.0,-1,,1,sell,0,sell,0.4859141076178286,17,0,0,block 3 (G second),21.0,12.0,Female,1.0,1.0,1.0,"[5, 'block 3 (G second)']",1,1,1,0.5,7.0,-0.30000000000000004,0.5,0.07142857142857142,0.5,0.0,5,0.25,1.0,Design 1,Design 2,"Have an option between Design #1 and Design #2,",,5.0,5.0
2065,1474,5,Player object (1237),sell,2023-03-05 23:06:46.743626+00:00,"{""priceA"": 95, ""sharesA"": 0, ""secs_since_round_starts"": 310, ""market"": ""A""}",265.0,56.0,16.0,ot80gep3,vmu7c279,FULL STUDY,245.0,s1,1,95,80.0,1,15.0,1,buy,0,sell,0.5252108989343294,17,0,0,block 3 (G second),21.0,12.0,Female,1.0,1.0,1.0,"[5, 'block 3 (G second)']",1,1,1,0.5,7.0,-0.30000000000000004,0.5,0.07142857142857142,0.5,0.0,5,0.25,1.0,Design 1,Design 2,"Have an option between Design #1 and Design #2,",,5.0,5.0
2066,1475,5,Player object (1237),buy,2023-03-05 23:06:52.181414+00:00,"{""priceA"": 85, ""sharesA"": 1, ""secs_since_round_starts"": 316, ""market"": ""A""}",180.0,57.0,17.0,ot80gep3,vmu7c279,FULL STUDY,245.0,s1,1,85,95.0,-1,,1,sell,0,sell,0.4825596920859898,17,0,0,block 3 (G second),21.0,12.0,Female,1.0,1.0,1.0,"[5, 'block 3 (G second)']",1,1,1,0.5,7.0,-0.30000000000000004,0.5,0.07142857142857142,0.5,0.0,5,0.25,1.0,Design 1,Design 2,"Have an option between Design #1 and Design #2,",,5.0,5.0
2067,1772,2,Player object (888),sell,2023-03-07 15:05:28.625529+00:00,"{""priceA"": 90, ""sharesA"": 0, ""secs_since_round_starts"": 225, ""market"": ""A""}",140.0,33.0,1.0,p4esvzkg,vmu7c279,FULL STUDY,155.0,s4,1,90,,1,,1,,0,sell,0.5,0,0,0,block 4 (G second),23.0,10.0,Male,0.0,0.0,0.0,"[2, 'block 4 (G second)']",0,1,1,0.5,3.0,-0.5333333333333334,0.14285714285714285,0.03571428571428571,0.5,0.0,3,1.0,1.0,Design 2,Design 2,"Have an option between Design #1 and Design #2,",4.0,,
2068,1773,2,Player object (888),buy,2023-03-07 15:05:51.053350+00:00,"{""priceA"": 50, ""sharesA"": 1, ""secs_since_round_starts"": 247, ""market"": ""A""}",90.0,37.0,2.0,p4esvzkg,vmu7c279,FULL STUDY,155.0,s4,1,50,90.0,-1,,1,sell,0,sell,0.5,0,0,0,block 4 (G second),23.0,10.0,Male,0.0,0.0,0.0,"[2, 'block 4 (G second)']",0,1,1,0.5,3.0,-0.5333333333333334,0.14285714285714285,0.03571428571428571,0.5,0.0,3,1.0,1.0,Design 2,Design 2,"Have an option between Design #1 and Design #2,",4.0,,
2069,1774,2,Player object (888),sell,2023-03-07 15:06:57.166366+00:00,"{""priceA"": 65, ""sharesA"": 0, ""secs_since_round_starts"": 313, ""market"": ""A""}",155.0,49.0,3.0,p4esvzkg,vmu7c279,FULL STUDY,155.0,s4,1,65,50.0,1,15.0,1,buy,0,sell,0.5,0,0,1,block 4 (G second),23.0,10.0,Male,0.0,0.0,0.0,"[2, 'block 4 (G second)']",0,1,1,0.5,3.0,-0.5333333333333334,0.14285714285714285,0.03571428571428571,0.5,0.0,3,1.0,1.0,Design 2,Design 2,"Have an option between Design #1 and Design #2,",4.0,,
2070,1778,3,Player object (1008),sell,2023-03-07 15:09:08.466304+00:00,"{""priceA"": 130, ""sharesA"": 0, ""secs_since_round_starts"": 63, ""market"": ""A""}",180.0,10.0,1.0,p4esvzkg,vmu7c279,FULL STUDY,225.0,s4,1,130,,1,,1,,0,sell,0.5,0,0,1,block 4 (G second),23.0,10.0,Male,0.0,0.0,0.0,"[3, 'block 4 (G second)']",0,0,1,1.0,3.0,-0.5333333333333334,0.18181818181818182,0.0,0.5,0.0,2,0.75,0.75,Design 2,Design 2,"Have an option between Design #1 and Design #2,",4.0,,
2071,1780,3,Player object (1008),buy,2023-03-07 15:11:37.224308+00:00,"{""priceA"": 145, ""sharesA"": 1, ""secs_since_round_starts"": 211, ""market"": ""A""}",35.0,37.0,2.0,p4esvzkg,vmu7c279,FULL STUDY,225.0,s4,1,145,130.0,-1,,1,sell,0,sell,0.5,0,0,0,block 4 (G second),23.0,10.0,Male,0.0,0.0,0.0,"[3, 'block 4 (G second)']",0,0,1,1.0,3.0,-0.5333333333333334,0.18181818181818182,0.0,0.5,0.0,2,0.75,0.75,Design 2,Design 2,"Have an option between Design #1 and Design #2,",4.0,,
2072,1781,3,Player object (1008),sell,2023-03-07 15:12:46.263780+00:00,"{""priceA"": 165, ""sharesA"": 0, ""secs_since_round_starts"": 280, ""market"": ""A""}",200.0,49.0,3.0,p4esvzkg,vmu7c279,FULL STUDY,225.0,s4,1,165,145.0,1,20.0,1,buy,0,sell,0.5,0,0,0,block 4 (G second),23.0,10.0,Male,0.0,0.0,0.0,"[3, 'block 4 (G second)']",0,0,1,1.0,3.0,-0.5333333333333334,0.18181818181818182,0.0,0.5,0.0,2,0.75,0.75,Design 2,Design 2,"Have an option between Design #1 and Design #2,",4.0,,
2073,1782,3,Player object (1008),buy,2023-03-07 15:13:35.391132+00:00,"{""priceA"": 155, ""sharesA"": 1, ""secs_since_round_starts"": 330, ""market"": ""A""}",45.0,58.0,4.0,p4esvzkg,vmu7c279,FULL STUDY,225.0,s4,1,155,165.0,-1,,1,sell,0,sell,0.5,0,0,0,block 4 (G second),23.0,10.0,Male,0.0,0.0,0.0,"[3, 'block 4 (G second)']",0,0,1,1.0,3.0,-0.5333333333333334,0.18181818181818182,0.0,0.5,0.0,2,0.75,0.75,Design 2,Design 2,"Have an option between Design #1 and Design #2,",4.0,,
2074,1787,4,Player object (1128),sell,2023-03-07 15:18:39.690385+00:00,"{""priceA"": 115, ""sharesA"": 0, ""secs_since_round_starts"": 289, ""market"": ""A""}",165.0,53.0,1.0,p4esvzkg,vmu7c279,FULL STUDY,165.0,s4,1,115,,1,,1,,0,sell,0.5,0,1,0,block 4 (G second),23.0,10.0,Male,0.0,0.0,0.0,"[4, 'block 4 (G second)']",1,1,1,1.0,3.0,-0.5333333333333334,0.05263157894736842,0.0,0.3333333333333333,0.0,4,0.75,0.75,Design 2,Design 2,"Have an option between Design #1 and Design #2,",4.0,,
2075,1791,5,Player object (1248),sell,2023-03-07 15:20:15.527964+00:00,"{""priceA"": 135, ""sharesA"": 0, ""secs_since_round_starts"": 51, ""market"": ""A""}",185.0,10.0,1.0,p4esvzkg,vmu7c279,FULL STUDY,160.0,s4,1,135,,1,,1,,0,sell,0.5,0,0,0,block 4 (G second),23.0,10.0,Male,0.0,0.0,0.0,"[5, 'block 4 (G second)']",1,0,1,0.0,3.0,-0.5333333333333334,0.14285714285714285,0.0,0.0,0.0,4,0.75,0.5,Design 2,Design 2,"Have an option between Design #1 and Design #2,",4.0,,
2076,1792,5,Player object (1248),buy,2023-03-07 15:20:19.180465+00:00,"{""priceA"": 130, ""sharesA"": 1, ""secs_since_round_starts"": 55, ""market"": ""A""}",55.0,11.0,2.0,p4esvzkg,vmu7c279,FULL STUDY,160.0,s4,1,130,135.0,-1,,1,sell,0,sell,0.5,0,0,0,block 4 (G second),23.0,10.0,Male,0.0,0.0,0.0,"[5, 'block 4 (G second)']",1,0,1,0.0,3.0,-0.5333333333333334,0.14285714285714285,0.0,0.0,0.0,4,0.75,0.5,Design 2,Design 2,"Have an option between Design #1 and Design #2,",4.0,,
2077,1793,5,Player object (1248),sell,2023-03-07 15:21:38.116866+00:00,"{""priceA"": 150, ""sharesA"": 0, ""secs_since_round_starts"": 134, ""market"": ""A""}",205.0,25.0,3.0,p4esvzkg,vmu7c279,FULL STUDY,160.0,s4,1,150,130.0,1,20.0,1,buy,0,sell,0.5,0,0,0,block 4 (G second),23.0,10.0,Male,0.0,0.0,0.0,"[5, 'block 4 (G second)']",1,0,1,0.0,3.0,-0.5333333333333334,0.14285714285714285,0.0,0.0,0.0,4,0.75,0.5,Design 2,Design 2,"Have an option between Design #1 and Design #2,",4.0,,
2078,1794,5,Player object (1248),buy,2023-03-07 15:21:53.122899+00:00,"{""priceA"": 140, ""sharesA"": 1, ""secs_since_round_starts"": 149, ""market"": ""A""}",65.0,28.0,4.0,p4esvzkg,vmu7c279,FULL STUDY,160.0,s4,1,140,150.0,-1,,1,sell,0,sell,0.5,0,0,0,block 4 (G second),23.0,10.0,Male,0.0,0.0,0.0,"[5, 'block 4 (G second)']",1,0,1,0.0,3.0,-0.5333333333333334,0.14285714285714285,0.0,0.0,0.0,4,0.75,0.5,Design 2,Design 2,"Have an option between Design #1 and Design #2,",4.0,,
2079,686,2,Player object (861),sell,2023-03-03 23:08:31.261631+00:00,"{""priceA"": 120, ""sharesA"": 0, ""secs_since_round_starts"": 102, ""market"": ""A""}",170.0,15.0,1.0,pb727kvg,vmu7c279,FULL STUDY,220.0,s2,1,120,,1,,1,,0,sell,0.5761373211134116,16,0,0,block 4 (G second),21.0,11.0,Female,1.0,0.0,0.0,"[2, 'block 4 (G second)']",0,1,1,0.5,2.0,-0.7166666666666666,0.08,0.0,0.0,0.0,4,1.0,0.75,Design 1,Design 1,"Have an option between Design #1 and Design #2,",4.0,,
2080,687,2,Player object (861),buy,2023-03-03 23:09:48.130003+00:00,"{""priceA"": 115, ""sharesA"": 1, ""secs_since_round_starts"": 179, ""market"": ""A""}",55.0,29.0,2.0,pb727kvg,vmu7c279,FULL STUDY,220.0,s2,1,115,120.0,-1,,1,sell,0,sell,0.41991811093665,16,0,0,block 4 (G second),21.0,11.0,Female,1.0,0.0,0.0,"[2, 'block 4 (G second)']",0,1,1,0.5,2.0,-0.7166666666666666,0.08,0.0,0.0,0.0,4,1.0,0.75,Design 1,Design 1,"Have an option between Design #1 and Design #2,",4.0,,
2081,689,2,Player object (861),sell,2023-03-03 23:11:52.543156+00:00,"{""priceA"": 155, ""sharesA"": 0, ""secs_since_round_starts"": 303, ""market"": ""A""}",210.0,48.0,3.0,pb727kvg,vmu7c279,FULL STUDY,220.0,s2,1,155,115.0,1,40.0,1,buy,0,sell,0.5347792584548927,16,0,0,block 4 (G second),21.0,11.0,Female,1.0,0.0,0.0,"[2, 'block 4 (G second)']",0,1,1,0.5,2.0,-0.7166666666666666,0.08,0.0,0.0,0.0,4,1.0,0.75,Design 1,Design 1,"Have an option between Design #1 and Design #2,",4.0,,
2082,690,2,Player object (861),buy,2023-03-03 23:12:46.540706+00:00,"{""priceA"": 115, ""sharesA"": 1, ""secs_since_round_starts"": 357, ""market"": ""A""}",95.0,58.0,4.0,pb727kvg,vmu7c279,FULL STUDY,220.0,s2,1,115,155.0,-1,,1,sell,0,sell,0.4893175166503174,16,0,0,block 4 (G second),21.0,11.0,Female,1.0,0.0,0.0,"[2, 'block 4 (G second)']",0,1,1,0.5,2.0,-0.7166666666666666,0.08,0.0,0.0,0.0,4,1.0,0.75,Design 1,Design 1,"Have an option between Design #1 and Design #2,",4.0,,
2083,694,3,Player object (981),sell,2023-03-03 23:14:00.650187+00:00,"{""priceA"": 110, ""sharesA"": 0, ""secs_since_round_starts"": 54, ""market"": ""A""}",160.0,11.0,1.0,pb727kvg,vmu7c279,FULL STUDY,200.0,s2,1,110,,1,,1,,0,sell,0.5295922419004607,19,0,0,block 4 (G second),21.0,11.0,Female,1.0,0.0,0.0,"[3, 'block 4 (G second)']",0,0,1,0.5,2.0,-0.7166666666666666,0.23076923076923078,0.0,1.0,0.0,2,0.5,0.75,Design 1,Design 1,"Have an option between Design #1 and Design #2,",4.0,,
2084,695,3,Player object (981),buy,2023-03-03 23:14:57.391944+00:00,"{""priceA"": 100, ""sharesA"": 1, ""secs_since_round_starts"": 111, ""market"": ""A""}",60.0,21.0,2.0,pb727kvg,vmu7c279,FULL STUDY,200.0,s2,1,100,110.0,-1,,1,sell,0,sell,0.4692484881524699,19,0,0,block 4 (G second),21.0,11.0,Female,1.0,0.0,0.0,"[3, 'block 4 (G second)']",0,0,1,0.5,2.0,-0.7166666666666666,0.23076923076923078,0.0,1.0,0.0,2,0.5,0.75,Design 1,Design 1,"Have an option between Design #1 and Design #2,",4.0,,
2085,696,3,Player object (981),sell,2023-03-03 23:15:45.292809+00:00,"{""priceA"": 120, ""sharesA"": 0, ""secs_since_round_starts"": 159, ""market"": ""A""}",180.0,30.0,3.0,pb727kvg,vmu7c279,FULL STUDY,200.0,s2,1,120,100.0,1,20.0,1,buy,0,sell,0.570054331362491,19,0,1,block 4 (G second),21.0,11.0,Female,1.0,0.0,0.0,"[3, 'block 4 (G second)']",0,0,1,0.5,2.0,-0.7166666666666666,0.23076923076923078,0.0,1.0,0.0,2,0.5,0.75,Design 1,Design 1,"Have an option between Design #1 and Design #2,",4.0,,
2086,698,3,Player object (981),buy,2023-03-03 23:16:26.119368+00:00,"{""priceA"": 100, ""sharesA"": 1, ""secs_since_round_starts"": 199, ""market"": ""A""}",80.0,36.0,4.0,pb727kvg,vmu7c279,FULL STUDY,200.0,s2,1,100,120.0,-1,,1,sell,0,sell,0.440139794868048,19,0,0,block 4 (G second),21.0,11.0,Female,1.0,0.0,0.0,"[3, 'block 4 (G second)']",0,0,1,0.5,2.0,-0.7166666666666666,0.23076923076923078,0.0,1.0,0.0,2,0.5,0.75,Design 1,Design 1,"Have an option between Design #1 and Design #2,",4.0,,
2087,699,3,Player object (981),sell,2023-03-03 23:17:04.179557+00:00,"{""priceA"": 120, ""sharesA"": 0, ""secs_since_round_starts"": 237, ""market"": ""A""}",200.0,43.0,5.0,pb727kvg,vmu7c279,FULL STUDY,200.0,s2,1,120,100.0,1,20.0,1,buy,0,sell,0.5357259670782416,19,0,0,block 4 (G second),21.0,11.0,Female,1.0,0.0,0.0,"[3, 'block 4 (G second)']",0,0,1,0.5,2.0,-0.7166666666666666,0.23076923076923078,0.0,1.0,0.0,2,0.5,0.75,Design 1,Design 1,"Have an option between Design #1 and Design #2,",4.0,,
2088,700,3,Player object (981),buy,2023-03-03 23:18:28.024685+00:00,"{""priceA"": 115, ""sharesA"": 1, ""secs_since_round_starts"": 321, ""market"": ""A""}",85.0,58.0,6.0,pb727kvg,vmu7c279,FULL STUDY,200.0,s2,1,115,120.0,-1,,1,sell,0,sell,0.442461876115205,19,1,0,block 4 (G second),21.0,11.0,Female,1.0,0.0,0.0,"[3, 'block 4 (G second)']",0,0,1,0.5,2.0,-0.7166666666666666,0.23076923076923078,0.0,1.0,0.0,2,0.5,0.75,Design 1,Design 1,"Have an option between Design #1 and Design #2,",4.0,,
2089,704,4,Player object (1101),sell,2023-03-03 23:20:09.667082+00:00,"{""priceA"": 90, ""sharesA"": 0, ""secs_since_round_starts"": 83, ""market"": ""A""}",140.0,16.0,1.0,pb727kvg,vmu7c279,FULL STUDY,190.0,s2,1,90,,1,,1,,0,sell,0.4995738325599586,14,0,0,block 4 (G second),21.0,11.0,Female,1.0,0.0,0.0,"[4, 'block 4 (G second)']",1,1,1,0.5,2.0,-0.7166666666666666,0.2857142857142857,0.04,0.0,0.0,2,1.0,1.0,Design 1,Design 1,"Have an option between Design #1 and Design #2,",4.0,,
2090,705,4,Player object (1101),buy,2023-03-03 23:20:32.025001+00:00,"{""priceA"": 70, ""sharesA"": 1, ""secs_since_round_starts"": 106, ""market"": ""A""}",70.0,20.0,2.0,pb727kvg,vmu7c279,FULL STUDY,190.0,s2,1,70,90.0,-1,,1,sell,0,sell,0.4604462199730844,14,0,0,block 4 (G second),21.0,11.0,Female,1.0,0.0,0.0,"[4, 'block 4 (G second)']",1,1,1,0.5,2.0,-0.7166666666666666,0.2857142857142857,0.04,0.0,0.0,2,1.0,1.0,Design 1,Design 1,"Have an option between Design #1 and Design #2,",4.0,,
2091,706,4,Player object (1101),sell,2023-03-03 23:21:26.529133+00:00,"{""priceA"": 85, ""sharesA"": 0, ""secs_since_round_starts"": 160, ""market"": ""A""}",155.0,30.0,3.0,pb727kvg,vmu7c279,FULL STUDY,190.0,s2,1,85,70.0,1,15.0,1,buy,0,sell,0.5151109892827086,14,0,0,block 4 (G second),21.0,11.0,Female,1.0,0.0,0.0,"[4, 'block 4 (G second)']",1,1,1,0.5,2.0,-0.7166666666666666,0.2857142857142857,0.04,0.0,0.0,2,1.0,1.0,Design 1,Design 1,"Have an option between Design #1 and Design #2,",4.0,,
2092,708,4,Player object (1101),buy,2023-03-03 23:22:18.787114+00:00,"{""priceA"": 80, ""sharesA"": 1, ""secs_since_round_starts"": 212, ""market"": ""A""}",75.0,39.0,4.0,pb727kvg,vmu7c279,FULL STUDY,190.0,s2,1,80,85.0,-1,,1,sell,0,sell,0.4897180556691627,14,0,0,block 4 (G second),21.0,11.0,Female,1.0,0.0,0.0,"[4, 'block 4 (G second)']",1,1,1,0.5,2.0,-0.7166666666666666,0.2857142857142857,0.04,0.0,0.0,2,1.0,1.0,Design 1,Design 1,"Have an option between Design #1 and Design #2,",4.0,,
2093,709,4,Player object (1101),sell,2023-03-03 23:22:47.237796+00:00,"{""priceA"": 115, ""sharesA"": 0, ""secs_since_round_starts"": 241, ""market"": ""A""}",190.0,44.0,5.0,pb727kvg,vmu7c279,FULL STUDY,190.0,s2,1,115,80.0,1,35.0,1,buy,0,sell,0.5772497941838325,14,0,0,block 4 (G second),21.0,11.0,Female,1.0,0.0,0.0,"[4, 'block 4 (G second)']",1,1,1,0.5,2.0,-0.7166666666666666,0.2857142857142857,0.04,0.0,0.0,2,1.0,1.0,Design 1,Design 1,"Have an option between Design #1 and Design #2,",4.0,,
2094,710,4,Player object (1101),buy,2023-03-03 23:23:36.271283+00:00,"{""priceA"": 75, ""sharesA"": 1, ""secs_since_round_starts"": 290, ""market"": ""A""}",115.0,53.0,6.0,pb727kvg,vmu7c279,FULL STUDY,190.0,s2,1,75,115.0,-1,,1,sell,0,sell,0.4439854633835125,14,1,0,block 4 (G second),21.0,11.0,Female,1.0,0.0,0.0,"[4, 'block 4 (G second)']",1,1,1,0.5,2.0,-0.7166666666666666,0.2857142857142857,0.04,0.0,0.0,2,1.0,1.0,Design 1,Design 1,"Have an option between Design #1 and Design #2,",4.0,,
2095,714,5,Player object (1221),sell,2023-03-03 23:25:22.943166+00:00,"{""priceA"": 100, ""sharesA"": 0, ""secs_since_round_starts"": 61, ""market"": ""A""}",150.0,12.0,1.0,pb727kvg,vmu7c279,FULL STUDY,240.0,s2,1,100,,1,,1,,0,sell,0.5344269279803172,17,0,0,block 4 (G second),21.0,11.0,Female,1.0,0.0,0.0,"[5, 'block 4 (G second)']",1,0,1,0.5,2.0,-0.7166666666666666,0.13636363636363635,0.0,0.3333333333333333,0.0,4,0.5,0.75,Design 1,Design 1,"Have an option between Design #1 and Design #2,",4.0,,
2096,715,5,Player object (1221),buy,2023-03-03 23:25:52.293891+00:00,"{""priceA"": 80, ""sharesA"": 1, ""secs_since_round_starts"": 90, ""market"": ""A""}",70.0,17.0,2.0,pb727kvg,vmu7c279,FULL STUDY,240.0,s2,1,80,100.0,-1,,1,sell,0,sell,0.4433955626702647,17,0,0,block 4 (G second),21.0,11.0,Female,1.0,0.0,0.0,"[5, 'block 4 (G second)']",1,0,1,0.5,2.0,-0.7166666666666666,0.13636363636363635,0.0,0.3333333333333333,0.0,4,0.5,0.75,Design 1,Design 1,"Have an option between Design #1 and Design #2,",4.0,,
2097,716,5,Player object (1221),sell,2023-03-03 23:26:28.082132+00:00,"{""priceA"": 105, ""sharesA"": 0, ""secs_since_round_starts"": 126, ""market"": ""A""}",175.0,24.0,3.0,pb727kvg,vmu7c279,FULL STUDY,240.0,s2,1,105,80.0,1,25.0,1,buy,0,sell,0.5594334008058068,17,0,0,block 4 (G second),21.0,11.0,Female,1.0,0.0,0.0,"[5, 'block 4 (G second)']",1,0,1,0.5,2.0,-0.7166666666666666,0.13636363636363635,0.0,0.3333333333333333,0.0,4,0.5,0.75,Design 1,Design 1,"Have an option between Design #1 and Design #2,",4.0,,
2098,717,5,Player object (1221),buy,2023-03-03 23:26:56.332731+00:00,"{""priceA"": 80, ""sharesA"": 1, ""secs_since_round_starts"": 154, ""market"": ""A""}",95.0,29.0,4.0,pb727kvg,vmu7c279,FULL STUDY,240.0,s2,1,80,105.0,-1,,1,sell,0,sell,0.4304345659865384,17,0,0,block 4 (G second),21.0,11.0,Female,1.0,0.0,0.0,"[5, 'block 4 (G second)']",1,0,1,0.5,2.0,-0.7166666666666666,0.13636363636363635,0.0,0.3333333333333333,0.0,4,0.5,0.75,Design 1,Design 1,"Have an option between Design #1 and Design #2,",4.0,,
2099,719,5,Player object (1221),sell,2023-03-03 23:27:22.610381+00:00,"{""priceA"": 110, ""sharesA"": 0, ""secs_since_round_starts"": 180, ""market"": ""A""}",205.0,33.0,5.0,pb727kvg,vmu7c279,FULL STUDY,240.0,s2,1,110,80.0,1,30.0,1,buy,0,sell,0.5480287979668599,17,0,1,block 4 (G second),21.0,11.0,Female,1.0,0.0,0.0,"[5, 'block 4 (G second)']",1,0,1,0.5,2.0,-0.7166666666666666,0.13636363636363635,0.0,0.3333333333333333,0.0,4,0.5,0.75,Design 1,Design 1,"Have an option between Design #1 and Design #2,",4.0,,
2100,720,5,Player object (1221),buy,2023-03-03 23:27:53.543126+00:00,"{""priceA"": 70, ""sharesA"": 1, ""secs_since_round_starts"": 211, ""market"": ""A""}",135.0,39.0,6.0,pb727kvg,vmu7c279,FULL STUDY,240.0,s2,1,70,110.0,-1,,1,sell,0,sell,0.4317803147869401,17,0,0,block 4 (G second),21.0,11.0,Female,1.0,0.0,0.0,"[5, 'block 4 (G second)']",1,0,1,0.5,2.0,-0.7166666666666666,0.13636363636363635,0.0,0.3333333333333333,0.0,4,0.5,0.75,Design 1,Design 1,"Have an option between Design #1 and Design #2,",4.0,,
2101,721,5,Player object (1221),sell,2023-03-03 23:28:26.617431+00:00,"{""priceA"": 110, ""sharesA"": 0, ""secs_since_round_starts"": 244, ""market"": ""A""}",245.0,45.0,7.0,pb727kvg,vmu7c279,FULL STUDY,240.0,s2,1,110,70.0,1,40.0,1,buy,0,sell,0.5454506058480159,17,0,0,block 4 (G second),21.0,11.0,Female,1.0,0.0,0.0,"[5, 'block 4 (G second)']",1,0,1,0.5,2.0,-0.7166666666666666,0.13636363636363635,0.0,0.3333333333333333,0.0,4,0.5,0.75,Design 1,Design 1,"Have an option between Design #1 and Design #2,",4.0,,
2102,722,5,Player object (1221),buy,2023-03-03 23:28:54.182360+00:00,"{""priceA"": 70, ""sharesA"": 1, ""secs_since_round_starts"": 272, ""market"": ""A""}",175.0,50.0,8.0,pb727kvg,vmu7c279,FULL STUDY,240.0,s2,1,70,110.0,-1,,1,sell,0,sell,0.4597993338202879,17,0,0,block 4 (G second),21.0,11.0,Female,1.0,0.0,0.0,"[5, 'block 4 (G second)']",1,0,1,0.5,2.0,-0.7166666666666666,0.13636363636363635,0.0,0.3333333333333333,0.0,4,0.5,0.75,Design 1,Design 1,"Have an option between Design #1 and Design #2,",4.0,,
2103,1903,2,Player object (894),sell,2023-03-07 20:59:23.173639+00:00,"{""priceA"": 90, ""sharesA"": 0, ""secs_since_round_starts"": 144, ""market"": ""A""}",140.0,23.0,1.0,pg5m7phh,vmu7c279,FULL STUDY,195.0,s4,1,90,,1,,1,,0,sell,0.5,0,0,0,block 1 (G first),21.0,11.0,Male,1.0,0.0,0.0,"[2, 'block 1 (G first)']",1,0,0,0.0,7.0,-0.21666666666666667,0.2,0.034482758620689655,1.0,0.0,3,1.0,0.75,Design 2,Design 2,"Have an option between Design #1 and Design #2,",5.0,,
2104,1904,2,Player object (894),buy,2023-03-07 20:59:35.662403+00:00,"{""priceA"": 70, ""sharesA"": 1, ""secs_since_round_starts"": 157, ""market"": ""A""}",70.0,25.0,2.0,pg5m7phh,vmu7c279,FULL STUDY,195.0,s4,1,70,90.0,-1,,1,sell,0,sell,0.5,0,0,0,block 1 (G first),21.0,11.0,Male,1.0,0.0,0.0,"[2, 'block 1 (G first)']",1,0,0,0.0,7.0,-0.21666666666666667,0.2,0.034482758620689655,1.0,0.0,3,1.0,0.75,Design 2,Design 2,"Have an option between Design #1 and Design #2,",5.0,,
2105,1905,2,Player object (894),sell,2023-03-07 21:00:02.563891+00:00,"{""priceA"": 95, ""sharesA"": 0, ""secs_since_round_starts"": 184, ""market"": ""A""}",165.0,30.0,3.0,pg5m7phh,vmu7c279,FULL STUDY,195.0,s4,1,95,70.0,1,25.0,1,buy,0,sell,0.5,0,0,1,block 1 (G first),21.0,11.0,Male,1.0,0.0,0.0,"[2, 'block 1 (G first)']",1,0,0,0.0,7.0,-0.21666666666666667,0.2,0.034482758620689655,1.0,0.0,3,1.0,0.75,Design 2,Design 2,"Have an option between Design #1 and Design #2,",5.0,,
2106,1907,2,Player object (894),buy,2023-03-07 21:00:34.169862+00:00,"{""priceA"": 75, ""sharesA"": 1, ""secs_since_round_starts"": 215, ""market"": ""A""}",90.0,34.0,4.0,pg5m7phh,vmu7c279,FULL STUDY,195.0,s4,1,75,95.0,-1,,1,sell,0,sell,0.5,0,1,0,block 1 (G first),21.0,11.0,Male,1.0,0.0,0.0,"[2, 'block 1 (G first)']",1,0,0,0.0,7.0,-0.21666666666666667,0.2,0.034482758620689655,1.0,0.0,3,1.0,0.75,Design 2,Design 2,"Have an option between Design #1 and Design #2,",5.0,,
2107,1908,2,Player object (894),sell,2023-03-07 21:02:20.257450+00:00,"{""priceA"": 105, ""sharesA"": 0, ""secs_since_round_starts"": 321, ""market"": ""A""}",195.0,53.0,5.0,pg5m7phh,vmu7c279,FULL STUDY,195.0,s4,1,105,75.0,1,30.0,1,buy,0,sell,0.5,0,0,1,block 1 (G first),21.0,11.0,Male,1.0,0.0,0.0,"[2, 'block 1 (G first)']",1,0,0,0.0,7.0,-0.21666666666666667,0.2,0.034482758620689655,1.0,0.0,3,1.0,0.75,Design 2,Design 2,"Have an option between Design #1 and Design #2,",5.0,,
2108,1912,3,Player object (1014),sell,2023-03-07 21:03:58.826617+00:00,"{""priceA"": 130, ""sharesA"": 0, ""secs_since_round_starts"": 54, ""market"": ""A""}",180.0,10.0,1.0,pg5m7phh,vmu7c279,FULL STUDY,200.0,s4,1,130,,1,,1,,0,sell,0.5,0,0,1,block 1 (G first),21.0,11.0,Male,1.0,0.0,0.0,"[3, 'block 1 (G first)']",1,1,0,0.0,7.0,-0.21666666666666667,0.13333333333333333,0.0,0.4,0.0,4,0.75,0.5,Design 2,Design 2,"Have an option between Design #1 and Design #2,",5.0,,
2109,1913,3,Player object (1014),buy,2023-03-07 21:04:48.802880+00:00,"{""priceA"": 150, ""sharesA"": 1, ""secs_since_round_starts"": 104, ""market"": ""A""}",30.0,19.0,2.0,pg5m7phh,vmu7c279,FULL STUDY,200.0,s4,1,150,130.0,-1,,1,sell,0,sell,0.5,0,0,0,block 1 (G first),21.0,11.0,Male,1.0,0.0,0.0,"[3, 'block 1 (G first)']",1,1,0,0.0,7.0,-0.21666666666666667,0.13333333333333333,0.0,0.4,0.0,4,0.75,0.5,Design 2,Design 2,"Have an option between Design #1 and Design #2,",5.0,,
2110,1915,3,Player object (1014),sell,2023-03-07 21:07:41.894938+00:00,"{""priceA"": 170, ""sharesA"": 0, ""secs_since_round_starts"": 277, ""market"": ""A""}",200.0,50.0,3.0,pg5m7phh,vmu7c279,FULL STUDY,200.0,s4,1,170,150.0,1,20.0,1,buy,0,sell,0.5,0,0,1,block 1 (G first),21.0,11.0,Male,1.0,0.0,0.0,"[3, 'block 1 (G first)']",1,1,0,0.0,7.0,-0.21666666666666667,0.13333333333333333,0.0,0.4,0.0,4,0.75,0.5,Design 2,Design 2,"Have an option between Design #1 and Design #2,",5.0,,
2111,1919,4,Player object (1134),sell,2023-03-07 21:09:30.752827+00:00,"{""priceA"": 140, ""sharesA"": 0, ""secs_since_round_starts"": 47, ""market"": ""A""}",190.0,9.0,1.0,pg5m7phh,vmu7c279,FULL STUDY,210.0,s4,1,140,,1,,1,,0,sell,0.5,0,0,0,block 1 (G first),21.0,11.0,Male,1.0,0.0,0.0,"[4, 'block 1 (G first)']",0,0,0,0.0,7.0,-0.21666666666666667,0.18181818181818182,0.0,1.0,0.0,4,0.75,0.75,Design 2,Design 2,"Have an option between Design #1 and Design #2,",5.0,,
2112,1920,4,Player object (1134),buy,2023-03-07 21:09:47.865549+00:00,"{""priceA"": 105, ""sharesA"": 1, ""secs_since_round_starts"": 64, ""market"": ""A""}",85.0,12.0,2.0,pg5m7phh,vmu7c279,FULL STUDY,210.0,s4,1,105,140.0,-1,,1,sell,0,sell,0.5,0,1,0,block 1 (G first),21.0,11.0,Male,1.0,0.0,0.0,"[4, 'block 1 (G first)']",0,0,0,0.0,7.0,-0.21666666666666667,0.18181818181818182,0.0,1.0,0.0,4,0.75,0.75,Design 2,Design 2,"Have an option between Design #1 and Design #2,",5.0,,
2113,1922,4,Player object (1134),sell,2023-03-07 21:13:11.211901+00:00,"{""priceA"": 125, ""sharesA"": 0, ""secs_since_round_starts"": 267, ""market"": ""A""}",210.0,49.0,3.0,pg5m7phh,vmu7c279,FULL STUDY,210.0,s4,1,125,105.0,1,20.0,1,buy,0,sell,0.5,0,0,1,block 1 (G first),21.0,11.0,Male,1.0,0.0,0.0,"[4, 'block 1 (G first)']",0,0,0,0.0,7.0,-0.21666666666666667,0.18181818181818182,0.0,1.0,0.0,4,0.75,0.75,Design 2,Design 2,"Have an option between Design #1 and Design #2,",5.0,,
2114,1926,5,Player object (1254),sell,2023-03-07 21:14:57.854678+00:00,"{""priceA"": 135, ""sharesA"": 0, ""secs_since_round_starts"": 38, ""market"": ""A""}",185.0,8.0,1.0,pg5m7phh,vmu7c279,FULL STUDY,190.0,s4,1,135,,1,,1,,0,sell,0.5,0,0,0,block 1 (G first),21.0,11.0,Male,1.0,0.0,0.0,"[5, 'block 1 (G first)']",0,1,0,0.0,7.0,-0.21666666666666667,0.23076923076923078,0.0,0.0,0.0,4,0.75,1.0,Design 2,Design 2,"Have an option between Design #1 and Design #2,",5.0,,
2115,1927,5,Player object (1254),buy,2023-03-07 21:15:03.576257+00:00,"{""priceA"": 120, ""sharesA"": 1, ""secs_since_round_starts"": 44, ""market"": ""A""}",65.0,9.0,2.0,pg5m7phh,vmu7c279,FULL STUDY,190.0,s4,1,120,135.0,-1,,1,sell,0,sell,0.5,0,0,0,block 1 (G first),21.0,11.0,Male,1.0,0.0,0.0,"[5, 'block 1 (G first)']",0,1,0,0.0,7.0,-0.21666666666666667,0.23076923076923078,0.0,0.0,0.0,4,0.75,1.0,Design 2,Design 2,"Have an option between Design #1 and Design #2,",5.0,,
2116,1928,5,Player object (1254),sell,2023-03-07 21:15:26.157996+00:00,"{""priceA"": 135, ""sharesA"": 0, ""secs_since_round_starts"": 67, ""market"": ""A""}",200.0,13.0,3.0,pg5m7phh,vmu7c279,FULL STUDY,190.0,s4,1,135,120.0,1,15.0,1,buy,0,sell,0.5,0,0,0,block 1 (G first),21.0,11.0,Male,1.0,0.0,0.0,"[5, 'block 1 (G first)']",0,1,0,0.0,7.0,-0.21666666666666667,0.23076923076923078,0.0,0.0,0.0,4,0.75,1.0,Design 2,Design 2,"Have an option between Design #1 and Design #2,",5.0,,
2117,1929,5,Player object (1254),buy,2023-03-07 21:15:48.950930+00:00,"{""priceA"": 125, ""sharesA"": 1, ""secs_since_round_starts"": 89, ""market"": ""A""}",75.0,17.0,4.0,pg5m7phh,vmu7c279,FULL STUDY,190.0,s4,1,125,135.0,-1,,1,sell,0,sell,0.5,0,0,0,block 1 (G first),21.0,11.0,Male,1.0,0.0,0.0,"[5, 'block 1 (G first)']",0,1,0,0.0,7.0,-0.21666666666666667,0.23076923076923078,0.0,0.0,0.0,4,0.75,1.0,Design 2,Design 2,"Have an option between Design #1 and Design #2,",5.0,,
2118,1930,5,Player object (1254),sell,2023-03-07 21:16:26.101972+00:00,"{""priceA"": 155, ""sharesA"": 0, ""secs_since_round_starts"": 127, ""market"": ""A""}",230.0,24.0,5.0,pg5m7phh,vmu7c279,FULL STUDY,190.0,s4,1,155,125.0,1,30.0,1,buy,0,sell,0.5,0,0,0,block 1 (G first),21.0,11.0,Male,1.0,0.0,0.0,"[5, 'block 1 (G first)']",0,1,0,0.0,7.0,-0.21666666666666667,0.23076923076923078,0.0,0.0,0.0,4,0.75,1.0,Design 2,Design 2,"Have an option between Design #1 and Design #2,",5.0,,
2119,1931,5,Player object (1254),buy,2023-03-07 21:16:53.307150+00:00,"{""priceA"": 135, ""sharesA"": 1, ""secs_since_round_starts"": 154, ""market"": ""A""}",95.0,29.0,6.0,pg5m7phh,vmu7c279,FULL STUDY,190.0,s4,1,135,155.0,-1,,1,sell,0,sell,0.5,0,0,0,block 1 (G first),21.0,11.0,Male,1.0,0.0,0.0,"[5, 'block 1 (G first)']",0,1,0,0.0,7.0,-0.21666666666666667,0.23076923076923078,0.0,0.0,0.0,4,0.75,1.0,Design 2,Design 2,"Have an option between Design #1 and Design #2,",5.0,,
2120,821,2,Player object (863),sell,2023-03-04 17:29:58.418696+00:00,"{""priceA"": 105, ""sharesA"": 0, ""secs_since_round_starts"": 106, ""market"": ""A""}",155.0,16.0,1.0,pgdv91vz,vmu7c279,FULL STUDY,185.0,s3,1,105,,1,,1,,0,sell,0.5185790363913291,16,0,0,block 4 (G second),20.0,11.0,Male,1.0,0.0,0.0,"[2, 'block 4 (G second)']",0,1,1,0.0,4.0,-0.5166666666666666,0.23076923076923078,0.0,0.5,0.0,4,1.0,0.75,Design 1,Design 1,Only trade on Design #1,3.0,1.0,1.0
2121,823,2,Player object (863),buy,2023-03-04 17:32:12.026340+00:00,"{""priceA"": 125, ""sharesA"": 1, ""secs_since_round_starts"": 239, ""market"": ""A""}",30.0,39.0,2.0,pgdv91vz,vmu7c279,FULL STUDY,185.0,s3,1,125,105.0,-1,,1,sell,0,sell,0.4382592777609274,16,1,0,block 4 (G second),20.0,11.0,Male,1.0,0.0,0.0,"[2, 'block 4 (G second)']",0,1,1,0.0,4.0,-0.5166666666666666,0.23076923076923078,0.0,0.5,0.0,4,1.0,0.75,Design 1,Design 1,Only trade on Design #1,3.0,1.0,1.0
2122,824,2,Player object (863),sell,2023-03-04 17:32:50.415916+00:00,"{""priceA"": 155, ""sharesA"": 0, ""secs_since_round_starts"": 278, ""market"": ""A""}",185.0,46.0,3.0,pgdv91vz,vmu7c279,FULL STUDY,185.0,s3,1,155,125.0,1,30.0,1,buy,0,sell,0.5495494947508355,16,0,1,block 4 (G second),20.0,11.0,Male,1.0,0.0,0.0,"[2, 'block 4 (G second)']",0,1,1,0.0,4.0,-0.5166666666666666,0.23076923076923078,0.0,0.5,0.0,4,1.0,0.75,Design 1,Design 1,Only trade on Design #1,3.0,1.0,1.0
2123,825,2,Player object (863),buy,2023-03-04 17:32:57.100007+00:00,"{""priceA"": 140, ""sharesA"": 1, ""secs_since_round_starts"": 285, ""market"": ""A""}",45.0,47.0,4.0,pgdv91vz,vmu7c279,FULL STUDY,185.0,s3,1,140,155.0,-1,,1,sell,0,sell,0.4996814899229063,16,0,0,block 4 (G second),20.0,11.0,Male,1.0,0.0,0.0,"[2, 'block 4 (G second)']",0,1,1,0.0,4.0,-0.5166666666666666,0.23076923076923078,0.0,0.5,0.0,4,1.0,0.75,Design 1,Design 1,Only trade on Design #1,3.0,1.0,1.0
2124,826,2,Player object (863),sell,2023-03-04 17:33:01.456375+00:00,"{""priceA"": 155, ""sharesA"": 0, ""secs_since_round_starts"": 289, ""market"": ""A""}",200.0,48.0,5.0,pgdv91vz,vmu7c279,FULL STUDY,185.0,s3,1,155,140.0,1,15.0,1,buy,0,sell,0.5347792584548927,16,0,0,block 4 (G second),20.0,11.0,Male,1.0,0.0,0.0,"[2, 'block 4 (G second)']",0,1,1,0.0,4.0,-0.5166666666666666,0.23076923076923078,0.0,0.5,0.0,4,1.0,0.75,Design 1,Design 1,Only trade on Design #1,3.0,1.0,1.0
2125,827,2,Player object (863),buy,2023-03-04 17:33:17.907031+00:00,"{""priceA"": 140, ""sharesA"": 1, ""secs_since_round_starts"": 305, ""market"": ""A""}",60.0,51.0,6.0,pgdv91vz,vmu7c279,FULL STUDY,185.0,s3,1,140,155.0,-1,,1,sell,0,sell,0.4693918893964308,16,0,0,block 4 (G second),20.0,11.0,Male,1.0,0.0,0.0,"[2, 'block 4 (G second)']",0,1,1,0.0,4.0,-0.5166666666666666,0.23076923076923078,0.0,0.5,0.0,4,1.0,0.75,Design 1,Design 1,Only trade on Design #1,3.0,1.0,1.0
2126,835,3,Player object (983),sell,2023-03-04 17:35:00.662065+00:00,"{""priceA"": 110, ""sharesA"": 0, ""secs_since_round_starts"": 44, ""market"": ""A""}",160.0,9.0,2.0,pgdv91vz,vmu7c279,FULL STUDY,190.0,s3,1,110,95.0,1,15.0,1,,0,sell,0.5389563723055646,19,0,0,block 4 (G second),20.0,11.0,Male,1.0,0.0,0.0,"[3, 'block 4 (G second)']",0,0,1,0.5,4.0,-0.5166666666666666,0.2,0.05,0.0,0.0,2,0.5,0.75,Design 1,Design 1,Only trade on Design #1,3.0,1.0,1.0
2127,836,3,Player object (983),buy,2023-03-04 17:35:05.332061+00:00,"{""priceA"": 95, ""sharesA"": 1, ""secs_since_round_starts"": 49, ""market"": ""A""}",65.0,10.0,3.0,pgdv91vz,vmu7c279,FULL STUDY,190.0,s3,1,95,110.0,-1,,1,sell,0,sell,0.4922087569005138,19,0,0,block 4 (G second),20.0,11.0,Male,1.0,0.0,0.0,"[3, 'block 4 (G second)']",0,0,1,0.5,4.0,-0.5166666666666666,0.2,0.05,0.0,0.0,2,0.5,0.75,Design 1,Design 1,Only trade on Design #1,3.0,1.0,1.0
2128,837,3,Player object (983),sell,2023-03-04 17:35:16.325920+00:00,"{""priceA"": 120, ""sharesA"": 0, ""secs_since_round_starts"": 60, ""market"": ""A""}",185.0,12.0,4.0,pgdv91vz,vmu7c279,FULL STUDY,190.0,s3,1,120,95.0,1,25.0,1,buy,0,sell,0.5553867656170776,19,0,0,block 4 (G second),20.0,11.0,Male,1.0,0.0,0.0,"[3, 'block 4 (G second)']",0,0,1,0.5,4.0,-0.5166666666666666,0.2,0.05,0.0,0.0,2,0.5,0.75,Design 1,Design 1,Only trade on Design #1,3.0,1.0,1.0
2129,838,3,Player object (983),buy,2023-03-04 17:35:32.796498+00:00,"{""priceA"": 110, ""sharesA"": 1, ""secs_since_round_starts"": 76, ""market"": ""A""}",75.0,15.0,5.0,pgdv91vz,vmu7c279,FULL STUDY,190.0,s3,1,110,120.0,-1,,1,sell,0,sell,0.4763410641166328,19,0,0,block 4 (G second),20.0,11.0,Male,1.0,0.0,0.0,"[3, 'block 4 (G second)']",0,0,1,0.5,4.0,-0.5166666666666666,0.2,0.05,0.0,0.0,2,0.5,0.75,Design 1,Design 1,Only trade on Design #1,3.0,1.0,1.0
2130,844,3,Player object (983),sell,2023-03-04 17:38:26.558868+00:00,"{""priceA"": 135, ""sharesA"": 0, ""secs_since_round_starts"": 250, ""market"": ""A""}",210.0,46.0,8.0,pgdv91vz,vmu7c279,FULL STUDY,190.0,s3,1,135,125.0,1,10.0,1,buy,0,sell,0.5396981283875847,19,0,0,block 4 (G second),20.0,11.0,Male,1.0,0.0,0.0,"[3, 'block 4 (G second)']",0,0,1,0.5,4.0,-0.5166666666666666,0.2,0.05,0.0,0.0,2,0.5,0.75,Design 1,Design 1,Only trade on Design #1,3.0,1.0,1.0
2131,845,3,Player object (983),buy,2023-03-04 17:38:51.305429+00:00,"{""priceA"": 125, ""sharesA"": 1, ""secs_since_round_starts"": 275, ""market"": ""A""}",85.0,50.0,9.0,pgdv91vz,vmu7c279,FULL STUDY,190.0,s3,1,125,135.0,-1,,1,sell,0,sell,0.4911246412164243,19,0,0,block 4 (G second),20.0,11.0,Male,1.0,0.0,0.0,"[3, 'block 4 (G second)']",0,0,1,0.5,4.0,-0.5166666666666666,0.2,0.05,0.0,0.0,2,0.5,0.75,Design 1,Design 1,Only trade on Design #1,3.0,1.0,1.0
2132,846,3,Player object (983),sell,2023-03-04 17:39:01.047594+00:00,"{""priceA"": 115, ""sharesA"": 0, ""secs_since_round_starts"": 284, ""market"": ""A""}",200.0,52.0,10.0,pgdv91vz,vmu7c279,FULL STUDY,190.0,s3,1,115,125.0,1,-10.0,1,buy,0,sell,0.4367228334197354,19,0,0,block 4 (G second),20.0,11.0,Male,1.0,0.0,0.0,"[3, 'block 4 (G second)']",0,0,1,0.5,4.0,-0.5166666666666666,0.2,0.05,0.0,0.0,2,0.5,0.75,Design 1,Design 1,Only trade on Design #1,3.0,1.0,1.0
2133,847,3,Player object (983),buy,2023-03-04 17:39:37.892002+00:00,"{""priceA"": 125, ""sharesA"": 1, ""secs_since_round_starts"": 321, ""market"": ""A""}",75.0,59.0,11.0,pgdv91vz,vmu7c279,FULL STUDY,190.0,s3,1,125,115.0,-1,,1,sell,0,sell,0.4946618842475483,19,0,0,block 4 (G second),20.0,11.0,Male,1.0,0.0,0.0,"[3, 'block 4 (G second)']",0,0,1,0.5,4.0,-0.5166666666666666,0.2,0.05,0.0,0.0,2,0.5,0.75,Design 1,Design 1,Only trade on Design #1,3.0,1.0,1.0
2134,853,4,Player object (1103),sell,2023-03-04 17:41:03.061230+00:00,"{""priceA"": 90, ""sharesA"": 0, ""secs_since_round_starts"": 72, ""market"": ""A""}",140.0,12.0,2.0,pgdv91vz,vmu7c279,FULL STUDY,185.0,s3,1,90,40.0,1,50.0,1,,0,sell,0.5210961257750505,14,0,0,block 4 (G second),20.0,11.0,Male,1.0,0.0,0.0,"[4, 'block 4 (G second)']",1,1,1,0.5,4.0,-0.5166666666666666,0.5,0.03125,1.0,0.0,2,1.0,0.75,Design 1,Design 1,Only trade on Design #1,3.0,1.0,1.0
2135,854,4,Player object (1103),buy,2023-03-04 17:41:12.036689+00:00,"{""priceA"": 75, ""sharesA"": 1, ""secs_since_round_starts"": 81, ""market"": ""A""}",65.0,13.0,3.0,pgdv91vz,vmu7c279,FULL STUDY,185.0,s3,1,75,90.0,-1,,1,sell,0,sell,0.479681559969247,14,0,0,block 4 (G second),20.0,11.0,Male,1.0,0.0,0.0,"[4, 'block 4 (G second)']",1,1,1,0.5,4.0,-0.5166666666666666,0.5,0.03125,1.0,0.0,2,1.0,0.75,Design 1,Design 1,Only trade on Design #1,3.0,1.0,1.0
2136,855,4,Player object (1103),sell,2023-03-04 17:41:14.390257+00:00,"{""priceA"": 90, ""sharesA"": 0, ""secs_since_round_starts"": 83, ""market"": ""A""}",155.0,14.0,4.0,pgdv91vz,vmu7c279,FULL STUDY,185.0,s3,1,90,75.0,1,15.0,1,buy,0,sell,0.5208618681016636,14,0,0,block 4 (G second),20.0,11.0,Male,1.0,0.0,0.0,"[4, 'block 4 (G second)']",1,1,1,0.5,4.0,-0.5166666666666666,0.5,0.03125,1.0,0.0,2,1.0,0.75,Design 1,Design 1,Only trade on Design #1,3.0,1.0,1.0
2137,856,4,Player object (1103),buy,2023-03-04 17:41:34.203062+00:00,"{""priceA"": 85, ""sharesA"": 1, ""secs_since_round_starts"": 103, ""market"": ""A""}",70.0,17.0,5.0,pgdv91vz,vmu7c279,FULL STUDY,185.0,s3,1,85,90.0,-1,,1,sell,0,sell,0.4647046911342559,14,0,0,block 4 (G second),20.0,11.0,Male,1.0,0.0,0.0,"[4, 'block 4 (G second)']",1,1,1,0.5,4.0,-0.5166666666666666,0.5,0.03125,1.0,0.0,2,1.0,0.75,Design 1,Design 1,Only trade on Design #1,3.0,1.0,1.0
2138,859,4,Player object (1103),sell,2023-03-04 17:42:42.633320+00:00,"{""priceA"": 85, ""sharesA"": 0, ""secs_since_round_starts"": 172, ""market"": ""A""}",155.0,30.0,7.0,pgdv91vz,vmu7c279,FULL STUDY,185.0,s3,1,85,55.0,1,30.0,1,buy,0,sell,0.5151109892827086,14,0,0,block 4 (G second),20.0,11.0,Male,1.0,0.0,0.0,"[4, 'block 4 (G second)']",1,1,1,0.5,4.0,-0.5166666666666666,0.5,0.03125,1.0,0.0,2,1.0,0.75,Design 1,Design 1,Only trade on Design #1,3.0,1.0,1.0
2139,861,4,Player object (1103),buy,2023-03-04 17:43:06.728254+00:00,"{""priceA"": 95, ""sharesA"": 1, ""secs_since_round_starts"": 196, ""market"": ""A""}",60.0,34.0,8.0,pgdv91vz,vmu7c279,FULL STUDY,185.0,s3,1,95,85.0,-1,,1,sell,0,sell,0.4981543075921684,14,0,0,block 4 (G second),20.0,11.0,Male,1.0,0.0,0.0,"[4, 'block 4 (G second)']",1,1,1,0.5,4.0,-0.5166666666666666,0.5,0.03125,1.0,0.0,2,1.0,0.75,Design 1,Design 1,Only trade on Design #1,3.0,1.0,1.0
2140,862,4,Player object (1103),sell,2023-03-04 17:43:11.567512+00:00,"{""priceA"": 100, ""sharesA"": 0, ""secs_since_round_starts"": 201, ""market"": ""A""}",160.0,35.0,9.0,pgdv91vz,vmu7c279,FULL STUDY,185.0,s3,1,100,95.0,1,5.0,1,buy,0,sell,0.5337204628349665,14,0,0,block 4 (G second),20.0,11.0,Male,1.0,0.0,0.0,"[4, 'block 4 (G second)']",1,1,1,0.5,4.0,-0.5166666666666666,0.5,0.03125,1.0,0.0,2,1.0,0.75,Design 1,Design 1,Only trade on Design #1,3.0,1.0,1.0
2141,863,4,Player object (1103),buy,2023-03-04 17:43:16.826891+00:00,"{""priceA"": 85, ""sharesA"": 1, ""secs_since_round_starts"": 206, ""market"": ""A""}",75.0,36.0,10.0,pgdv91vz,vmu7c279,FULL STUDY,185.0,s3,1,85,100.0,-1,,1,sell,0,sell,0.4885269486642424,14,0,0,block 4 (G second),20.0,11.0,Male,1.0,0.0,0.0,"[4, 'block 4 (G second)']",1,1,1,0.5,4.0,-0.5166666666666666,0.5,0.03125,1.0,0.0,2,1.0,0.75,Design 1,Design 1,Only trade on Design #1,3.0,1.0,1.0
2142,866,4,Player object (1103),sell,2023-03-04 17:43:58.901037+00:00,"{""priceA"": 100, ""sharesA"": 0, ""secs_since_round_starts"": 248, ""market"": ""A""}",175.0,43.0,11.0,pgdv91vz,vmu7c279,FULL STUDY,185.0,s3,1,100,85.0,1,15.0,1,buy,0,sell,0.5617190733230237,14,0,1,block 4 (G second),20.0,11.0,Male,1.0,0.0,0.0,"[4, 'block 4 (G second)']",1,1,1,0.5,4.0,-0.5166666666666666,0.5,0.03125,1.0,0.0,2,1.0,0.75,Design 1,Design 1,Only trade on Design #1,3.0,1.0,1.0
2143,868,4,Player object (1103),buy,2023-03-04 17:44:16.481888+00:00,"{""priceA"": 95, ""sharesA"": 1, ""secs_since_round_starts"": 265, ""market"": ""A""}",80.0,46.0,12.0,pgdv91vz,vmu7c279,FULL STUDY,185.0,s3,1,95,100.0,-1,,1,sell,0,sell,0.4784785382548627,14,0,0,block 4 (G second),20.0,11.0,Male,1.0,0.0,0.0,"[4, 'block 4 (G second)']",1,1,1,0.5,4.0,-0.5166666666666666,0.5,0.03125,1.0,0.0,2,1.0,0.75,Design 1,Design 1,Only trade on Design #1,3.0,1.0,1.0
2144,872,4,Player object (1103),sell,2023-03-04 17:44:40.496335+00:00,"{""priceA"": 120, ""sharesA"": 0, ""secs_since_round_starts"": 289, ""market"": ""A""}",200.0,50.0,13.0,pgdv91vz,vmu7c279,FULL STUDY,185.0,s3,1,120,95.0,1,25.0,1,buy,0,sell,0.5591364702939366,14,0,1,block 4 (G second),20.0,11.0,Male,1.0,0.0,0.0,"[4, 'block 4 (G second)']",1,1,1,0.5,4.0,-0.5166666666666666,0.5,0.03125,1.0,0.0,2,1.0,0.75,Design 1,Design 1,Only trade on Design #1,3.0,1.0,1.0
2145,873,4,Player object (1103),buy,2023-03-04 17:44:48.537061+00:00,"{""priceA"": 90, ""sharesA"": 1, ""secs_since_round_starts"": 298, ""market"": ""A""}",110.0,52.0,14.0,pgdv91vz,vmu7c279,FULL STUDY,185.0,s3,1,90,120.0,-1,,1,sell,0,sell,0.4694909620846048,14,0,0,block 4 (G second),20.0,11.0,Male,1.0,0.0,0.0,"[4, 'block 4 (G second)']",1,1,1,0.5,4.0,-0.5166666666666666,0.5,0.03125,1.0,0.0,2,1.0,0.75,Design 1,Design 1,Only trade on Design #1,3.0,1.0,1.0
2146,882,5,Player object (1223),sell,2023-03-04 17:46:18.646069+00:00,"{""priceA"": 100, ""sharesA"": 0, ""secs_since_round_starts"": 32, ""market"": ""A""}",150.0,7.0,1.0,pgdv91vz,vmu7c279,FULL STUDY,185.0,s3,1,100,,1,,1,,0,sell,0.5733994727268583,17,0,0,block 4 (G second),20.0,11.0,Male,1.0,0.0,0.0,"[5, 'block 4 (G second)']",1,0,1,0.5,4.0,-0.5166666666666666,0.23076923076923078,0.0,0.25,0.0,5,0.25,1.0,Design 1,Design 1,Only trade on Design #1,3.0,1.0,1.0
2147,883,5,Player object (1223),buy,2023-03-04 17:46:24.090112+00:00,"{""priceA"": 90, ""sharesA"": 1, ""secs_since_round_starts"": 38, ""market"": ""A""}",60.0,8.0,2.0,pgdv91vz,vmu7c279,FULL STUDY,185.0,s3,1,90,100.0,-1,,1,sell,0,sell,0.5166236645513725,17,0,0,block 4 (G second),20.0,11.0,Male,1.0,0.0,0.0,"[5, 'block 4 (G second)']",1,0,1,0.5,4.0,-0.5166666666666666,0.23076923076923078,0.0,0.25,0.0,5,0.25,1.0,Design 1,Design 1,Only trade on Design #1,3.0,1.0,1.0
2148,892,5,Player object (1223),sell,2023-03-04 17:47:59.448603+00:00,"{""priceA"": 115, ""sharesA"": 0, ""secs_since_round_starts"": 133, ""market"": ""A""}",175.0,25.0,4.0,pgdv91vz,vmu7c279,FULL STUDY,185.0,s3,1,115,105.0,1,10.0,1,buy,0,sell,0.5757035170695836,17,0,1,block 4 (G second),20.0,11.0,Male,1.0,0.0,0.0,"[5, 'block 4 (G second)']",1,0,1,0.5,4.0,-0.5166666666666666,0.23076923076923078,0.0,0.25,0.0,5,0.25,1.0,Design 1,Design 1,Only trade on Design #1,3.0,1.0,1.0
2149,893,5,Player object (1223),buy,2023-03-04 17:48:11.822577+00:00,"{""priceA"": 100, ""sharesA"": 1, ""secs_since_round_starts"": 146, ""market"": ""A""}",75.0,27.0,5.0,pgdv91vz,vmu7c279,FULL STUDY,185.0,s3,1,100,115.0,-1,,1,sell,0,sell,0.4777068930880888,17,0,0,block 4 (G second),20.0,11.0,Male,1.0,0.0,0.0,"[5, 'block 4 (G second)']",1,0,1,0.5,4.0,-0.5166666666666666,0.23076923076923078,0.0,0.25,0.0,5,0.25,1.0,Design 1,Design 1,Only trade on Design #1,3.0,1.0,1.0
2150,897,5,Player object (1223),sell,2023-03-04 17:48:48.563349+00:00,"{""priceA"": 120, ""sharesA"": 0, ""secs_since_round_starts"": 182, ""market"": ""A""}",195.0,34.0,6.0,pgdv91vz,vmu7c279,FULL STUDY,185.0,s3,1,120,100.0,1,20.0,1,buy,0,sell,0.5679672812132522,17,0,0,block 4 (G second),20.0,11.0,Male,1.0,0.0,0.0,"[5, 'block 4 (G second)']",1,0,1,0.5,4.0,-0.5166666666666666,0.23076923076923078,0.0,0.25,0.0,5,0.25,1.0,Design 1,Design 1,Only trade on Design #1,3.0,1.0,1.0
2151,900,5,Player object (1223),buy,2023-03-04 17:49:06.123485+00:00,"{""priceA"": 95, ""sharesA"": 1, ""secs_since_round_starts"": 200, ""market"": ""A""}",100.0,37.0,7.0,pgdv91vz,vmu7c279,FULL STUDY,185.0,s3,1,95,120.0,-1,,1,sell,0,sell,0.4805886028013266,17,0,0,block 4 (G second),20.0,11.0,Male,1.0,0.0,0.0,"[5, 'block 4 (G second)']",1,0,1,0.5,4.0,-0.5166666666666666,0.23076923076923078,0.0,0.25,0.0,5,0.25,1.0,Design 1,Design 1,Only trade on Design #1,3.0,1.0,1.0
2152,920,5,Player object (1223),sell,2023-03-04 17:49:38.403768+00:00,"{""priceA"": 110, ""sharesA"": 0, ""secs_since_round_starts"": 232, ""market"": ""A""}",210.0,43.0,8.0,pgdv91vz,vmu7c279,FULL STUDY,185.0,s3,1,110,95.0,1,15.0,1,buy,0,sell,0.571300234525265,17,0,0,block 4 (G second),20.0,11.0,Male,1.0,0.0,0.0,"[5, 'block 4 (G second)']",1,0,1,0.5,4.0,-0.5166666666666666,0.23076923076923078,0.0,0.25,0.0,5,0.25,1.0,Design 1,Design 1,Only trade on Design #1,3.0,1.0,1.0
2153,921,5,Player object (1223),buy,2023-03-04 17:49:59.838636+00:00,"{""priceA"": 90, ""sharesA"": 1, ""secs_since_round_starts"": 254, ""market"": ""A""}",120.0,47.0,9.0,pgdv91vz,vmu7c279,FULL STUDY,185.0,s3,1,90,110.0,-1,,1,sell,0,sell,0.4627742743797309,17,0,0,block 4 (G second),20.0,11.0,Male,1.0,0.0,0.0,"[5, 'block 4 (G second)']",1,0,1,0.5,4.0,-0.5166666666666666,0.23076923076923078,0.0,0.25,0.0,5,0.25,1.0,Design 1,Design 1,Only trade on Design #1,3.0,1.0,1.0
2154,3275,2,Player object (929),sell,2023-03-09 03:30:51.465183+00:00,"{""priceA"": 100, ""sharesA"": 0, ""secs_since_round_starts"": 124, ""market"": ""A""}",150.0,7.0,1.0,px6py4fl,vmu7c279,FULL STUDY,200.0,s3,1,100,,1,,1,,0,sell,0.4669924949471701,16,0,0,block 3 (G second),23.0,12.0,Female,1.0,0.0,0.0,"[2, 'block 3 (G second)']",0,0,1,0.5,7.0,-0.30000000000000004,0.23076923076923078,0.0,1.0,0.0,4,1.0,0.5,Design 2,Design 2,"Have an option between Design #1 and Design #2,",5.0,5.0,5.0
2155,3276,2,Player object (929),buy,2023-03-09 03:31:09.433959+00:00,"{""priceA"": 75, ""sharesA"": 1, ""secs_since_round_starts"": 142, ""market"": ""A""}",75.0,10.0,2.0,px6py4fl,vmu7c279,FULL STUDY,200.0,s3,1,75,100.0,-1,,1,sell,0,sell,0.4825575314143953,16,0,0,block 3 (G second),23.0,12.0,Female,1.0,0.0,0.0,"[2, 'block 3 (G second)']",0,0,1,0.5,7.0,-0.30000000000000004,0.23076923076923078,0.0,1.0,0.0,4,1.0,0.5,Design 2,Design 2,"Have an option between Design #1 and Design #2,",5.0,5.0,5.0
2156,3277,2,Player object (929),sell,2023-03-09 03:31:30.079632+00:00,"{""priceA"": 105, ""sharesA"": 0, ""secs_since_round_starts"": 163, ""market"": ""A""}",180.0,14.0,3.0,px6py4fl,vmu7c279,FULL STUDY,200.0,s3,1,105,75.0,1,30.0,1,buy,0,sell,0.5600744319669811,16,0,1,block 3 (G second),23.0,12.0,Female,1.0,0.0,0.0,"[2, 'block 3 (G second)']",0,0,1,0.5,7.0,-0.30000000000000004,0.23076923076923078,0.0,1.0,0.0,4,1.0,0.5,Design 2,Design 2,"Have an option between Design #1 and Design #2,",5.0,5.0,5.0
2157,3278,2,Player object (929),buy,2023-03-09 03:32:30.584016+00:00,"{""priceA"": 145, ""sharesA"": 1, ""secs_since_round_starts"": 223, ""market"": ""A""}",35.0,25.0,4.0,px6py4fl,vmu7c279,FULL STUDY,200.0,s3,1,145,105.0,-1,,1,sell,0,sell,0.5294358264188312,16,0,0,block 3 (G second),23.0,12.0,Female,1.0,0.0,0.0,"[2, 'block 3 (G second)']",0,0,1,0.5,7.0,-0.30000000000000004,0.23076923076923078,0.0,1.0,0.0,4,1.0,0.5,Design 2,Design 2,"Have an option between Design #1 and Design #2,",5.0,5.0,5.0
2158,3282,2,Player object (929),sell,2023-03-09 03:33:33.228446+00:00,"{""priceA"": 150, ""sharesA"": 0, ""secs_since_round_starts"": 286, ""market"": ""A""}",185.0,36.0,6.0,px6py4fl,vmu7c279,FULL STUDY,200.0,s3,1,150,115.0,1,35.0,1,buy,0,sell,0.542045663089369,16,0,0,block 3 (G second),23.0,12.0,Female,1.0,0.0,0.0,"[2, 'block 3 (G second)']",0,0,1,0.5,7.0,-0.30000000000000004,0.23076923076923078,0.0,1.0,0.0,4,1.0,0.5,Design 2,Design 2,"Have an option between Design #1 and Design #2,",5.0,5.0,5.0
2159,3283,2,Player object (929),buy,2023-03-09 03:33:49.809277+00:00,"{""priceA"": 125, ""sharesA"": 1, ""secs_since_round_starts"": 302, ""market"": ""A""}",60.0,39.0,7.0,px6py4fl,vmu7c279,FULL STUDY,200.0,s3,1,125,150.0,-1,,1,sell,0,sell,0.4382592777609274,16,1,0,block 3 (G second),23.0,12.0,Female,1.0,0.0,0.0,"[2, 'block 3 (G second)']",0,0,1,0.5,7.0,-0.30000000000000004,0.23076923076923078,0.0,1.0,0.0,4,1.0,0.5,Design 2,Design 2,"Have an option between Design #1 and Design #2,",5.0,5.0,5.0
2160,3286,2,Player object (929),sell,2023-03-09 03:34:28.292521+00:00,"{""priceA"": 155, ""sharesA"": 0, ""secs_since_round_starts"": 341, ""market"": ""A""}",215.0,46.0,9.0,px6py4fl,vmu7c279,FULL STUDY,200.0,s3,1,155,135.0,1,20.0,1,buy,0,sell,0.5495494947508355,16,0,1,block 3 (G second),23.0,12.0,Female,1.0,0.0,0.0,"[2, 'block 3 (G second)']",0,0,1,0.5,7.0,-0.30000000000000004,0.23076923076923078,0.0,1.0,0.0,4,1.0,0.5,Design 2,Design 2,"Have an option between Design #1 and Design #2,",5.0,5.0,5.0
2161,3287,2,Player object (929),buy,2023-03-09 03:34:56.201475+00:00,"{""priceA"": 140, ""sharesA"": 1, ""secs_since_round_starts"": 369, ""market"": ""A""}",75.0,51.0,10.0,px6py4fl,vmu7c279,FULL STUDY,200.0,s3,1,140,155.0,-1,,1,sell,0,sell,0.4693918893964308,16,0,0,block 3 (G second),23.0,12.0,Female,1.0,0.0,0.0,"[2, 'block 3 (G second)']",0,0,1,0.5,7.0,-0.30000000000000004,0.23076923076923078,0.0,1.0,0.0,4,1.0,0.5,Design 2,Design 2,"Have an option between Design #1 and Design #2,",5.0,5.0,5.0
2162,3291,3,Player object (1049),sell,2023-03-09 03:36:43.886998+00:00,"{""priceA"": 110, ""sharesA"": 0, ""secs_since_round_starts"": 50, ""market"": ""A""}",160.0,11.0,1.0,px6py4fl,vmu7c279,FULL STUDY,225.0,s3,1,110,,1,,1,,0,sell,0.5295922419004607,19,0,0,block 3 (G second),23.0,12.0,Female,1.0,0.0,0.0,"[3, 'block 3 (G second)']",0,1,1,0.5,7.0,-0.30000000000000004,0.3333333333333333,0.0,0.0,0.0,2,0.5,0.75,Design 2,Design 2,"Have an option between Design #1 and Design #2,",5.0,5.0,5.0
2163,3292,3,Player object (1049),buy,2023-03-09 03:37:11.591256+00:00,"{""priceA"": 100, ""sharesA"": 1, ""secs_since_round_starts"": 78, ""market"": ""A""}",60.0,16.0,2.0,px6py4fl,vmu7c279,FULL STUDY,225.0,s3,1,100,110.0,-1,,1,sell,0,sell,0.4486815727575955,19,1,0,block 3 (G second),23.0,12.0,Female,1.0,0.0,0.0,"[3, 'block 3 (G second)']",0,1,1,0.5,7.0,-0.30000000000000004,0.3333333333333333,0.0,0.0,0.0,2,0.5,0.75,Design 2,Design 2,"Have an option between Design #1 and Design #2,",5.0,5.0,5.0
2164,3293,3,Player object (1049),sell,2023-03-09 03:37:34.973598+00:00,"{""priceA"": 115, ""sharesA"": 0, ""secs_since_round_starts"": 102, ""market"": ""A""}",175.0,20.0,3.0,px6py4fl,vmu7c279,FULL STUDY,225.0,s3,1,115,100.0,1,15.0,1,buy,0,sell,0.5061230669509241,19,0,0,block 3 (G second),23.0,12.0,Female,1.0,0.0,0.0,"[3, 'block 3 (G second)']",0,1,1,0.5,7.0,-0.30000000000000004,0.3333333333333333,0.0,0.0,0.0,2,0.5,0.75,Design 2,Design 2,"Have an option between Design #1 and Design #2,",5.0,5.0,5.0
2165,3294,3,Player object (1049),buy,2023-03-09 03:37:39.103759+00:00,"{""priceA"": 100, ""sharesA"": 1, ""secs_since_round_starts"": 106, ""market"": ""A""}",75.0,21.0,4.0,px6py4fl,vmu7c279,FULL STUDY,225.0,s3,1,100,115.0,-1,,1,sell,0,sell,0.4692484881524699,19,0,0,block 3 (G second),23.0,12.0,Female,1.0,0.0,0.0,"[3, 'block 3 (G second)']",0,1,1,0.5,7.0,-0.30000000000000004,0.3333333333333333,0.0,0.0,0.0,2,0.5,0.75,Design 2,Design 2,"Have an option between Design #1 and Design #2,",5.0,5.0,5.0
2166,3295,3,Player object (1049),sell,2023-03-09 03:38:06.618346+00:00,"{""priceA"": 115, ""sharesA"": 0, ""secs_since_round_starts"": 133, ""market"": ""A""}",190.0,26.0,5.0,px6py4fl,vmu7c279,FULL STUDY,225.0,s3,1,115,100.0,1,15.0,1,buy,0,sell,0.526172546586359,19,0,0,block 3 (G second),23.0,12.0,Female,1.0,0.0,0.0,"[3, 'block 3 (G second)']",0,1,1,0.5,7.0,-0.30000000000000004,0.3333333333333333,0.0,0.0,0.0,2,0.5,0.75,Design 2,Design 2,"Have an option between Design #1 and Design #2,",5.0,5.0,5.0
2167,3297,3,Player object (1049),buy,2023-03-09 03:38:44.097358+00:00,"{""priceA"": 100, ""sharesA"": 1, ""secs_since_round_starts"": 171, ""market"": ""A""}",90.0,33.0,6.0,px6py4fl,vmu7c279,FULL STUDY,225.0,s3,1,100,115.0,-1,,1,sell,0,sell,0.4476889957041811,19,1,0,block 3 (G second),23.0,12.0,Female,1.0,0.0,0.0,"[3, 'block 3 (G second)']",0,1,1,0.5,7.0,-0.30000000000000004,0.3333333333333333,0.0,0.0,0.0,2,0.5,0.75,Design 2,Design 2,"Have an option between Design #1 and Design #2,",5.0,5.0,5.0
2168,3298,3,Player object (1049),sell,2023-03-09 03:39:17.123313+00:00,"{""priceA"": 115, ""sharesA"": 0, ""secs_since_round_starts"": 204, ""market"": ""A""}",205.0,39.0,7.0,px6py4fl,vmu7c279,FULL STUDY,225.0,s3,1,115,100.0,1,15.0,1,buy,0,sell,0.5221490272476892,19,0,0,block 3 (G second),23.0,12.0,Female,1.0,0.0,0.0,"[3, 'block 3 (G second)']",0,1,1,0.5,7.0,-0.30000000000000004,0.3333333333333333,0.0,0.0,0.0,2,0.5,0.75,Design 2,Design 2,"Have an option between Design #1 and Design #2,",5.0,5.0,5.0
2169,3299,3,Player object (1049),buy,2023-03-09 03:39:23.313373+00:00,"{""priceA"": 100, ""sharesA"": 1, ""secs_since_round_starts"": 210, ""market"": ""A""}",105.0,40.0,8.0,px6py4fl,vmu7c279,FULL STUDY,225.0,s3,1,100,115.0,-1,,1,sell,0,sell,0.4804175727303482,19,0,0,block 3 (G second),23.0,12.0,Female,1.0,0.0,0.0,"[3, 'block 3 (G second)']",0,1,1,0.5,7.0,-0.30000000000000004,0.3333333333333333,0.0,0.0,0.0,2,0.5,0.75,Design 2,Design 2,"Have an option between Design #1 and Design #2,",5.0,5.0,5.0
2170,3300,3,Player object (1049),sell,2023-03-09 03:39:39.284805+00:00,"{""priceA"": 120, ""sharesA"": 0, ""secs_since_round_starts"": 226, ""market"": ""A""}",225.0,43.0,9.0,px6py4fl,vmu7c279,FULL STUDY,225.0,s3,1,120,100.0,1,20.0,1,buy,0,sell,0.5357259670782416,19,0,0,block 3 (G second),23.0,12.0,Female,1.0,0.0,0.0,"[3, 'block 3 (G second)']",0,1,1,0.5,7.0,-0.30000000000000004,0.3333333333333333,0.0,0.0,0.0,2,0.5,0.75,Design 2,Design 2,"Have an option between Design #1 and Design #2,",5.0,5.0,5.0
2171,3309,3,Player object (1049),buy,2023-03-09 03:41:01.909259+00:00,"{""priceA"": 115, ""sharesA"": 1, ""secs_since_round_starts"": 308, ""market"": ""A""}",110.0,58.0,10.0,px6py4fl,vmu7c279,FULL STUDY,225.0,s3,1,115,120.0,-1,,1,sell,0,sell,0.442461876115205,19,1,0,block 3 (G second),23.0,12.0,Female,1.0,0.0,0.0,"[3, 'block 3 (G second)']",0,1,1,0.5,7.0,-0.30000000000000004,0.3333333333333333,0.0,0.0,0.0,2,0.5,0.75,Design 2,Design 2,"Have an option between Design #1 and Design #2,",5.0,5.0,5.0
2172,3314,4,Player object (1169),sell,2023-03-09 03:42:16.758910+00:00,"{""priceA"": 90, ""sharesA"": 0, ""secs_since_round_starts"": 57, ""market"": ""A""}",140.0,12.0,1.0,px6py4fl,vmu7c279,FULL STUDY,160.0,s3,1,90,,1,,1,,0,sell,0.5210961257750505,14,0,0,block 3 (G second),23.0,12.0,Female,1.0,0.0,0.0,"[4, 'block 3 (G second)']",1,0,1,0.5,7.0,-0.30000000000000004,0.4,0.06451612903225806,1.0,0.16666666666666666,2,1.0,0.75,Design 2,Design 2,"Have an option between Design #1 and Design #2,",5.0,5.0,5.0
2173,3317,4,Player object (1169),buy,2023-03-09 03:42:34.821060+00:00,"{""priceA"": 95, ""sharesA"": 1, ""secs_since_round_starts"": 75, ""market"": ""A""}",45.0,15.0,2.0,px6py4fl,vmu7c279,FULL STUDY,160.0,s3,1,95,90.0,-1,,1,sell,0,sell,0.5493972040799432,14,0,0,block 3 (G second),23.0,12.0,Female,1.0,0.0,0.0,"[4, 'block 3 (G second)']",1,0,1,0.5,7.0,-0.30000000000000004,0.4,0.06451612903225806,1.0,0.16666666666666666,2,1.0,0.75,Design 2,Design 2,"Have an option between Design #1 and Design #2,",5.0,5.0,5.0
2174,3325,4,Player object (1169),sell,2023-03-09 03:43:45.180284+00:00,"{""priceA"": 80, ""sharesA"": 0, ""secs_since_round_starts"": 145, ""market"": ""A""}",125.0,28.0,3.0,px6py4fl,vmu7c279,FULL STUDY,160.0,s3,1,80,95.0,1,-15.0,1,buy,0,sell,0.5529051331090981,14,0,1,block 3 (G second),23.0,12.0,Female,1.0,0.0,0.0,"[4, 'block 3 (G second)']",1,0,1,0.5,7.0,-0.30000000000000004,0.4,0.06451612903225806,1.0,0.16666666666666666,2,1.0,0.75,Design 2,Design 2,"Have an option between Design #1 and Design #2,",5.0,5.0,5.0
2175,3329,4,Player object (1169),buy,2023-03-09 03:44:30.742088+00:00,"{""priceA"": 85, ""sharesA"": 1, ""secs_since_round_starts"": 191, ""market"": ""A""}",40.0,36.0,4.0,px6py4fl,vmu7c279,FULL STUDY,160.0,s3,1,85,80.0,-1,,1,sell,0,sell,0.4885269486642424,14,0,0,block 3 (G second),23.0,12.0,Female,1.0,0.0,0.0,"[4, 'block 3 (G second)']",1,0,1,0.5,7.0,-0.30000000000000004,0.4,0.06451612903225806,1.0,0.16666666666666666,2,1.0,0.75,Design 2,Design 2,"Have an option between Design #1 and Design #2,",5.0,5.0,5.0
2176,3330,4,Player object (1169),sell,2023-03-09 03:45:09.526559+00:00,"{""priceA"": 100, ""sharesA"": 0, ""secs_since_round_starts"": 230, ""market"": ""A""}",140.0,43.0,5.0,px6py4fl,vmu7c279,FULL STUDY,160.0,s3,1,100,85.0,1,15.0,1,buy,0,sell,0.5617190733230237,14,0,1,block 3 (G second),23.0,12.0,Female,1.0,0.0,0.0,"[4, 'block 3 (G second)']",1,0,1,0.5,7.0,-0.30000000000000004,0.4,0.06451612903225806,1.0,0.16666666666666666,2,1.0,0.75,Design 2,Design 2,"Have an option between Design #1 and Design #2,",5.0,5.0,5.0
2177,3331,4,Player object (1169),buy,2023-03-09 03:45:36.900440+00:00,"{""priceA"": 100, ""sharesA"": 1, ""secs_since_round_starts"": 257, ""market"": ""A""}",40.0,48.0,6.0,px6py4fl,vmu7c279,FULL STUDY,160.0,s3,1,100,100.0,-1,,1,sell,0,sell,0.500105737602651,14,0,0,block 3 (G second),23.0,12.0,Female,1.0,0.0,0.0,"[4, 'block 3 (G second)']",1,0,1,0.5,7.0,-0.30000000000000004,0.4,0.06451612903225806,1.0,0.16666666666666666,2,1.0,0.75,Design 2,Design 2,"Have an option between Design #1 and Design #2,",5.0,5.0,5.0
2178,3332,4,Player object (1169),sell,2023-03-09 03:45:47.233223+00:00,"{""priceA"": 120, ""sharesA"": 0, ""secs_since_round_starts"": 267, ""market"": ""A""}",160.0,50.0,7.0,px6py4fl,vmu7c279,FULL STUDY,160.0,s3,1,120,100.0,1,20.0,1,buy,0,sell,0.5591364702939366,14,0,1,block 3 (G second),23.0,12.0,Female,1.0,0.0,0.0,"[4, 'block 3 (G second)']",1,0,1,0.5,7.0,-0.30000000000000004,0.4,0.06451612903225806,1.0,0.16666666666666666,2,1.0,0.75,Design 2,Design 2,"Have an option between Design #1 and Design #2,",5.0,5.0,5.0
2179,3334,4,Player object (1169),buy,2023-03-09 03:46:03.538379+00:00,"{""priceA"": 75, ""sharesA"": 1, ""secs_since_round_starts"": 284, ""market"": ""A""}",85.0,53.0,8.0,px6py4fl,vmu7c279,FULL STUDY,160.0,s3,1,75,120.0,-1,,1,sell,0,sell,0.4439854633835125,14,1,0,block 3 (G second),23.0,12.0,Female,1.0,0.0,0.0,"[4, 'block 3 (G second)']",1,0,1,0.5,7.0,-0.30000000000000004,0.4,0.06451612903225806,1.0,0.16666666666666666,2,1.0,0.75,Design 2,Design 2,"Have an option between Design #1 and Design #2,",5.0,5.0,5.0
2180,3346,5,Player object (1289),sell,2023-03-09 03:48:36.066634+00:00,"{""priceA"": 105, ""sharesA"": 0, ""secs_since_round_starts"": 107, ""market"": ""A""}",155.0,21.0,1.0,px6py4fl,vmu7c279,FULL STUDY,230.0,s3,1,105,,1,,1,,0,sell,0.5510362930796925,17,0,1,block 3 (G second),23.0,12.0,Female,1.0,0.0,0.0,"[5, 'block 3 (G second)']",1,1,1,0.5,7.0,-0.30000000000000004,0.5,0.0,0.75,0.0,4,0.5,0.75,Design 2,Design 2,"Have an option between Design #1 and Design #2,",5.0,5.0,5.0
2181,3350,5,Player object (1289),buy,2023-03-09 03:48:50.444987+00:00,"{""priceA"": 95, ""sharesA"": 1, ""secs_since_round_starts"": 121, ""market"": ""A""}",60.0,23.0,2.0,px6py4fl,vmu7c279,FULL STUDY,230.0,s3,1,95,105.0,-1,,1,sell,0,sell,0.5355078155027276,17,0,0,block 3 (G second),23.0,12.0,Female,1.0,0.0,0.0,"[5, 'block 3 (G second)']",1,1,1,0.5,7.0,-0.30000000000000004,0.5,0.0,0.75,0.0,4,0.5,0.75,Design 2,Design 2,"Have an option between Design #1 and Design #2,",5.0,5.0,5.0
2182,3352,5,Player object (1289),sell,2023-03-09 03:48:57.774653+00:00,"{""priceA"": 115, ""sharesA"": 0, ""secs_since_round_starts"": 129, ""market"": ""A""}",175.0,25.0,3.0,px6py4fl,vmu7c279,FULL STUDY,230.0,s3,1,115,95.0,1,20.0,1,buy,0,sell,0.5757035170695836,17,0,1,block 3 (G second),23.0,12.0,Female,1.0,0.0,0.0,"[5, 'block 3 (G second)']",1,1,1,0.5,7.0,-0.30000000000000004,0.5,0.0,0.75,0.0,4,0.5,0.75,Design 2,Design 2,"Have an option between Design #1 and Design #2,",5.0,5.0,5.0
2183,3356,5,Player object (1289),buy,2023-03-09 03:49:15.062552+00:00,"{""priceA"": 85, ""sharesA"": 1, ""secs_since_round_starts"": 146, ""market"": ""A""}",90.0,28.0,4.0,px6py4fl,vmu7c279,FULL STUDY,230.0,s3,1,85,115.0,-1,,1,sell,0,sell,0.4496194529460131,17,1,0,block 3 (G second),23.0,12.0,Female,1.0,0.0,0.0,"[5, 'block 3 (G second)']",1,1,1,0.5,7.0,-0.30000000000000004,0.5,0.0,0.75,0.0,4,0.5,0.75,Design 2,Design 2,"Have an option between Design #1 and Design #2,",5.0,5.0,5.0
2184,3359,5,Player object (1289),sell,2023-03-09 03:49:43.377103+00:00,"{""priceA"": 110, ""sharesA"": 0, ""secs_since_round_starts"": 174, ""market"": ""A""}",200.0,33.0,5.0,px6py4fl,vmu7c279,FULL STUDY,230.0,s3,1,110,85.0,1,25.0,1,buy,0,sell,0.5480287979668599,17,0,1,block 3 (G second),23.0,12.0,Female,1.0,0.0,0.0,"[5, 'block 3 (G second)']",1,1,1,0.5,7.0,-0.30000000000000004,0.5,0.0,0.75,0.0,4,0.5,0.75,Design 2,Design 2,"Have an option between Design #1 and Design #2,",5.0,5.0,5.0
2185,3362,5,Player object (1289),buy,2023-03-09 03:50:07.281816+00:00,"{""priceA"": 95, ""sharesA"": 1, ""secs_since_round_starts"": 198, ""market"": ""A""}",105.0,37.0,6.0,px6py4fl,vmu7c279,FULL STUDY,230.0,s3,1,95,110.0,-1,,1,sell,0,sell,0.4805886028013266,17,0,0,block 3 (G second),23.0,12.0,Female,1.0,0.0,0.0,"[5, 'block 3 (G second)']",1,1,1,0.5,7.0,-0.30000000000000004,0.5,0.0,0.75,0.0,4,0.5,0.75,Design 2,Design 2,"Have an option between Design #1 and Design #2,",5.0,5.0,5.0
2186,3363,5,Player object (1289),sell,2023-03-09 03:50:38.505951+00:00,"{""priceA"": 110, ""sharesA"": 0, ""secs_since_round_starts"": 229, ""market"": ""A""}",215.0,43.0,7.0,px6py4fl,vmu7c279,FULL STUDY,230.0,s3,1,110,95.0,1,15.0,1,buy,0,sell,0.571300234525265,17,0,0,block 3 (G second),23.0,12.0,Female,1.0,0.0,0.0,"[5, 'block 3 (G second)']",1,1,1,0.5,7.0,-0.30000000000000004,0.5,0.0,0.75,0.0,4,0.5,0.75,Design 2,Design 2,"Have an option between Design #1 and Design #2,",5.0,5.0,5.0
2187,3364,5,Player object (1289),buy,2023-03-09 03:51:06.655122+00:00,"{""priceA"": 75, ""sharesA"": 1, ""secs_since_round_starts"": 257, ""market"": ""A""}",140.0,48.0,8.0,px6py4fl,vmu7c279,FULL STUDY,230.0,s3,1,75,110.0,-1,,1,sell,0,sell,0.4393932183506925,17,1,0,block 3 (G second),23.0,12.0,Female,1.0,0.0,0.0,"[5, 'block 3 (G second)']",1,1,1,0.5,7.0,-0.30000000000000004,0.5,0.0,0.75,0.0,4,0.5,0.75,Design 2,Design 2,"Have an option between Design #1 and Design #2,",5.0,5.0,5.0
2188,3366,5,Player object (1289),sell,2023-03-09 03:51:36.345327+00:00,"{""priceA"": 85, ""sharesA"": 0, ""secs_since_round_starts"": 287, ""market"": ""A""}",225.0,53.0,9.0,px6py4fl,vmu7c279,FULL STUDY,230.0,s3,1,85,75.0,1,10.0,1,buy,0,sell,0.4927925471404216,17,0,0,block 3 (G second),23.0,12.0,Female,1.0,0.0,0.0,"[5, 'block 3 (G second)']",1,1,1,0.5,7.0,-0.30000000000000004,0.5,0.0,0.75,0.0,4,0.5,0.75,Design 2,Design 2,"Have an option between Design #1 and Design #2,",5.0,5.0,5.0
2189,3367,5,Player object (1289),buy,2023-03-09 03:51:44.088895+00:00,"{""priceA"": 80, ""sharesA"": 1, ""secs_since_round_starts"": 295, ""market"": ""A""}",145.0,55.0,10.0,px6py4fl,vmu7c279,FULL STUDY,230.0,s3,1,80,85.0,-1,,1,sell,0,sell,0.4859141076178286,17,0,0,block 3 (G second),23.0,12.0,Female,1.0,0.0,0.0,"[5, 'block 3 (G second)']",1,1,1,0.5,7.0,-0.30000000000000004,0.5,0.0,0.75,0.0,4,0.5,0.75,Design 2,Design 2,"Have an option between Design #1 and Design #2,",5.0,5.0,5.0
2190,3369,5,Player object (1289),sell,2023-03-09 03:51:56.348719+00:00,"{""priceA"": 95, ""sharesA"": 0, ""secs_since_round_starts"": 307, ""market"": ""A""}",240.0,56.0,11.0,px6py4fl,vmu7c279,FULL STUDY,230.0,s3,1,95,80.0,1,15.0,1,buy,0,sell,0.5252108989343294,17,0,0,block 3 (G second),23.0,12.0,Female,1.0,0.0,0.0,"[5, 'block 3 (G second)']",1,1,1,0.5,7.0,-0.30000000000000004,0.5,0.0,0.75,0.0,4,0.5,0.75,Design 2,Design 2,"Have an option between Design #1 and Design #2,",5.0,5.0,5.0
2191,3370,5,Player object (1289),buy,2023-03-09 03:52:05.624726+00:00,"{""priceA"": 75, ""sharesA"": 1, ""secs_since_round_starts"": 316, ""market"": ""A""}",165.0,58.0,12.0,px6py4fl,vmu7c279,FULL STUDY,230.0,s3,1,75,95.0,-1,,1,sell,0,sell,0.4529558772574278,17,0,0,block 3 (G second),23.0,12.0,Female,1.0,0.0,0.0,"[5, 'block 3 (G second)']",1,1,1,0.5,7.0,-0.30000000000000004,0.5,0.0,0.75,0.0,4,0.5,0.75,Design 2,Design 2,"Have an option between Design #1 and Design #2,",5.0,5.0,5.0
2192,1154,2,Player object (875),sell,2023-03-05 18:29:50.851052+00:00,"{""priceA"": 65, ""sharesA"": 0, ""secs_since_round_starts"": 93, ""market"": ""A""}",115.0,11.0,1.0,q5w3ghvj,vmu7c279,FULL STUDY,230.0,s3,1,65,,1,,1,,0,sell,0.4529543903039196,16,0,0,block 2 (G first),21.0,11.0,Male,1.0,0.0,0.0,"[2, 'block 2 (G first)']",1,1,0,0.0,5.0,-0.41666666666666663,0.3076923076923077,0.2857142857142857,0.8333333333333334,0.0,4,1.0,0.5,Design 2,Design 2,"Have an option between Design #1 and Design #2,",5.0,1.0,3.0
2193,1155,2,Player object (875),buy,2023-03-05 18:29:55.939771+00:00,"{""priceA"": 80, ""sharesA"": 1, ""secs_since_round_starts"": 99, ""market"": ""A""}",35.0,12.0,2.0,q5w3ghvj,vmu7c279,FULL STUDY,230.0,s3,1,80,65.0,-1,,1,sell,0,sell,0.502087716794639,16,0,0,block 2 (G first),21.0,11.0,Male,1.0,0.0,0.0,"[2, 'block 2 (G first)']",1,1,0,0.0,5.0,-0.41666666666666663,0.3076923076923077,0.2857142857142857,0.8333333333333334,0.0,4,1.0,0.5,Design 2,Design 2,"Have an option between Design #1 and Design #2,",5.0,1.0,3.0
2194,1156,2,Player object (875),sell,2023-03-05 18:30:07.548759+00:00,"{""priceA"": 105, ""sharesA"": 0, ""secs_since_round_starts"": 110, ""market"": ""A""}",140.0,14.0,3.0,q5w3ghvj,vmu7c279,FULL STUDY,230.0,s3,1,105,80.0,1,25.0,1,buy,0,sell,0.5600744319669811,16,0,1,block 2 (G first),21.0,11.0,Male,1.0,0.0,0.0,"[2, 'block 2 (G first)']",1,1,0,0.0,5.0,-0.41666666666666663,0.3076923076923077,0.2857142857142857,0.8333333333333334,0.0,4,1.0,0.5,Design 2,Design 2,"Have an option between Design #1 and Design #2,",5.0,1.0,3.0
2195,1157,2,Player object (875),buy,2023-03-05 18:30:23.275981+00:00,"{""priceA"": 110, ""sharesA"": 1, ""secs_since_round_starts"": 126, ""market"": ""A""}",30.0,17.0,4.0,q5w3ghvj,vmu7c279,FULL STUDY,230.0,s3,1,110,105.0,-1,,1,sell,0,sell,0.5478276073026133,16,0,0,block 2 (G first),21.0,11.0,Male,1.0,0.0,0.0,"[2, 'block 2 (G first)']",1,1,0,0.0,5.0,-0.41666666666666663,0.3076923076923077,0.2857142857142857,0.8333333333333334,0.0,4,1.0,0.5,Design 2,Design 2,"Have an option between Design #1 and Design #2,",5.0,1.0,3.0
2196,1158,2,Player object (875),sell,2023-03-05 18:30:35.680616+00:00,"{""priceA"": 130, ""sharesA"": 0, ""secs_since_round_starts"": 138, ""market"": ""A""}",160.0,19.0,5.0,q5w3ghvj,vmu7c279,FULL STUDY,230.0,s3,1,130,110.0,1,20.0,1,buy,0,sell,0.5813773703663461,16,0,1,block 2 (G first),21.0,11.0,Male,1.0,0.0,0.0,"[2, 'block 2 (G first)']",1,1,0,0.0,5.0,-0.41666666666666663,0.3076923076923077,0.2857142857142857,0.8333333333333334,0.0,4,1.0,0.5,Design 2,Design 2,"Have an option between Design #1 and Design #2,",5.0,1.0,3.0
2197,1159,2,Player object (875),buy,2023-03-05 18:30:45.737182+00:00,"{""priceA"": 130, ""sharesA"": 1, ""secs_since_round_starts"": 148, ""market"": ""A""}",30.0,21.0,6.0,q5w3ghvj,vmu7c279,FULL STUDY,230.0,s3,1,130,130.0,-1,,1,sell,0,sell,0.5504042050217014,16,0,0,block 2 (G first),21.0,11.0,Male,1.0,0.0,0.0,"[2, 'block 2 (G first)']",1,1,0,0.0,5.0,-0.41666666666666663,0.3076923076923077,0.2857142857142857,0.8333333333333334,0.0,4,1.0,0.5,Design 2,Design 2,"Have an option between Design #1 and Design #2,",5.0,1.0,3.0
2198,1160,2,Player object (875),sell,2023-03-05 18:30:57.534156+00:00,"{""priceA"": 150, ""sharesA"": 0, ""secs_since_round_starts"": 160, ""market"": ""A""}",180.0,23.0,7.0,q5w3ghvj,vmu7c279,FULL STUDY,230.0,s3,1,150,130.0,1,20.0,1,buy,0,sell,0.5825581483921976,16,0,1,block 2 (G first),21.0,11.0,Male,1.0,0.0,0.0,"[2, 'block 2 (G first)']",1,1,0,0.0,5.0,-0.41666666666666663,0.3076923076923077,0.2857142857142857,0.8333333333333334,0.0,4,1.0,0.5,Design 2,Design 2,"Have an option between Design #1 and Design #2,",5.0,1.0,3.0
2199,1161,2,Player object (875),buy,2023-03-05 18:31:02.676721+00:00,"{""priceA"": 160, ""sharesA"": 1, ""secs_since_round_starts"": 165, ""market"": ""A""}",20.0,24.0,8.0,q5w3ghvj,vmu7c279,FULL STUDY,230.0,s3,1,160,150.0,-1,,1,sell,0,sell,0.5912834651029929,16,0,0,block 2 (G first),21.0,11.0,Male,1.0,0.0,0.0,"[2, 'block 2 (G first)']",1,1,0,0.0,5.0,-0.41666666666666663,0.3076923076923077,0.2857142857142857,0.8333333333333334,0.0,4,1.0,0.5,Design 2,Design 2,"Have an option between Design #1 and Design #2,",5.0,1.0,3.0
2200,1162,2,Player object (875),sell,2023-03-05 18:31:07.745077+00:00,"{""priceA"": 145, ""sharesA"": 0, ""secs_since_round_starts"": 170, ""market"": ""A""}",165.0,25.0,9.0,q5w3ghvj,vmu7c279,FULL STUDY,230.0,s3,1,145,160.0,1,-15.0,1,buy,0,sell,0.5294358264188312,16,0,0,block 2 (G first),21.0,11.0,Male,1.0,0.0,0.0,"[2, 'block 2 (G first)']",1,1,0,0.0,5.0,-0.41666666666666663,0.3076923076923077,0.2857142857142857,0.8333333333333334,0.0,4,1.0,0.5,Design 2,Design 2,"Have an option between Design #1 and Design #2,",5.0,1.0,3.0
2201,1163,2,Player object (875),buy,2023-03-05 18:31:18.767158+00:00,"{""priceA"": 125, ""sharesA"": 1, ""secs_since_round_starts"": 181, ""market"": ""A""}",40.0,27.0,10.0,q5w3ghvj,vmu7c279,FULL STUDY,230.0,s3,1,125,145.0,-1,,1,sell,0,sell,0.4549942201992644,16,1,0,block 2 (G first),21.0,11.0,Male,1.0,0.0,0.0,"[2, 'block 2 (G first)']",1,1,0,0.0,5.0,-0.41666666666666663,0.3076923076923077,0.2857142857142857,0.8333333333333334,0.0,4,1.0,0.5,Design 2,Design 2,"Have an option between Design #1 and Design #2,",5.0,1.0,3.0
2202,1166,2,Player object (875),sell,2023-03-05 18:32:05.155003+00:00,"{""priceA"": 130, ""sharesA"": 0, ""secs_since_round_starts"": 228, ""market"": ""A""}",170.0,33.0,11.0,q5w3ghvj,vmu7c279,FULL STUDY,230.0,s3,1,130,125.0,1,5.0,1,buy,0,sell,0.499206602391208,16,0,0,block 2 (G first),21.0,11.0,Male,1.0,0.0,0.0,"[2, 'block 2 (G first)']",1,1,0,0.0,5.0,-0.41666666666666663,0.3076923076923077,0.2857142857142857,0.8333333333333334,0.0,4,1.0,0.5,Design 2,Design 2,"Have an option between Design #1 and Design #2,",5.0,1.0,3.0
2203,1167,2,Player object (875),buy,2023-03-05 18:32:14.347943+00:00,"{""priceA"": 140, ""sharesA"": 1, ""secs_since_round_starts"": 237, ""market"": ""A""}",30.0,35.0,12.0,q5w3ghvj,vmu7c279,FULL STUDY,230.0,s3,1,140,130.0,-1,,1,sell,0,sell,0.5101876173062244,16,0,0,block 2 (G first),21.0,11.0,Male,1.0,0.0,0.0,"[2, 'block 2 (G first)']",1,1,0,0.0,5.0,-0.41666666666666663,0.3076923076923077,0.2857142857142857,0.8333333333333334,0.0,4,1.0,0.5,Design 2,Design 2,"Have an option between Design #1 and Design #2,",5.0,1.0,3.0
2204,1168,2,Player object (875),sell,2023-03-05 18:32:25.898009+00:00,"{""priceA"": 145, ""sharesA"": 0, ""secs_since_round_starts"": 249, ""market"": ""A""}",175.0,37.0,13.0,q5w3ghvj,vmu7c279,FULL STUDY,230.0,s3,1,145,140.0,1,5.0,1,buy,0,sell,0.494384744736363,16,0,0,block 2 (G first),21.0,11.0,Male,1.0,0.0,0.0,"[2, 'block 2 (G first)']",1,1,0,0.0,5.0,-0.41666666666666663,0.3076923076923077,0.2857142857142857,0.8333333333333334,0.0,4,1.0,0.5,Design 2,Design 2,"Have an option between Design #1 and Design #2,",5.0,1.0,3.0
2205,1169,2,Player object (875),buy,2023-03-05 18:32:36.939378+00:00,"{""priceA"": 125, ""sharesA"": 1, ""secs_since_round_starts"": 260, ""market"": ""A""}",50.0,39.0,14.0,q5w3ghvj,vmu7c279,FULL STUDY,230.0,s3,1,125,145.0,-1,,1,sell,0,sell,0.4382592777609274,16,1,0,block 2 (G first),21.0,11.0,Male,1.0,0.0,0.0,"[2, 'block 2 (G first)']",1,1,0,0.0,5.0,-0.41666666666666663,0.3076923076923077,0.2857142857142857,0.8333333333333334,0.0,4,1.0,0.5,Design 2,Design 2,"Have an option between Design #1 and Design #2,",5.0,1.0,3.0
2206,1170,2,Player object (875),sell,2023-03-05 18:33:16.627592+00:00,"{""priceA"": 155, ""sharesA"": 0, ""secs_since_round_starts"": 299, ""market"": ""A""}",205.0,46.0,15.0,q5w3ghvj,vmu7c279,FULL STUDY,230.0,s3,1,155,125.0,1,30.0,1,buy,0,sell,0.5495494947508355,16,0,1,block 2 (G first),21.0,11.0,Male,1.0,0.0,0.0,"[2, 'block 2 (G first)']",1,1,0,0.0,5.0,-0.41666666666666663,0.3076923076923077,0.2857142857142857,0.8333333333333334,0.0,4,1.0,0.5,Design 2,Design 2,"Have an option between Design #1 and Design #2,",5.0,1.0,3.0
2207,1172,2,Player object (875),buy,2023-03-05 18:33:31.498207+00:00,"{""priceA"": 155, ""sharesA"": 1, ""secs_since_round_starts"": 314, ""market"": ""A""}",50.0,48.0,16.0,q5w3ghvj,vmu7c279,FULL STUDY,230.0,s3,1,155,155.0,-1,,1,sell,0,sell,0.5347792584548927,16,0,0,block 2 (G first),21.0,11.0,Male,1.0,0.0,0.0,"[2, 'block 2 (G first)']",1,1,0,0.0,5.0,-0.41666666666666663,0.3076923076923077,0.2857142857142857,0.8333333333333334,0.0,4,1.0,0.5,Design 2,Design 2,"Have an option between Design #1 and Design #2,",5.0,1.0,3.0
2208,1173,2,Player object (875),sell,2023-03-05 18:33:43.001340+00:00,"{""priceA"": 155, ""sharesA"": 0, ""secs_since_round_starts"": 326, ""market"": ""A""}",205.0,50.0,17.0,q5w3ghvj,vmu7c279,FULL STUDY,230.0,s3,1,155,155.0,1,0.0,1,buy,0,sell,0.5063294801170398,16,0,0,block 2 (G first),21.0,11.0,Male,1.0,0.0,0.0,"[2, 'block 2 (G first)']",1,1,0,0.0,5.0,-0.41666666666666663,0.3076923076923077,0.2857142857142857,0.8333333333333334,0.0,4,1.0,0.5,Design 2,Design 2,"Have an option between Design #1 and Design #2,",5.0,1.0,3.0
2209,1174,2,Player object (875),buy,2023-03-05 18:33:53.186385+00:00,"{""priceA"": 125, ""sharesA"": 1, ""secs_since_round_starts"": 336, ""market"": ""A""}",80.0,52.0,18.0,q5w3ghvj,vmu7c279,FULL STUDY,230.0,s3,1,125,155.0,-1,,1,sell,0,sell,0.4439176376077041,16,1,0,block 2 (G first),21.0,11.0,Male,1.0,0.0,0.0,"[2, 'block 2 (G first)']",1,1,0,0.0,5.0,-0.41666666666666663,0.3076923076923077,0.2857142857142857,0.8333333333333334,0.0,4,1.0,0.5,Design 2,Design 2,"Have an option between Design #1 and Design #2,",5.0,1.0,3.0
2210,1175,2,Player object (875),sell,2023-03-05 18:34:13.240586+00:00,"{""priceA"": 135, ""sharesA"": 0, ""secs_since_round_starts"": 356, ""market"": ""A""}",215.0,55.0,19.0,q5w3ghvj,vmu7c279,FULL STUDY,230.0,s3,1,135,125.0,1,10.0,1,buy,0,sell,0.4873282494519479,16,0,0,block 2 (G first),21.0,11.0,Male,1.0,0.0,0.0,"[2, 'block 2 (G first)']",1,1,0,0.0,5.0,-0.41666666666666663,0.3076923076923077,0.2857142857142857,0.8333333333333334,0.0,4,1.0,0.5,Design 2,Design 2,"Have an option between Design #1 and Design #2,",5.0,1.0,3.0
2211,1176,2,Player object (875),buy,2023-03-05 18:34:21.202618+00:00,"{""priceA"": 110, ""sharesA"": 1, ""secs_since_round_starts"": 364, ""market"": ""A""}",105.0,57.0,20.0,q5w3ghvj,vmu7c279,FULL STUDY,230.0,s3,1,110,135.0,-1,,1,sell,0,sell,0.4349378880511929,16,1,0,block 2 (G first),21.0,11.0,Male,1.0,0.0,0.0,"[2, 'block 2 (G first)']",1,1,0,0.0,5.0,-0.41666666666666663,0.3076923076923077,0.2857142857142857,0.8333333333333334,0.0,4,1.0,0.5,Design 2,Design 2,"Have an option between Design #1 and Design #2,",5.0,1.0,3.0
2212,1178,2,Player object (875),sell,2023-03-05 18:34:45.148112+00:00,"{""priceA"": 125, ""sharesA"": 0, ""secs_since_round_starts"": 388, ""market"": ""A""}",230.0,60.0,21.0,q5w3ghvj,vmu7c279,FULL STUDY,230.0,s3,1,125,110.0,1,15.0,1,buy,0,sell,0.5540089061739091,16,0,1,block 2 (G first),21.0,11.0,Male,1.0,0.0,0.0,"[2, 'block 2 (G first)']",1,1,0,0.0,5.0,-0.41666666666666663,0.3076923076923077,0.2857142857142857,0.8333333333333334,0.0,4,1.0,0.5,Design 2,Design 2,"Have an option between Design #1 and Design #2,",5.0,1.0,3.0
2213,1181,3,Player object (995),sell,2023-03-05 18:36:03.693216+00:00,"{""priceA"": 95, ""sharesA"": 0, ""secs_since_round_starts"": 70, ""market"": ""A""}",145.0,10.0,1.0,q5w3ghvj,vmu7c279,FULL STUDY,250.0,s3,1,95,,1,,1,,0,sell,0.4922087569005138,19,0,0,block 2 (G first),21.0,11.0,Male,1.0,0.0,0.0,"[3, 'block 2 (G first)']",1,0,0,0.5,5.0,-0.41666666666666663,0.29411764705882354,0.1,1.0,0.0,2,0.5,0.75,Design 2,Design 2,"Have an option between Design #1 and Design #2,",5.0,1.0,3.0
2214,1182,3,Player object (995),buy,2023-03-05 18:36:36.086937+00:00,"{""priceA"": 100, ""sharesA"": 1, ""secs_since_round_starts"": 103, ""market"": ""A""}",45.0,16.0,2.0,q5w3ghvj,vmu7c279,FULL STUDY,250.0,s3,1,100,95.0,-1,,1,sell,0,sell,0.4486815727575955,19,1,0,block 2 (G first),21.0,11.0,Male,1.0,0.0,0.0,"[3, 'block 2 (G first)']",1,0,0,0.5,5.0,-0.41666666666666663,0.29411764705882354,0.1,1.0,0.0,2,0.5,0.75,Design 2,Design 2,"Have an option between Design #1 and Design #2,",5.0,1.0,3.0
2215,1183,3,Player object (995),sell,2023-03-05 18:36:52.874134+00:00,"{""priceA"": 120, ""sharesA"": 0, ""secs_since_round_starts"": 120, ""market"": ""A""}",165.0,19.0,3.0,q5w3ghvj,vmu7c279,FULL STUDY,250.0,s3,1,120,100.0,1,20.0,1,buy,0,sell,0.5586446427659006,19,0,1,block 2 (G first),21.0,11.0,Male,1.0,0.0,0.0,"[3, 'block 2 (G first)']",1,0,0,0.5,5.0,-0.41666666666666663,0.29411764705882354,0.1,1.0,0.0,2,0.5,0.75,Design 2,Design 2,"Have an option between Design #1 and Design #2,",5.0,1.0,3.0
2216,1184,3,Player object (995),buy,2023-03-05 18:37:08.975235+00:00,"{""priceA"": 85, ""sharesA"": 1, ""secs_since_round_starts"": 136, ""market"": ""A""}",80.0,22.0,4.0,q5w3ghvj,vmu7c279,FULL STUDY,250.0,s3,1,85,120.0,-1,,1,sell,0,sell,0.443819468959905,19,1,0,block 2 (G first),21.0,11.0,Male,1.0,0.0,0.0,"[3, 'block 2 (G first)']",1,0,0,0.5,5.0,-0.41666666666666663,0.29411764705882354,0.1,1.0,0.0,2,0.5,0.75,Design 2,Design 2,"Have an option between Design #1 and Design #2,",5.0,1.0,3.0
2217,1185,3,Player object (995),sell,2023-03-05 18:37:27.204987+00:00,"{""priceA"": 110, ""sharesA"": 0, ""secs_since_round_starts"": 154, ""market"": ""A""}",190.0,25.0,5.0,q5w3ghvj,vmu7c279,FULL STUDY,250.0,s3,1,110,85.0,1,25.0,1,buy,0,sell,0.4872943409941583,19,0,0,block 2 (G first),21.0,11.0,Male,1.0,0.0,0.0,"[3, 'block 2 (G first)']",1,0,0,0.5,5.0,-0.41666666666666663,0.29411764705882354,0.1,1.0,0.0,2,0.5,0.75,Design 2,Design 2,"Have an option between Design #1 and Design #2,",5.0,1.0,3.0
2218,1186,3,Player object (995),buy,2023-03-05 18:37:33.006975+00:00,"{""priceA"": 115, ""sharesA"": 1, ""secs_since_round_starts"": 160, ""market"": ""A""}",75.0,26.0,6.0,q5w3ghvj,vmu7c279,FULL STUDY,250.0,s3,1,115,110.0,-1,,1,sell,0,sell,0.526172546586359,19,0,0,block 2 (G first),21.0,11.0,Male,1.0,0.0,0.0,"[3, 'block 2 (G first)']",1,0,0,0.5,5.0,-0.41666666666666663,0.29411764705882354,0.1,1.0,0.0,2,0.5,0.75,Design 2,Design 2,"Have an option between Design #1 and Design #2,",5.0,1.0,3.0
2219,1187,3,Player object (995),sell,2023-03-05 18:37:53.926396+00:00,"{""priceA"": 120, ""sharesA"": 0, ""secs_since_round_starts"": 181, ""market"": ""A""}",195.0,30.0,7.0,q5w3ghvj,vmu7c279,FULL STUDY,250.0,s3,1,120,115.0,1,5.0,1,buy,0,sell,0.570054331362491,19,0,1,block 2 (G first),21.0,11.0,Male,1.0,0.0,0.0,"[3, 'block 2 (G first)']",1,0,0,0.5,5.0,-0.41666666666666663,0.29411764705882354,0.1,1.0,0.0,2,0.5,0.75,Design 2,Design 2,"Have an option between Design #1 and Design #2,",5.0,1.0,3.0
2220,1189,3,Player object (995),buy,2023-03-05 18:38:19.166239+00:00,"{""priceA"": 100, ""sharesA"": 1, ""secs_since_round_starts"": 206, ""market"": ""A""}",95.0,33.0,8.0,q5w3ghvj,vmu7c279,FULL STUDY,250.0,s3,1,100,120.0,-1,,1,sell,0,sell,0.4476889957041811,19,1,0,block 2 (G first),21.0,11.0,Male,1.0,0.0,0.0,"[3, 'block 2 (G first)']",1,0,0,0.5,5.0,-0.41666666666666663,0.29411764705882354,0.1,1.0,0.0,2,0.5,0.75,Design 2,Design 2,"Have an option between Design #1 and Design #2,",5.0,1.0,3.0
2221,1190,3,Player object (995),sell,2023-03-05 18:38:56.430972+00:00,"{""priceA"": 100, ""sharesA"": 0, ""secs_since_round_starts"": 243, ""market"": ""A""}",195.0,40.0,9.0,q5w3ghvj,vmu7c279,FULL STUDY,250.0,s3,1,100,100.0,1,0.0,1,buy,0,sell,0.4804175727303482,19,0,0,block 2 (G first),21.0,11.0,Male,1.0,0.0,0.0,"[3, 'block 2 (G first)']",1,0,0,0.5,5.0,-0.41666666666666663,0.29411764705882354,0.1,1.0,0.0,2,0.5,0.75,Design 2,Design 2,"Have an option between Design #1 and Design #2,",5.0,1.0,3.0
2222,1191,3,Player object (995),buy,2023-03-05 18:39:07.071589+00:00,"{""priceA"": 105, ""sharesA"": 1, ""secs_since_round_starts"": 254, ""market"": ""A""}",90.0,42.0,10.0,q5w3ghvj,vmu7c279,FULL STUDY,250.0,s3,1,105,100.0,-1,,1,sell,0,sell,0.5010477910686952,19,0,0,block 2 (G first),21.0,11.0,Male,1.0,0.0,0.0,"[3, 'block 2 (G first)']",1,0,0,0.5,5.0,-0.41666666666666663,0.29411764705882354,0.1,1.0,0.0,2,0.5,0.75,Design 2,Design 2,"Have an option between Design #1 and Design #2,",5.0,1.0,3.0
2223,1193,3,Player object (995),sell,2023-03-05 18:39:22.263126+00:00,"{""priceA"": 135, ""sharesA"": 0, ""secs_since_round_starts"": 269, ""market"": ""A""}",225.0,44.0,11.0,q5w3ghvj,vmu7c279,FULL STUDY,250.0,s3,1,135,105.0,1,30.0,1,buy,0,sell,0.5595824488336746,19,0,1,block 2 (G first),21.0,11.0,Male,1.0,0.0,0.0,"[3, 'block 2 (G first)']",1,0,0,0.5,5.0,-0.41666666666666663,0.29411764705882354,0.1,1.0,0.0,2,0.5,0.75,Design 2,Design 2,"Have an option between Design #1 and Design #2,",5.0,1.0,3.0
2224,1194,3,Player object (995),buy,2023-03-05 18:39:47.765959+00:00,"{""priceA"": 125, ""sharesA"": 1, ""secs_since_round_starts"": 295, ""market"": ""A""}",100.0,48.0,12.0,q5w3ghvj,vmu7c279,FULL STUDY,250.0,s3,1,125,135.0,-1,,1,sell,0,sell,0.4599698795591006,19,0,0,block 2 (G first),21.0,11.0,Male,1.0,0.0,0.0,"[3, 'block 2 (G first)']",1,0,0,0.5,5.0,-0.41666666666666663,0.29411764705882354,0.1,1.0,0.0,2,0.5,0.75,Design 2,Design 2,"Have an option between Design #1 and Design #2,",5.0,1.0,3.0
2225,1195,3,Player object (995),sell,2023-03-05 18:40:22.858185+00:00,"{""priceA"": 150, ""sharesA"": 0, ""secs_since_round_starts"": 330, ""market"": ""A""}",250.0,55.0,13.0,q5w3ghvj,vmu7c279,FULL STUDY,250.0,s3,1,150,125.0,1,25.0,1,buy,0,sell,0.5546141592279494,19,0,1,block 2 (G first),21.0,11.0,Male,1.0,0.0,0.0,"[3, 'block 2 (G first)']",1,0,0,0.5,5.0,-0.41666666666666663,0.29411764705882354,0.1,1.0,0.0,2,0.5,0.75,Design 2,Design 2,"Have an option between Design #1 and Design #2,",5.0,1.0,3.0
2226,1196,3,Player object (995),buy,2023-03-05 18:40:40.142574+00:00,"{""priceA"": 115, ""sharesA"": 1, ""secs_since_round_starts"": 347, ""market"": ""A""}",135.0,58.0,14.0,q5w3ghvj,vmu7c279,FULL STUDY,250.0,s3,1,115,150.0,-1,,1,sell,0,sell,0.442461876115205,19,1,0,block 2 (G first),21.0,11.0,Male,1.0,0.0,0.0,"[3, 'block 2 (G first)']",1,0,0,0.5,5.0,-0.41666666666666663,0.29411764705882354,0.1,1.0,0.0,2,0.5,0.75,Design 2,Design 2,"Have an option between Design #1 and Design #2,",5.0,1.0,3.0
2227,1197,3,Player object (995),sell,2023-03-05 18:40:52.169126+00:00,"{""priceA"": 115, ""sharesA"": 0, ""secs_since_round_starts"": 359, ""market"": ""A""}",250.0,60.0,15.0,q5w3ghvj,vmu7c279,FULL STUDY,250.0,s3,1,115,115.0,1,0.0,1,buy,0,sell,0.4613046310449969,19,0,0,block 2 (G first),21.0,11.0,Male,1.0,0.0,0.0,"[3, 'block 2 (G first)']",1,0,0,0.5,5.0,-0.41666666666666663,0.29411764705882354,0.1,1.0,0.0,2,0.5,0.75,Design 2,Design 2,"Have an option between Design #1 and Design #2,",5.0,1.0,3.0
2228,1202,4,Player object (1115),sell,2023-03-05 18:41:53.471628+00:00,"{""priceA"": 70, ""sharesA"": 0, ""secs_since_round_starts"": 49, ""market"": ""A""}",120.0,9.0,1.0,q5w3ghvj,vmu7c279,FULL STUDY,205.0,s3,1,70,,1,,1,,0,sell,0.5440818519127735,14,0,1,block 2 (G first),21.0,11.0,Male,1.0,0.0,0.0,"[4, 'block 2 (G first)']",0,1,0,0.5,5.0,-0.41666666666666663,0.25,0.058823529411764705,0.5,0.3333333333333333,2,1.0,0.75,Design 2,Design 2,"Have an option between Design #1 and Design #2,",5.0,1.0,3.0
2229,1203,4,Player object (1115),buy,2023-03-05 18:42:17.093119+00:00,"{""priceA"": 90, ""sharesA"": 1, ""secs_since_round_starts"": 72, ""market"": ""A""}",30.0,14.0,2.0,q5w3ghvj,vmu7c279,FULL STUDY,205.0,s3,1,90,70.0,-1,,1,sell,0,sell,0.5208618681016636,14,0,0,block 2 (G first),21.0,11.0,Male,1.0,0.0,0.0,"[4, 'block 2 (G first)']",0,1,0,0.5,5.0,-0.41666666666666663,0.25,0.058823529411764705,0.5,0.3333333333333333,2,1.0,0.75,Design 2,Design 2,"Have an option between Design #1 and Design #2,",5.0,1.0,3.0
2230,1204,4,Player object (1115),sell,2023-03-05 18:42:27.835758+00:00,"{""priceA"": 90, ""sharesA"": 0, ""secs_since_round_starts"": 83, ""market"": ""A""}",120.0,16.0,3.0,q5w3ghvj,vmu7c279,FULL STUDY,205.0,s3,1,90,90.0,1,0.0,1,buy,0,sell,0.4995738325599586,14,0,0,block 2 (G first),21.0,11.0,Male,1.0,0.0,0.0,"[4, 'block 2 (G first)']",0,1,0,0.5,5.0,-0.41666666666666663,0.25,0.058823529411764705,0.5,0.3333333333333333,2,1.0,0.75,Design 2,Design 2,"Have an option between Design #1 and Design #2,",5.0,1.0,3.0
2231,1205,4,Player object (1115),buy,2023-03-05 18:42:41.659504+00:00,"{""priceA"": 70, ""sharesA"": 1, ""secs_since_round_starts"": 97, ""market"": ""A""}",50.0,18.0,4.0,q5w3ghvj,vmu7c279,FULL STUDY,205.0,s3,1,70,90.0,-1,,1,sell,0,sell,0.4407118028401492,14,1,0,block 2 (G first),21.0,11.0,Male,1.0,0.0,0.0,"[4, 'block 2 (G first)']",0,1,0,0.5,5.0,-0.41666666666666663,0.25,0.058823529411764705,0.5,0.3333333333333333,2,1.0,0.75,Design 2,Design 2,"Have an option between Design #1 and Design #2,",5.0,1.0,3.0
2232,1206,4,Player object (1115),sell,2023-03-05 18:42:50.720743+00:00,"{""priceA"": 70, ""sharesA"": 0, ""secs_since_round_starts"": 106, ""market"": ""A""}",120.0,20.0,5.0,q5w3ghvj,vmu7c279,FULL STUDY,205.0,s3,1,70,70.0,1,0.0,1,buy,0,sell,0.4604462199730844,14,0,0,block 2 (G first),21.0,11.0,Male,1.0,0.0,0.0,"[4, 'block 2 (G first)']",0,1,0,0.5,5.0,-0.41666666666666663,0.25,0.058823529411764705,0.5,0.3333333333333333,2,1.0,0.75,Design 2,Design 2,"Have an option between Design #1 and Design #2,",5.0,1.0,3.0
2233,1207,4,Player object (1115),buy,2023-03-05 18:43:03.255246+00:00,"{""priceA"": 55, ""sharesA"": 1, ""secs_since_round_starts"": 119, ""market"": ""A""}",65.0,22.0,6.0,q5w3ghvj,vmu7c279,FULL STUDY,205.0,s3,1,55,70.0,-1,,1,sell,0,sell,0.4224279859932807,14,1,0,block 2 (G first),21.0,11.0,Male,1.0,0.0,0.0,"[4, 'block 2 (G first)']",0,1,0,0.5,5.0,-0.41666666666666663,0.25,0.058823529411764705,0.5,0.3333333333333333,2,1.0,0.75,Design 2,Design 2,"Have an option between Design #1 and Design #2,",5.0,1.0,3.0
2234,1208,4,Player object (1115),sell,2023-03-05 18:43:15.499733+00:00,"{""priceA"": 55, ""sharesA"": 0, ""secs_since_round_starts"": 131, ""market"": ""A""}",120.0,24.0,7.0,q5w3ghvj,vmu7c279,FULL STUDY,205.0,s3,1,55,55.0,1,0.0,1,buy,0,sell,0.4514670992379582,14,0,0,block 2 (G first),21.0,11.0,Male,1.0,0.0,0.0,"[4, 'block 2 (G first)']",0,1,0,0.5,5.0,-0.41666666666666663,0.25,0.058823529411764705,0.5,0.3333333333333333,2,1.0,0.75,Design 2,Design 2,"Have an option between Design #1 and Design #2,",5.0,1.0,3.0
2235,1209,4,Player object (1115),buy,2023-03-05 18:43:22.705111+00:00,"{""priceA"": 55, ""sharesA"": 1, ""secs_since_round_starts"": 138, ""market"": ""A""}",65.0,26.0,8.0,q5w3ghvj,vmu7c279,FULL STUDY,205.0,s3,1,55,55.0,-1,,1,sell,0,sell,0.4870054870256314,14,0,0,block 2 (G first),21.0,11.0,Male,1.0,0.0,0.0,"[4, 'block 2 (G first)']",0,1,0,0.5,5.0,-0.41666666666666663,0.25,0.058823529411764705,0.5,0.3333333333333333,2,1.0,0.75,Design 2,Design 2,"Have an option between Design #1 and Design #2,",5.0,1.0,3.0
2236,1210,4,Player object (1115),sell,2023-03-05 18:43:42.587910+00:00,"{""priceA"": 90, ""sharesA"": 0, ""secs_since_round_starts"": 158, ""market"": ""A""}",155.0,29.0,9.0,q5w3ghvj,vmu7c279,FULL STUDY,205.0,s3,1,90,55.0,1,35.0,1,buy,0,sell,0.5712793841154561,14,0,0,block 2 (G first),21.0,11.0,Male,1.0,0.0,0.0,"[4, 'block 2 (G first)']",0,1,0,0.5,5.0,-0.41666666666666663,0.25,0.058823529411764705,0.5,0.3333333333333333,2,1.0,0.75,Design 2,Design 2,"Have an option between Design #1 and Design #2,",5.0,1.0,3.0
2237,1212,4,Player object (1115),buy,2023-03-05 18:44:00.497501+00:00,"{""priceA"": 95, ""sharesA"": 1, ""secs_since_round_starts"": 176, ""market"": ""A""}",60.0,32.0,10.0,q5w3ghvj,vmu7c279,FULL STUDY,205.0,s3,1,95,90.0,-1,,1,sell,0,sell,0.5179404569050043,14,0,0,block 2 (G first),21.0,11.0,Male,1.0,0.0,0.0,"[4, 'block 2 (G first)']",0,1,0,0.5,5.0,-0.41666666666666663,0.25,0.058823529411764705,0.5,0.3333333333333333,2,1.0,0.75,Design 2,Design 2,"Have an option between Design #1 and Design #2,",5.0,1.0,3.0
2238,1213,4,Player object (1115),sell,2023-03-05 18:44:12.814674+00:00,"{""priceA"": 95, ""sharesA"": 0, ""secs_since_round_starts"": 188, ""market"": ""A""}",155.0,34.0,11.0,q5w3ghvj,vmu7c279,FULL STUDY,205.0,s3,1,95,95.0,1,0.0,1,buy,0,sell,0.4981543075921684,14,0,0,block 2 (G first),21.0,11.0,Male,1.0,0.0,0.0,"[4, 'block 2 (G first)']",0,1,0,0.5,5.0,-0.41666666666666663,0.25,0.058823529411764705,0.5,0.3333333333333333,2,1.0,0.75,Design 2,Design 2,"Have an option between Design #1 and Design #2,",5.0,1.0,3.0
2239,1214,4,Player object (1115),buy,2023-03-05 18:44:14.328198+00:00,"{""priceA"": 100, ""sharesA"": 1, ""secs_since_round_starts"": 190, ""market"": ""A""}",55.0,35.0,12.0,q5w3ghvj,vmu7c279,FULL STUDY,205.0,s3,1,100,95.0,-1,,1,sell,0,sell,0.5337204628349665,14,0,0,block 2 (G first),21.0,11.0,Male,1.0,0.0,0.0,"[4, 'block 2 (G first)']",0,1,0,0.5,5.0,-0.41666666666666663,0.25,0.058823529411764705,0.5,0.3333333333333333,2,1.0,0.75,Design 2,Design 2,"Have an option between Design #1 and Design #2,",5.0,1.0,3.0
2240,1215,4,Player object (1115),sell,2023-03-05 18:45:05.581443+00:00,"{""priceA"": 115, ""sharesA"": 0, ""secs_since_round_starts"": 241, ""market"": ""A""}",170.0,44.0,13.0,q5w3ghvj,vmu7c279,FULL STUDY,205.0,s3,1,115,100.0,1,15.0,1,buy,0,sell,0.5772497941838325,14,0,0,block 2 (G first),21.0,11.0,Male,1.0,0.0,0.0,"[4, 'block 2 (G first)']",0,1,0,0.5,5.0,-0.41666666666666663,0.25,0.058823529411764705,0.5,0.3333333333333333,2,1.0,0.75,Design 2,Design 2,"Have an option between Design #1 and Design #2,",5.0,1.0,3.0
2241,1216,4,Player object (1115),buy,2023-03-05 18:45:21.436312+00:00,"{""priceA"": 85, ""sharesA"": 1, ""secs_since_round_starts"": 257, ""market"": ""A""}",85.0,47.0,14.0,q5w3ghvj,vmu7c279,FULL STUDY,205.0,s3,1,85,115.0,-1,,1,sell,0,sell,0.4501495476988393,14,1,0,block 2 (G first),21.0,11.0,Male,1.0,0.0,0.0,"[4, 'block 2 (G first)']",0,1,0,0.5,5.0,-0.41666666666666663,0.25,0.058823529411764705,0.5,0.3333333333333333,2,1.0,0.75,Design 2,Design 2,"Have an option between Design #1 and Design #2,",5.0,1.0,3.0
2242,1217,4,Player object (1115),sell,2023-03-05 18:45:37.545912+00:00,"{""priceA"": 120, ""sharesA"": 0, ""secs_since_round_starts"": 273, ""market"": ""A""}",205.0,50.0,15.0,q5w3ghvj,vmu7c279,FULL STUDY,205.0,s3,1,120,85.0,1,35.0,1,buy,0,sell,0.5591364702939366,14,0,1,block 2 (G first),21.0,11.0,Male,1.0,0.0,0.0,"[4, 'block 2 (G first)']",0,1,0,0.5,5.0,-0.41666666666666663,0.25,0.058823529411764705,0.5,0.3333333333333333,2,1.0,0.75,Design 2,Design 2,"Have an option between Design #1 and Design #2,",5.0,1.0,3.0
2243,1218,4,Player object (1115),buy,2023-03-05 18:45:55.461715+00:00,"{""priceA"": 75, ""sharesA"": 1, ""secs_since_round_starts"": 291, ""market"": ""A""}",130.0,53.0,16.0,q5w3ghvj,vmu7c279,FULL STUDY,205.0,s3,1,75,120.0,-1,,1,sell,0,sell,0.4439854633835125,14,1,0,block 2 (G first),21.0,11.0,Male,1.0,0.0,0.0,"[4, 'block 2 (G first)']",0,1,0,0.5,5.0,-0.41666666666666663,0.25,0.058823529411764705,0.5,0.3333333333333333,2,1.0,0.75,Design 2,Design 2,"Have an option between Design #1 and Design #2,",5.0,1.0,3.0
2244,1222,5,Player object (1235),sell,2023-03-05 18:47:09.477029+00:00,"{""priceA"": 95, ""sharesA"": 0, ""secs_since_round_starts"": 29, ""market"": ""A""}",145.0,6.0,1.0,q5w3ghvj,vmu7c279,FULL STUDY,210.0,s3,1,95,,1,,1,,0,sell,0.5560314405213382,17,0,1,block 2 (G first),21.0,11.0,Male,1.0,0.0,0.0,"[5, 'block 2 (G first)']",0,0,0,0.0,5.0,-0.41666666666666663,0.38461538461538464,0.041666666666666664,0.5,0.25,4,0.5,0.75,Design 2,Design 2,"Have an option between Design #1 and Design #2,",5.0,1.0,3.0
2245,1223,5,Player object (1235),buy,2023-03-05 18:47:27.826570+00:00,"{""priceA"": 75, ""sharesA"": 1, ""secs_since_round_starts"": 48, ""market"": ""A""}",70.0,10.0,2.0,q5w3ghvj,vmu7c279,FULL STUDY,210.0,s3,1,75,95.0,-1,,1,sell,0,sell,0.4488309348307913,17,1,0,block 2 (G first),21.0,11.0,Male,1.0,0.0,0.0,"[5, 'block 2 (G first)']",0,0,0,0.0,5.0,-0.41666666666666663,0.38461538461538464,0.041666666666666664,0.5,0.25,4,0.5,0.75,Design 2,Design 2,"Have an option between Design #1 and Design #2,",5.0,1.0,3.0
2246,1224,5,Player object (1235),sell,2023-03-05 18:47:45.957617+00:00,"{""priceA"": 85, ""sharesA"": 0, ""secs_since_round_starts"": 66, ""market"": ""A""}",155.0,13.0,3.0,q5w3ghvj,vmu7c279,FULL STUDY,210.0,s3,1,85,75.0,1,10.0,1,buy,0,sell,0.4890232705715233,17,0,0,block 2 (G first),21.0,11.0,Male,1.0,0.0,0.0,"[5, 'block 2 (G first)']",0,0,0,0.0,5.0,-0.41666666666666663,0.38461538461538464,0.041666666666666664,0.5,0.25,4,0.5,0.75,Design 2,Design 2,"Have an option between Design #1 and Design #2,",5.0,1.0,3.0
2247,1225,5,Player object (1235),buy,2023-03-05 18:47:56.237480+00:00,"{""priceA"": 90, ""sharesA"": 1, ""secs_since_round_starts"": 76, ""market"": ""A""}",65.0,15.0,4.0,q5w3ghvj,vmu7c279,FULL STUDY,210.0,s3,1,90,85.0,-1,,1,sell,0,sell,0.505231414156075,17,0,0,block 2 (G first),21.0,11.0,Male,1.0,0.0,0.0,"[5, 'block 2 (G first)']",0,0,0,0.0,5.0,-0.41666666666666663,0.38461538461538464,0.041666666666666664,0.5,0.25,4,0.5,0.75,Design 2,Design 2,"Have an option between Design #1 and Design #2,",5.0,1.0,3.0
2248,1226,5,Player object (1235),sell,2023-03-05 18:48:30.194034+00:00,"{""priceA"": 105, ""sharesA"": 0, ""secs_since_round_starts"": 110, ""market"": ""A""}",170.0,21.0,5.0,q5w3ghvj,vmu7c279,FULL STUDY,210.0,s3,1,105,90.0,1,15.0,1,buy,0,sell,0.5510362930796925,17,0,1,block 2 (G first),21.0,11.0,Male,1.0,0.0,0.0,"[5, 'block 2 (G first)']",0,0,0,0.0,5.0,-0.41666666666666663,0.38461538461538464,0.041666666666666664,0.5,0.25,4,0.5,0.75,Design 2,Design 2,"Have an option between Design #1 and Design #2,",5.0,1.0,3.0
2249,1227,5,Player object (1235),buy,2023-03-05 18:48:42.358954+00:00,"{""priceA"": 95, ""sharesA"": 1, ""secs_since_round_starts"": 122, ""market"": ""A""}",75.0,23.0,6.0,q5w3ghvj,vmu7c279,FULL STUDY,210.0,s3,1,95,105.0,-1,,1,sell,0,sell,0.5355078155027276,17,0,0,block 2 (G first),21.0,11.0,Male,1.0,0.0,0.0,"[5, 'block 2 (G first)']",0,0,0,0.0,5.0,-0.41666666666666663,0.38461538461538464,0.041666666666666664,0.5,0.25,4,0.5,0.75,Design 2,Design 2,"Have an option between Design #1 and Design #2,",5.0,1.0,3.0
2250,1228,5,Player object (1235),sell,2023-03-05 18:48:52.640149+00:00,"{""priceA"": 115, ""sharesA"": 0, ""secs_since_round_starts"": 133, ""market"": ""A""}",190.0,25.0,7.0,q5w3ghvj,vmu7c279,FULL STUDY,210.0,s3,1,115,95.0,1,20.0,1,buy,0,sell,0.5757035170695836,17,0,1,block 2 (G first),21.0,11.0,Male,1.0,0.0,0.0,"[5, 'block 2 (G first)']",0,0,0,0.0,5.0,-0.41666666666666663,0.38461538461538464,0.041666666666666664,0.5,0.25,4,0.5,0.75,Design 2,Design 2,"Have an option between Design #1 and Design #2,",5.0,1.0,3.0
2251,1229,5,Player object (1235),buy,2023-03-05 18:49:07.559613+00:00,"{""priceA"": 85, ""sharesA"": 1, ""secs_since_round_starts"": 148, ""market"": ""A""}",105.0,28.0,8.0,q5w3ghvj,vmu7c279,FULL STUDY,210.0,s3,1,85,115.0,-1,,1,sell,0,sell,0.4496194529460131,17,1,0,block 2 (G first),21.0,11.0,Male,1.0,0.0,0.0,"[5, 'block 2 (G first)']",0,0,0,0.0,5.0,-0.41666666666666663,0.38461538461538464,0.041666666666666664,0.5,0.25,4,0.5,0.75,Design 2,Design 2,"Have an option between Design #1 and Design #2,",5.0,1.0,3.0
2252,1231,5,Player object (1235),sell,2023-03-05 18:49:42.994828+00:00,"{""priceA"": 120, ""sharesA"": 0, ""secs_since_round_starts"": 183, ""market"": ""A""}",225.0,34.0,9.0,q5w3ghvj,vmu7c279,FULL STUDY,210.0,s3,1,120,85.0,1,35.0,1,buy,0,sell,0.5679672812132522,17,0,0,block 2 (G first),21.0,11.0,Male,1.0,0.0,0.0,"[5, 'block 2 (G first)']",0,0,0,0.0,5.0,-0.41666666666666663,0.38461538461538464,0.041666666666666664,0.5,0.25,4,0.5,0.75,Design 2,Design 2,"Have an option between Design #1 and Design #2,",5.0,1.0,3.0
2253,1232,5,Player object (1235),buy,2023-03-05 18:50:08.065790+00:00,"{""priceA"": 80, ""sharesA"": 1, ""secs_since_round_starts"": 208, ""market"": ""A""}",145.0,38.0,10.0,q5w3ghvj,vmu7c279,FULL STUDY,210.0,s3,1,80,120.0,-1,,1,sell,0,sell,0.4515999245786187,17,1,0,block 2 (G first),21.0,11.0,Male,1.0,0.0,0.0,"[5, 'block 2 (G first)']",0,0,0,0.0,5.0,-0.41666666666666663,0.38461538461538464,0.041666666666666664,0.5,0.25,4,0.5,0.75,Design 2,Design 2,"Have an option between Design #1 and Design #2,",5.0,1.0,3.0
2254,1233,5,Player object (1235),sell,2023-03-05 18:50:32.074004+00:00,"{""priceA"": 110, ""sharesA"": 0, ""secs_since_round_starts"": 232, ""market"": ""A""}",255.0,43.0,11.0,q5w3ghvj,vmu7c279,FULL STUDY,210.0,s3,1,110,80.0,1,30.0,1,buy,0,sell,0.571300234525265,17,0,0,block 2 (G first),21.0,11.0,Male,1.0,0.0,0.0,"[5, 'block 2 (G first)']",0,0,0,0.0,5.0,-0.41666666666666663,0.38461538461538464,0.041666666666666664,0.5,0.25,4,0.5,0.75,Design 2,Design 2,"Have an option between Design #1 and Design #2,",5.0,1.0,3.0
2255,1234,5,Player object (1235),buy,2023-03-05 18:50:43.405617+00:00,"{""priceA"": 110, ""sharesA"": 1, ""secs_since_round_starts"": 243, ""market"": ""A""}",145.0,45.0,12.0,q5w3ghvj,vmu7c279,FULL STUDY,210.0,s3,1,110,110.0,-1,,1,sell,0,sell,0.5454506058480159,17,0,0,block 2 (G first),21.0,11.0,Male,1.0,0.0,0.0,"[5, 'block 2 (G first)']",0,0,0,0.0,5.0,-0.41666666666666663,0.38461538461538464,0.041666666666666664,0.5,0.25,4,0.5,0.75,Design 2,Design 2,"Have an option between Design #1 and Design #2,",5.0,1.0,3.0
2256,3909,2,Player object (939),sell,2023-03-09 19:57:49.810429+00:00,"{""priceA"": 120, ""sharesA"": 0, ""secs_since_round_starts"": 90, ""market"": ""A""}",170.0,15.0,1.0,qzgbjdzz,vmu7c279,FULL STUDY,230.0,s2,1,120,,1,,1,,0,sell,0.5761373211134116,16,0,0,block 1 (G first),22.0,11.0,Male,1.0,0.0,0.0,"[2, 'block 1 (G first)']",1,0,0,0.5,6.0,-0.31666666666666665,0.46153846153846156,0.0,0.5,0.0,2,0.5,0.5,Design 1,Design 2,"Have an option between Design #1 and Design #2,",5.0,,
2257,3911,2,Player object (939),buy,2023-03-09 19:57:55.387307+00:00,"{""priceA"": 105, ""sharesA"": 1, ""secs_since_round_starts"": 96, ""market"": ""A""}",65.0,16.0,2.0,qzgbjdzz,vmu7c279,FULL STUDY,230.0,s2,1,105,120.0,-1,,1,sell,0,sell,0.5185790363913291,16,0,0,block 1 (G first),22.0,11.0,Male,1.0,0.0,0.0,"[2, 'block 1 (G first)']",1,0,0,0.5,6.0,-0.31666666666666665,0.46153846153846156,0.0,0.5,0.0,2,0.5,0.5,Design 1,Design 2,"Have an option between Design #1 and Design #2,",5.0,,
2258,3913,2,Player object (939),sell,2023-03-09 19:58:00.952001+00:00,"{""priceA"": 110, ""sharesA"": 0, ""secs_since_round_starts"": 101, ""market"": ""A""}",175.0,17.0,3.0,qzgbjdzz,vmu7c279,FULL STUDY,230.0,s2,1,110,105.0,1,5.0,1,buy,0,sell,0.5478276073026133,16,0,0,block 1 (G first),22.0,11.0,Male,1.0,0.0,0.0,"[2, 'block 1 (G first)']",1,0,0,0.5,6.0,-0.31666666666666665,0.46153846153846156,0.0,0.5,0.0,2,0.5,0.5,Design 1,Design 2,"Have an option between Design #1 and Design #2,",5.0,,
2259,3914,2,Player object (939),buy,2023-03-09 19:58:11.860738+00:00,"{""priceA"": 130, ""sharesA"": 1, ""secs_since_round_starts"": 112, ""market"": ""A""}",45.0,19.0,4.0,qzgbjdzz,vmu7c279,FULL STUDY,230.0,s2,1,130,110.0,-1,,1,sell,0,sell,0.5813773703663461,16,0,1,block 1 (G first),22.0,11.0,Male,1.0,0.0,0.0,"[2, 'block 1 (G first)']",1,0,0,0.5,6.0,-0.31666666666666665,0.46153846153846156,0.0,0.5,0.0,2,0.5,0.5,Design 1,Design 2,"Have an option between Design #1 and Design #2,",5.0,,
2260,3916,2,Player object (939),sell,2023-03-09 19:58:28.271782+00:00,"{""priceA"": 140, ""sharesA"": 0, ""secs_since_round_starts"": 129, ""market"": ""A""}",185.0,22.0,5.0,qzgbjdzz,vmu7c279,FULL STUDY,230.0,s2,1,140,130.0,1,10.0,1,buy,0,sell,0.5695815034421478,16,0,0,block 1 (G first),22.0,11.0,Male,1.0,0.0,0.0,"[2, 'block 1 (G first)']",1,0,0,0.5,6.0,-0.31666666666666665,0.46153846153846156,0.0,0.5,0.0,2,0.5,0.5,Design 1,Design 2,"Have an option between Design #1 and Design #2,",5.0,,
2261,3919,2,Player object (939),buy,2023-03-09 19:59:01.035284+00:00,"{""priceA"": 120, ""sharesA"": 1, ""secs_since_round_starts"": 162, ""market"": ""A""}",65.0,28.0,6.0,qzgbjdzz,vmu7c279,FULL STUDY,230.0,s2,1,120,140.0,-1,,1,sell,0,sell,0.4340892272841542,16,0,0,block 1 (G first),22.0,11.0,Male,1.0,0.0,0.0,"[2, 'block 1 (G first)']",1,0,0,0.5,6.0,-0.31666666666666665,0.46153846153846156,0.0,0.5,0.0,2,0.5,0.5,Design 1,Design 2,"Have an option between Design #1 and Design #2,",5.0,,
2262,3920,2,Player object (939),sell,2023-03-09 19:59:12.381284+00:00,"{""priceA"": 125, ""sharesA"": 0, ""secs_since_round_starts"": 173, ""market"": ""A""}",190.0,30.0,7.0,qzgbjdzz,vmu7c279,FULL STUDY,230.0,s2,1,125,120.0,1,5.0,1,buy,0,sell,0.4785999259850118,16,0,0,block 1 (G first),22.0,11.0,Male,1.0,0.0,0.0,"[2, 'block 1 (G first)']",1,0,0,0.5,6.0,-0.31666666666666665,0.46153846153846156,0.0,0.5,0.0,2,0.5,0.5,Design 1,Design 2,"Have an option between Design #1 and Design #2,",5.0,,
2263,3926,2,Player object (939),buy,2023-03-09 20:00:17.096797+00:00,"{""priceA"": 125, ""sharesA"": 1, ""secs_since_round_starts"": 238, ""market"": ""A""}",65.0,39.0,8.0,qzgbjdzz,vmu7c279,FULL STUDY,230.0,s2,1,125,125.0,-1,,1,sell,0,sell,0.4382592777609274,16,1,0,block 1 (G first),22.0,11.0,Male,1.0,0.0,0.0,"[2, 'block 1 (G first)']",1,0,0,0.5,6.0,-0.31666666666666665,0.46153846153846156,0.0,0.5,0.0,2,0.5,0.5,Design 1,Design 2,"Have an option between Design #1 and Design #2,",5.0,,
2264,3927,2,Player object (939),sell,2023-03-09 20:00:23.376826+00:00,"{""priceA"": 140, ""sharesA"": 0, ""secs_since_round_starts"": 244, ""market"": ""A""}",205.0,40.0,9.0,qzgbjdzz,vmu7c279,FULL STUDY,230.0,s2,1,140,125.0,1,15.0,1,buy,0,sell,0.4916787423410894,16,0,0,block 1 (G first),22.0,11.0,Male,1.0,0.0,0.0,"[2, 'block 1 (G first)']",1,0,0,0.5,6.0,-0.31666666666666665,0.46153846153846156,0.0,0.5,0.0,2,0.5,0.5,Design 1,Design 2,"Have an option between Design #1 and Design #2,",5.0,,
2265,3930,2,Player object (939),buy,2023-03-09 20:00:44.915631+00:00,"{""priceA"": 130, ""sharesA"": 1, ""secs_since_round_starts"": 265, ""market"": ""A""}",75.0,44.0,10.0,qzgbjdzz,vmu7c279,FULL STUDY,230.0,s2,1,130,140.0,-1,,1,sell,0,sell,0.4799987600827208,16,0,0,block 1 (G first),22.0,11.0,Male,1.0,0.0,0.0,"[2, 'block 1 (G first)']",1,0,0,0.5,6.0,-0.31666666666666665,0.46153846153846156,0.0,0.5,0.0,2,0.5,0.5,Design 1,Design 2,"Have an option between Design #1 and Design #2,",5.0,,
2266,3932,2,Player object (939),sell,2023-03-09 20:00:55.902895+00:00,"{""priceA"": 155, ""sharesA"": 0, ""secs_since_round_starts"": 276, ""market"": ""A""}",230.0,46.0,11.0,qzgbjdzz,vmu7c279,FULL STUDY,230.0,s2,1,155,130.0,1,25.0,1,buy,0,sell,0.5495494947508355,16,0,1,block 1 (G first),22.0,11.0,Male,1.0,0.0,0.0,"[2, 'block 1 (G first)']",1,0,0,0.5,6.0,-0.31666666666666665,0.46153846153846156,0.0,0.5,0.0,2,0.5,0.5,Design 1,Design 2,"Have an option between Design #1 and Design #2,",5.0,,
2267,3935,2,Player object (939),buy,2023-03-09 20:01:32.907466+00:00,"{""priceA"": 125, ""sharesA"": 1, ""secs_since_round_starts"": 313, ""market"": ""A""}",105.0,52.0,12.0,qzgbjdzz,vmu7c279,FULL STUDY,230.0,s2,1,125,155.0,-1,,1,sell,0,sell,0.4439176376077041,16,1,0,block 1 (G first),22.0,11.0,Male,1.0,0.0,0.0,"[2, 'block 1 (G first)']",1,0,0,0.5,6.0,-0.31666666666666665,0.46153846153846156,0.0,0.5,0.0,2,0.5,0.5,Design 1,Design 2,"Have an option between Design #1 and Design #2,",5.0,,
2268,3937,2,Player object (939),sell,2023-03-09 20:02:12.554745+00:00,"{""priceA"": 125, ""sharesA"": 0, ""secs_since_round_starts"": 353, ""market"": ""A""}",230.0,60.0,13.0,qzgbjdzz,vmu7c279,FULL STUDY,230.0,s2,1,125,125.0,1,0.0,1,buy,0,sell,0.5540089061739091,16,0,1,block 1 (G first),22.0,11.0,Male,1.0,0.0,0.0,"[2, 'block 1 (G first)']",1,0,0,0.5,6.0,-0.31666666666666665,0.46153846153846156,0.0,0.5,0.0,2,0.5,0.5,Design 1,Design 2,"Have an option between Design #1 and Design #2,",5.0,,
2269,3943,3,Player object (1059),sell,2023-03-09 20:03:37.737570+00:00,"{""priceA"": 110, ""sharesA"": 0, ""secs_since_round_starts"": 72, ""market"": ""A""}",160.0,11.0,1.0,qzgbjdzz,vmu7c279,FULL STUDY,230.0,s2,1,110,,1,,1,,0,sell,0.5295922419004607,19,0,0,block 1 (G first),22.0,11.0,Male,1.0,0.0,0.0,"[3, 'block 1 (G first)']",1,1,0,0.5,6.0,-0.31666666666666665,0.3125,0.0,1.0,0.0,2,0.5,1.0,Design 1,Design 2,"Have an option between Design #1 and Design #2,",5.0,,
2270,3946,3,Player object (1059),buy,2023-03-09 20:04:09.310727+00:00,"{""priceA"": 100, ""sharesA"": 1, ""secs_since_round_starts"": 103, ""market"": ""A""}",60.0,16.0,2.0,qzgbjdzz,vmu7c279,FULL STUDY,230.0,s2,1,100,110.0,-1,,1,sell,0,sell,0.4486815727575955,19,1,0,block 1 (G first),22.0,11.0,Male,1.0,0.0,0.0,"[3, 'block 1 (G first)']",1,1,0,0.5,6.0,-0.31666666666666665,0.3125,0.0,1.0,0.0,2,0.5,1.0,Design 1,Design 2,"Have an option between Design #1 and Design #2,",5.0,,
2271,3948,3,Player object (1059),sell,2023-03-09 20:04:22.628917+00:00,"{""priceA"": 120, ""sharesA"": 0, ""secs_since_round_starts"": 117, ""market"": ""A""}",180.0,19.0,3.0,qzgbjdzz,vmu7c279,FULL STUDY,230.0,s2,1,120,100.0,1,20.0,1,buy,0,sell,0.5586446427659006,19,0,1,block 1 (G first),22.0,11.0,Male,1.0,0.0,0.0,"[3, 'block 1 (G first)']",1,1,0,0.5,6.0,-0.31666666666666665,0.3125,0.0,1.0,0.0,2,0.5,1.0,Design 1,Design 2,"Have an option between Design #1 and Design #2,",5.0,,
2272,3949,3,Player object (1059),buy,2023-03-09 20:04:33.526041+00:00,"{""priceA"": 100, ""sharesA"": 1, ""secs_since_round_starts"": 127, ""market"": ""A""}",80.0,21.0,4.0,qzgbjdzz,vmu7c279,FULL STUDY,230.0,s2,1,100,120.0,-1,,1,sell,0,sell,0.4692484881524699,19,0,0,block 1 (G first),22.0,11.0,Male,1.0,0.0,0.0,"[3, 'block 1 (G first)']",1,1,0,0.5,6.0,-0.31666666666666665,0.3125,0.0,1.0,0.0,2,0.5,1.0,Design 1,Design 2,"Have an option between Design #1 and Design #2,",5.0,,
2273,3953,3,Player object (1059),sell,2023-03-09 20:05:18.234557+00:00,"{""priceA"": 115, ""sharesA"": 0, ""secs_since_round_starts"": 172, ""market"": ""A""}",195.0,29.0,5.0,qzgbjdzz,vmu7c279,FULL STUDY,230.0,s2,1,115,100.0,1,15.0,1,buy,0,sell,0.5511004178331719,19,0,0,block 1 (G first),22.0,11.0,Male,1.0,0.0,0.0,"[3, 'block 1 (G first)']",1,1,0,0.5,6.0,-0.31666666666666665,0.3125,0.0,1.0,0.0,2,0.5,1.0,Design 1,Design 2,"Have an option between Design #1 and Design #2,",5.0,,
2274,3958,3,Player object (1059),buy,2023-03-09 20:06:03.873635+00:00,"{""priceA"": 100, ""sharesA"": 1, ""secs_since_round_starts"": 218, ""market"": ""A""}",95.0,36.0,6.0,qzgbjdzz,vmu7c279,FULL STUDY,230.0,s2,1,100,115.0,-1,,1,sell,0,sell,0.440139794868048,19,0,0,block 1 (G first),22.0,11.0,Male,1.0,0.0,0.0,"[3, 'block 1 (G first)']",1,1,0,0.5,6.0,-0.31666666666666665,0.3125,0.0,1.0,0.0,2,0.5,1.0,Design 1,Design 2,"Have an option between Design #1 and Design #2,",5.0,,
2275,3960,3,Player object (1059),sell,2023-03-09 20:06:42.676541+00:00,"{""priceA"": 120, ""sharesA"": 0, ""secs_since_round_starts"": 257, ""market"": ""A""}",215.0,43.0,7.0,qzgbjdzz,vmu7c279,FULL STUDY,230.0,s2,1,120,100.0,1,20.0,1,buy,0,sell,0.5357259670782416,19,0,0,block 1 (G first),22.0,11.0,Male,1.0,0.0,0.0,"[3, 'block 1 (G first)']",1,1,0,0.5,6.0,-0.31666666666666665,0.3125,0.0,1.0,0.0,2,0.5,1.0,Design 1,Design 2,"Have an option between Design #1 and Design #2,",5.0,,
2276,3963,3,Player object (1059),buy,2023-03-09 20:07:31.905946+00:00,"{""priceA"": 115, ""sharesA"": 1, ""secs_since_round_starts"": 306, ""market"": ""A""}",100.0,52.0,8.0,qzgbjdzz,vmu7c279,FULL STUDY,230.0,s2,1,115,120.0,-1,,1,sell,0,sell,0.4367228334197354,19,0,0,block 1 (G first),22.0,11.0,Male,1.0,0.0,0.0,"[3, 'block 1 (G first)']",1,1,0,0.5,6.0,-0.31666666666666665,0.3125,0.0,1.0,0.0,2,0.5,1.0,Design 1,Design 2,"Have an option between Design #1 and Design #2,",5.0,,
2277,3965,3,Player object (1059),sell,2023-03-09 20:07:37.906377+00:00,"{""priceA"": 130, ""sharesA"": 0, ""secs_since_round_starts"": 312, ""market"": ""A""}",230.0,53.0,9.0,qzgbjdzz,vmu7c279,FULL STUDY,230.0,s2,1,130,115.0,1,15.0,1,buy,0,sell,0.4905868559773416,19,0,0,block 1 (G first),22.0,11.0,Male,1.0,0.0,0.0,"[3, 'block 1 (G first)']",1,1,0,0.5,6.0,-0.31666666666666665,0.3125,0.0,1.0,0.0,2,0.5,1.0,Design 1,Design 2,"Have an option between Design #1 and Design #2,",5.0,,
2278,3968,3,Player object (1059),buy,2023-03-09 20:08:09.095396+00:00,"{""priceA"": 115, ""sharesA"": 1, ""secs_since_round_starts"": 343, ""market"": ""A""}",115.0,58.0,10.0,qzgbjdzz,vmu7c279,FULL STUDY,230.0,s2,1,115,130.0,-1,,1,sell,0,sell,0.442461876115205,19,1,0,block 1 (G first),22.0,11.0,Male,1.0,0.0,0.0,"[3, 'block 1 (G first)']",1,1,0,0.5,6.0,-0.31666666666666665,0.3125,0.0,1.0,0.0,2,0.5,1.0,Design 1,Design 2,"Have an option between Design #1 and Design #2,",5.0,,
2279,3974,4,Player object (1179),sell,2023-03-09 20:09:04.695300+00:00,"{""priceA"": 40, ""sharesA"": 0, ""secs_since_round_starts"": 37, ""market"": ""A""}",90.0,6.0,1.0,qzgbjdzz,vmu7c279,FULL STUDY,130.0,s2,1,40,,1,,1,,0,sell,0.4060600996068529,14,0,0,block 1 (G first),22.0,11.0,Male,1.0,0.0,0.0,"[4, 'block 1 (G first)']",0,0,0,0.5,6.0,-0.31666666666666665,0.1111111111111111,0.125,0.3333333333333333,0.0,2,1.0,0.75,Design 1,Design 2,"Have an option between Design #1 and Design #2,",5.0,,
2280,3975,4,Player object (1179),buy,2023-03-09 20:09:10.473647+00:00,"{""priceA"": 55, ""sharesA"": 1, ""secs_since_round_starts"": 43, ""market"": ""A""}",35.0,8.0,2.0,qzgbjdzz,vmu7c279,FULL STUDY,130.0,s2,1,55,40.0,-1,,1,sell,0,sell,0.5131395645435063,14,0,0,block 1 (G first),22.0,11.0,Male,1.0,0.0,0.0,"[4, 'block 1 (G first)']",0,0,0,0.5,6.0,-0.31666666666666665,0.1111111111111111,0.125,0.3333333333333333,0.0,2,1.0,0.75,Design 1,Design 2,"Have an option between Design #1 and Design #2,",5.0,,
2281,3983,4,Player object (1179),sell,2023-03-09 20:11:04.780914+00:00,"{""priceA"": 80, ""sharesA"": 0, ""secs_since_round_starts"": 158, ""market"": ""A""}",115.0,28.0,3.0,qzgbjdzz,vmu7c279,FULL STUDY,130.0,s2,1,80,55.0,1,25.0,1,buy,0,sell,0.5529051331090981,14,0,1,block 1 (G first),22.0,11.0,Male,1.0,0.0,0.0,"[4, 'block 1 (G first)']",0,0,0,0.5,6.0,-0.31666666666666665,0.1111111111111111,0.125,0.3333333333333333,0.0,2,1.0,0.75,Design 1,Design 2,"Have an option between Design #1 and Design #2,",5.0,,
2282,3985,4,Player object (1179),buy,2023-03-09 20:12:02.165492+00:00,"{""priceA"": 65, ""sharesA"": 1, ""secs_since_round_starts"": 215, ""market"": ""A""}",50.0,38.0,4.0,qzgbjdzz,vmu7c279,FULL STUDY,130.0,s2,1,65,80.0,-1,,1,sell,0,sell,0.4355009867455686,14,1,0,block 1 (G first),22.0,11.0,Male,1.0,0.0,0.0,"[4, 'block 1 (G first)']",0,0,0,0.5,6.0,-0.31666666666666665,0.1111111111111111,0.125,0.3333333333333333,0.0,2,1.0,0.75,Design 1,Design 2,"Have an option between Design #1 and Design #2,",5.0,,
2283,3987,4,Player object (1179),sell,2023-03-09 20:12:08.167769+00:00,"{""priceA"": 80, ""sharesA"": 0, ""secs_since_round_starts"": 221, ""market"": ""A""}",130.0,39.0,5.0,qzgbjdzz,vmu7c279,FULL STUDY,130.0,s2,1,80,65.0,1,15.0,1,buy,0,sell,0.4897180556691627,14,0,0,block 1 (G first),22.0,11.0,Male,1.0,0.0,0.0,"[4, 'block 1 (G first)']",0,0,0,0.5,6.0,-0.31666666666666665,0.1111111111111111,0.125,0.3333333333333333,0.0,2,1.0,0.75,Design 1,Design 2,"Have an option between Design #1 and Design #2,",5.0,,
2284,3995,4,Player object (1179),buy,2023-03-09 20:13:24.114286+00:00,"{""priceA"": 75, ""sharesA"": 1, ""secs_since_round_starts"": 297, ""market"": ""A""}",55.0,53.0,6.0,qzgbjdzz,vmu7c279,FULL STUDY,130.0,s2,1,75,80.0,-1,,1,sell,0,sell,0.4439854633835125,14,1,0,block 1 (G first),22.0,11.0,Male,1.0,0.0,0.0,"[4, 'block 1 (G first)']",0,0,0,0.5,6.0,-0.31666666666666665,0.1111111111111111,0.125,0.3333333333333333,0.0,2,1.0,0.75,Design 1,Design 2,"Have an option between Design #1 and Design #2,",5.0,,
2285,4002,5,Player object (1299),sell,2023-03-09 20:14:45.979935+00:00,"{""priceA"": 100, ""sharesA"": 0, ""secs_since_round_starts"": 34, ""market"": ""A""}",150.0,7.0,1.0,qzgbjdzz,vmu7c279,FULL STUDY,195.0,s2,1,100,,1,,1,,0,sell,0.5733994727268583,17,0,0,block 1 (G first),22.0,11.0,Male,1.0,0.0,0.0,"[5, 'block 1 (G first)']",0,1,0,0.5,6.0,-0.31666666666666665,0.13043478260869565,0.0,0.25,0.0,5,0.25,1.0,Design 1,Design 2,"Have an option between Design #1 and Design #2,",5.0,,
2286,4003,5,Player object (1299),buy,2023-03-09 20:14:49.057069+00:00,"{""priceA"": 90, ""sharesA"": 1, ""secs_since_round_starts"": 37, ""market"": ""A""}",60.0,8.0,2.0,qzgbjdzz,vmu7c279,FULL STUDY,195.0,s2,1,90,100.0,-1,,1,sell,0,sell,0.5166236645513725,17,0,0,block 1 (G first),22.0,11.0,Male,1.0,0.0,0.0,"[5, 'block 1 (G first)']",0,1,0,0.5,6.0,-0.31666666666666665,0.13043478260869565,0.0,0.25,0.0,5,0.25,1.0,Design 1,Design 2,"Have an option between Design #1 and Design #2,",5.0,,
2287,4010,5,Player object (1299),sell,2023-03-09 20:16:23.025186+00:00,"{""priceA"": 115, ""sharesA"": 0, ""secs_since_round_starts"": 131, ""market"": ""A""}",175.0,25.0,3.0,qzgbjdzz,vmu7c279,FULL STUDY,195.0,s2,1,115,90.0,1,25.0,1,buy,0,sell,0.5757035170695836,17,0,1,block 1 (G first),22.0,11.0,Male,1.0,0.0,0.0,"[5, 'block 1 (G first)']",0,1,0,0.5,6.0,-0.31666666666666665,0.13043478260869565,0.0,0.25,0.0,5,0.25,1.0,Design 1,Design 2,"Have an option between Design #1 and Design #2,",5.0,,
2288,4012,5,Player object (1299),buy,2023-03-09 20:16:37.850133+00:00,"{""priceA"": 100, ""sharesA"": 1, ""secs_since_round_starts"": 146, ""market"": ""A""}",75.0,27.0,4.0,qzgbjdzz,vmu7c279,FULL STUDY,195.0,s2,1,100,115.0,-1,,1,sell,0,sell,0.4777068930880888,17,0,0,block 1 (G first),22.0,11.0,Male,1.0,0.0,0.0,"[5, 'block 1 (G first)']",0,1,0,0.5,6.0,-0.31666666666666665,0.13043478260869565,0.0,0.25,0.0,5,0.25,1.0,Design 1,Design 2,"Have an option between Design #1 and Design #2,",5.0,,
2289,4018,5,Player object (1299),sell,2023-03-09 20:17:14.774291+00:00,"{""priceA"": 120, ""sharesA"": 0, ""secs_since_round_starts"": 183, ""market"": ""A""}",195.0,34.0,5.0,qzgbjdzz,vmu7c279,FULL STUDY,195.0,s2,1,120,100.0,1,20.0,1,buy,0,sell,0.5679672812132522,17,0,0,block 1 (G first),22.0,11.0,Male,1.0,0.0,0.0,"[5, 'block 1 (G first)']",0,1,0,0.5,6.0,-0.31666666666666665,0.13043478260869565,0.0,0.25,0.0,5,0.25,1.0,Design 1,Design 2,"Have an option between Design #1 and Design #2,",5.0,,
2290,4019,5,Player object (1299),buy,2023-03-09 20:17:36.815622+00:00,"{""priceA"": 80, ""sharesA"": 1, ""secs_since_round_starts"": 205, ""market"": ""A""}",115.0,38.0,6.0,qzgbjdzz,vmu7c279,FULL STUDY,195.0,s2,1,80,120.0,-1,,1,sell,0,sell,0.4515999245786187,17,1,0,block 1 (G first),22.0,11.0,Male,1.0,0.0,0.0,"[5, 'block 1 (G first)']",0,1,0,0.5,6.0,-0.31666666666666665,0.13043478260869565,0.0,0.25,0.0,5,0.25,1.0,Design 1,Design 2,"Have an option between Design #1 and Design #2,",5.0,,
2291,4023,5,Player object (1299),sell,2023-03-09 20:18:27.910635+00:00,"{""priceA"": 90, ""sharesA"": 0, ""secs_since_round_starts"": 256, ""market"": ""A""}",205.0,47.0,7.0,qzgbjdzz,vmu7c279,FULL STUDY,195.0,s2,1,90,80.0,1,10.0,1,buy,0,sell,0.4627742743797309,17,0,0,block 1 (G first),22.0,11.0,Male,1.0,0.0,0.0,"[5, 'block 1 (G first)']",0,1,0,0.5,6.0,-0.31666666666666665,0.13043478260869565,0.0,0.25,0.0,5,0.25,1.0,Design 1,Design 2,"Have an option between Design #1 and Design #2,",5.0,,
2292,4024,5,Player object (1299),buy,2023-03-09 20:18:34.015831+00:00,"{""priceA"": 75, ""sharesA"": 1, ""secs_since_round_starts"": 262, ""market"": ""A""}",130.0,48.0,8.0,qzgbjdzz,vmu7c279,FULL STUDY,195.0,s2,1,75,90.0,-1,,1,sell,0,sell,0.4393932183506925,17,1,0,block 1 (G first),22.0,11.0,Male,1.0,0.0,0.0,"[5, 'block 1 (G first)']",0,1,0,0.5,6.0,-0.31666666666666665,0.13043478260869565,0.0,0.25,0.0,5,0.25,1.0,Design 1,Design 2,"Have an option between Design #1 and Design #2,",5.0,,
2293,5215,2,Player object (1522),sell,2023-03-10 13:17:14.968331+00:00,"{""priceA"": 120, ""sharesA"": 0, ""secs_since_round_starts"": 116, ""market"": ""A""}",170.0,15.0,1.0,r6br4dt3,t7od4xlw,FULL STUDY,195.0,s2,1,120,,1,,1,,0,sell,0.5761373211134116,16,0,0,block 4 (G second),26.0,12.0,Male,0.0,1.0,1.0,"[2, 'block 4 (G second)']",0,1,1,0.0,7.0,-0.30000000000000004,0.18181818181818182,0.0,0.0,0.0,4,1.0,1.0,Design 1,Design 1,"Have an option between Design #1 and Design #2,",2.0,,
2294,5218,2,Player object (1522),buy,2023-03-10 13:18:09.757177+00:00,"{""priceA"": 145, ""sharesA"": 1, ""secs_since_round_starts"": 171, ""market"": ""A""}",25.0,25.0,2.0,r6br4dt3,t7od4xlw,FULL STUDY,195.0,s2,1,145,120.0,-1,,1,sell,0,sell,0.5294358264188312,16,0,0,block 4 (G second),26.0,12.0,Male,0.0,1.0,1.0,"[2, 'block 4 (G second)']",0,1,1,0.0,7.0,-0.30000000000000004,0.18181818181818182,0.0,0.0,0.0,4,1.0,1.0,Design 1,Design 1,"Have an option between Design #1 and Design #2,",2.0,,
2295,5225,2,Player object (1522),sell,2023-03-10 13:20:25.619576+00:00,"{""priceA"": 170, ""sharesA"": 0, ""secs_since_round_starts"": 306, ""market"": ""A""}",195.0,49.0,3.0,r6br4dt3,t7od4xlw,FULL STUDY,195.0,s2,1,170,145.0,1,25.0,1,buy,0,sell,0.5589355340840079,16,0,0,block 4 (G second),26.0,12.0,Male,0.0,1.0,1.0,"[2, 'block 4 (G second)']",0,1,1,0.0,7.0,-0.30000000000000004,0.18181818181818182,0.0,0.0,0.0,4,1.0,1.0,Design 1,Design 1,"Have an option between Design #1 and Design #2,",2.0,,
2296,5227,2,Player object (1522),buy,2023-03-10 13:20:42.761335+00:00,"{""priceA"": 125, ""sharesA"": 1, ""secs_since_round_starts"": 324, ""market"": ""A""}",70.0,52.0,4.0,r6br4dt3,t7od4xlw,FULL STUDY,195.0,s2,1,125,170.0,-1,,1,sell,0,sell,0.4439176376077041,16,1,0,block 4 (G second),26.0,12.0,Male,0.0,1.0,1.0,"[2, 'block 4 (G second)']",0,1,1,0.0,7.0,-0.30000000000000004,0.18181818181818182,0.0,0.0,0.0,4,1.0,1.0,Design 1,Design 1,"Have an option between Design #1 and Design #2,",2.0,,
2297,5241,3,Player object (1702),sell,2023-03-10 13:22:48.640025+00:00,"{""priceA"": 130, ""sharesA"": 0, ""secs_since_round_starts"": 73, ""market"": ""A""}",180.0,13.0,2.0,r6br4dt3,t7od4xlw,FULL STUDY,235.0,s2,1,130,95.0,1,35.0,1,,0,sell,0.5729625045047859,19,0,1,block 4 (G second),26.0,12.0,Male,0.0,1.0,1.0,"[3, 'block 4 (G second)']",0,0,1,0.0,7.0,-0.30000000000000004,0.2777777777777778,0.0,0.5,0.0,2,0.5,0.5,Design 1,Design 1,"Have an option between Design #1 and Design #2,",2.0,,
2298,5243,3,Player object (1702),buy,2023-03-10 13:23:10.194135+00:00,"{""priceA"": 105, ""sharesA"": 1, ""secs_since_round_starts"": 95, ""market"": ""A""}",75.0,17.0,3.0,r6br4dt3,t7od4xlw,FULL STUDY,235.0,s2,1,105,130.0,-1,,1,sell,0,sell,0.4990675303551922,19,0,0,block 4 (G second),26.0,12.0,Male,0.0,1.0,1.0,"[3, 'block 4 (G second)']",0,0,1,0.0,7.0,-0.30000000000000004,0.2777777777777778,0.0,0.5,0.0,2,0.5,0.5,Design 1,Design 1,"Have an option between Design #1 and Design #2,",2.0,,
2299,5244,3,Player object (1702),sell,2023-03-10 13:23:58.288437+00:00,"{""priceA"": 115, ""sharesA"": 0, ""secs_since_round_starts"": 143, ""market"": ""A""}",190.0,26.0,4.0,r6br4dt3,t7od4xlw,FULL STUDY,235.0,s2,1,115,105.0,1,10.0,1,buy,0,sell,0.526172546586359,19,0,0,block 4 (G second),26.0,12.0,Male,0.0,1.0,1.0,"[3, 'block 4 (G second)']",0,0,1,0.0,7.0,-0.30000000000000004,0.2777777777777778,0.0,0.5,0.0,2,0.5,0.5,Design 1,Design 1,"Have an option between Design #1 and Design #2,",2.0,,
2300,5248,3,Player object (1702),buy,2023-03-10 13:24:49.548373+00:00,"{""priceA"": 110, ""sharesA"": 1, ""secs_since_round_starts"": 194, ""market"": ""A""}",80.0,34.0,5.0,r6br4dt3,t7od4xlw,FULL STUDY,235.0,s2,1,110,115.0,-1,,1,sell,0,sell,0.4983651933170437,19,0,0,block 4 (G second),26.0,12.0,Male,0.0,1.0,1.0,"[3, 'block 4 (G second)']",0,0,1,0.0,7.0,-0.30000000000000004,0.2777777777777778,0.0,0.5,0.0,2,0.5,0.5,Design 1,Design 1,"Have an option between Design #1 and Design #2,",2.0,,
2301,5251,3,Player object (1702),sell,2023-03-10 13:25:16.814988+00:00,"{""priceA"": 115, ""sharesA"": 0, ""secs_since_round_starts"": 222, ""market"": ""A""}",195.0,39.0,6.0,r6br4dt3,t7od4xlw,FULL STUDY,235.0,s2,1,115,110.0,1,5.0,1,buy,0,sell,0.5221490272476892,19,0,0,block 4 (G second),26.0,12.0,Male,0.0,1.0,1.0,"[3, 'block 4 (G second)']",0,0,1,0.0,7.0,-0.30000000000000004,0.2777777777777778,0.0,0.5,0.0,2,0.5,0.5,Design 1,Design 1,"Have an option between Design #1 and Design #2,",2.0,,
2302,5252,3,Player object (1702),buy,2023-03-10 13:25:21.052082+00:00,"{""priceA"": 100, ""sharesA"": 1, ""secs_since_round_starts"": 226, ""market"": ""A""}",95.0,40.0,7.0,r6br4dt3,t7od4xlw,FULL STUDY,235.0,s2,1,100,115.0,-1,,1,sell,0,sell,0.4804175727303482,19,0,0,block 4 (G second),26.0,12.0,Male,0.0,1.0,1.0,"[3, 'block 4 (G second)']",0,0,1,0.0,7.0,-0.30000000000000004,0.2777777777777778,0.0,0.5,0.0,2,0.5,0.5,Design 1,Design 1,"Have an option between Design #1 and Design #2,",2.0,,
2303,5253,3,Player object (1702),sell,2023-03-10 13:25:38.352669+00:00,"{""priceA"": 120, ""sharesA"": 0, ""secs_since_round_starts"": 243, ""market"": ""A""}",215.0,43.0,8.0,r6br4dt3,t7od4xlw,FULL STUDY,235.0,s2,1,120,100.0,1,20.0,1,buy,0,sell,0.5357259670782416,19,0,0,block 4 (G second),26.0,12.0,Male,0.0,1.0,1.0,"[3, 'block 4 (G second)']",0,0,1,0.0,7.0,-0.30000000000000004,0.2777777777777778,0.0,0.5,0.0,2,0.5,0.5,Design 1,Design 1,"Have an option between Design #1 and Design #2,",2.0,,
2304,5254,3,Player object (1702),buy,2023-03-10 13:26:10.319198+00:00,"{""priceA"": 110, ""sharesA"": 1, ""secs_since_round_starts"": 275, ""market"": ""A""}",105.0,49.0,9.0,r6br4dt3,t7od4xlw,FULL STUDY,235.0,s2,1,110,120.0,-1,,1,sell,0,sell,0.4374794566672981,19,1,0,block 4 (G second),26.0,12.0,Male,0.0,1.0,1.0,"[3, 'block 4 (G second)']",0,0,1,0.0,7.0,-0.30000000000000004,0.2777777777777778,0.0,0.5,0.0,2,0.5,0.5,Design 1,Design 1,"Have an option between Design #1 and Design #2,",2.0,,
2305,5256,3,Player object (1702),sell,2023-03-10 13:26:32.213754+00:00,"{""priceA"": 130, ""sharesA"": 0, ""secs_since_round_starts"": 297, ""market"": ""A""}",235.0,53.0,10.0,r6br4dt3,t7od4xlw,FULL STUDY,235.0,s2,1,130,110.0,1,20.0,1,buy,0,sell,0.4905868559773416,19,0,0,block 4 (G second),26.0,12.0,Male,0.0,1.0,1.0,"[3, 'block 4 (G second)']",0,0,1,0.0,7.0,-0.30000000000000004,0.2777777777777778,0.0,0.5,0.0,2,0.5,0.5,Design 1,Design 1,"Have an option between Design #1 and Design #2,",2.0,,
2306,5258,3,Player object (1702),buy,2023-03-10 13:27:01.315026+00:00,"{""priceA"": 115, ""sharesA"": 1, ""secs_since_round_starts"": 326, ""market"": ""A""}",120.0,58.0,11.0,r6br4dt3,t7od4xlw,FULL STUDY,235.0,s2,1,115,130.0,-1,,1,sell,0,sell,0.442461876115205,19,1,0,block 4 (G second),26.0,12.0,Male,0.0,1.0,1.0,"[3, 'block 4 (G second)']",0,0,1,0.0,7.0,-0.30000000000000004,0.2777777777777778,0.0,0.5,0.0,2,0.5,0.5,Design 1,Design 1,"Have an option between Design #1 and Design #2,",2.0,,
2307,5271,4,Player object (1882),sell,2023-03-10 13:31:10.906612+00:00,"{""priceA"": 100, ""sharesA"": 0, ""secs_since_round_starts"": 232, ""market"": ""A""}",150.0,43.0,1.0,r6br4dt3,t7od4xlw,FULL STUDY,135.0,s2,1,100,,1,,1,,0,sell,0.5617190733230237,14,0,1,block 4 (G second),26.0,12.0,Male,0.0,1.0,1.0,"[4, 'block 4 (G second)']",1,1,1,0.5,7.0,-0.30000000000000004,,0.0,,0.0,2,1.0,0.75,Design 1,Design 1,"Have an option between Design #1 and Design #2,",2.0,,
2308,5274,4,Player object (1882),buy,2023-03-10 13:32:00.412398+00:00,"{""priceA"": 90, ""sharesA"": 1, ""secs_since_round_starts"": 281, ""market"": ""A""}",60.0,52.0,2.0,r6br4dt3,t7od4xlw,FULL STUDY,135.0,s2,1,90,100.0,-1,,1,sell,0,sell,0.4694909620846048,14,0,0,block 4 (G second),26.0,12.0,Male,0.0,1.0,1.0,"[4, 'block 4 (G second)']",1,1,1,0.5,7.0,-0.30000000000000004,,0.0,,0.0,2,1.0,0.75,Design 1,Design 1,"Have an option between Design #1 and Design #2,",2.0,,
2309,5291,5,Player object (2062),sell,2023-03-10 13:33:28.916390+00:00,"{""priceA"": 90, ""sharesA"": 0, ""secs_since_round_starts"": 40, ""market"": ""A""}",140.0,8.0,1.0,r6br4dt3,t7od4xlw,FULL STUDY,195.0,s2,1,90,,1,,1,,0,sell,0.5166236645513725,17,0,0,block 4 (G second),26.0,12.0,Male,0.0,1.0,1.0,"[5, 'block 4 (G second)']",1,0,1,0.0,7.0,-0.30000000000000004,0.3333333333333333,0.05,0.5,0.0,4,0.5,1.0,Design 1,Design 1,"Have an option between Design #1 and Design #2,",2.0,,
2310,5292,5,Player object (2062),buy,2023-03-10 13:33:39.125250+00:00,"{""priceA"": 75, ""sharesA"": 1, ""secs_since_round_starts"": 50, ""market"": ""A""}",65.0,10.0,2.0,r6br4dt3,t7od4xlw,FULL STUDY,195.0,s2,1,75,90.0,-1,,1,sell,0,sell,0.4488309348307913,17,1,0,block 4 (G second),26.0,12.0,Male,0.0,1.0,1.0,"[5, 'block 4 (G second)']",1,0,1,0.0,7.0,-0.30000000000000004,0.3333333333333333,0.05,0.5,0.0,4,0.5,1.0,Design 1,Design 1,"Have an option between Design #1 and Design #2,",2.0,,
2311,5294,5,Player object (2062),sell,2023-03-10 13:33:49.794758+00:00,"{""priceA"": 100, ""sharesA"": 0, ""secs_since_round_starts"": 61, ""market"": ""A""}",165.0,12.0,3.0,r6br4dt3,t7od4xlw,FULL STUDY,195.0,s2,1,100,75.0,1,25.0,1,buy,0,sell,0.5344269279803172,17,0,0,block 4 (G second),26.0,12.0,Male,0.0,1.0,1.0,"[5, 'block 4 (G second)']",1,0,1,0.0,7.0,-0.30000000000000004,0.3333333333333333,0.05,0.5,0.0,4,0.5,1.0,Design 1,Design 1,"Have an option between Design #1 and Design #2,",2.0,,
2312,5297,5,Player object (2062),buy,2023-03-10 13:34:00.107004+00:00,"{""priceA"": 80, ""sharesA"": 1, ""secs_since_round_starts"": 71, ""market"": ""A""}",85.0,14.0,4.0,r6br4dt3,t7od4xlw,FULL STUDY,195.0,s2,1,80,100.0,-1,,1,sell,0,sell,0.457409789643144,17,0,0,block 4 (G second),26.0,12.0,Male,0.0,1.0,1.0,"[5, 'block 4 (G second)']",1,0,1,0.0,7.0,-0.30000000000000004,0.3333333333333333,0.05,0.5,0.0,4,0.5,1.0,Design 1,Design 1,"Have an option between Design #1 and Design #2,",2.0,,
2313,5303,5,Player object (2062),sell,2023-03-10 13:34:34.904373+00:00,"{""priceA"": 95, ""sharesA"": 0, ""secs_since_round_starts"": 106, ""market"": ""A""}",180.0,20.0,5.0,r6br4dt3,t7od4xlw,FULL STUDY,195.0,s2,1,95,80.0,1,15.0,1,buy,0,sell,0.5232479875730728,17,0,0,block 4 (G second),26.0,12.0,Male,0.0,1.0,1.0,"[5, 'block 4 (G second)']",1,0,1,0.0,7.0,-0.30000000000000004,0.3333333333333333,0.05,0.5,0.0,4,0.5,1.0,Design 1,Design 1,"Have an option between Design #1 and Design #2,",2.0,,
2314,5306,5,Player object (2062),buy,2023-03-10 13:35:12.835178+00:00,"{""priceA"": 100, ""sharesA"": 1, ""secs_since_round_starts"": 144, ""market"": ""A""}",80.0,27.0,6.0,r6br4dt3,t7od4xlw,FULL STUDY,195.0,s2,1,100,95.0,-1,,1,sell,0,sell,0.4777068930880888,17,0,0,block 4 (G second),26.0,12.0,Male,0.0,1.0,1.0,"[5, 'block 4 (G second)']",1,0,1,0.0,7.0,-0.30000000000000004,0.3333333333333333,0.05,0.5,0.0,4,0.5,1.0,Design 1,Design 1,"Have an option between Design #1 and Design #2,",2.0,,
2315,5312,5,Player object (2062),sell,2023-03-10 13:35:50.697157+00:00,"{""priceA"": 120, ""sharesA"": 0, ""secs_since_round_starts"": 182, ""market"": ""A""}",200.0,34.0,7.0,r6br4dt3,t7od4xlw,FULL STUDY,195.0,s2,1,120,100.0,1,20.0,1,buy,0,sell,0.5679672812132522,17,0,0,block 4 (G second),26.0,12.0,Male,0.0,1.0,1.0,"[5, 'block 4 (G second)']",1,0,1,0.0,7.0,-0.30000000000000004,0.3333333333333333,0.05,0.5,0.0,4,0.5,1.0,Design 1,Design 1,"Have an option between Design #1 and Design #2,",2.0,,
2316,5316,5,Player object (2062),buy,2023-03-10 13:36:14.048368+00:00,"{""priceA"": 80, ""sharesA"": 1, ""secs_since_round_starts"": 205, ""market"": ""A""}",120.0,38.0,8.0,r6br4dt3,t7od4xlw,FULL STUDY,195.0,s2,1,80,120.0,-1,,1,sell,0,sell,0.4515999245786187,17,1,0,block 4 (G second),26.0,12.0,Male,0.0,1.0,1.0,"[5, 'block 4 (G second)']",1,0,1,0.0,7.0,-0.30000000000000004,0.3333333333333333,0.05,0.5,0.0,4,0.5,1.0,Design 1,Design 1,"Have an option between Design #1 and Design #2,",2.0,,
2317,5318,5,Player object (2062),sell,2023-03-10 13:36:35.310699+00:00,"{""priceA"": 100, ""sharesA"": 0, ""secs_since_round_starts"": 226, ""market"": ""A""}",220.0,42.0,9.0,r6br4dt3,t7od4xlw,FULL STUDY,195.0,s2,1,100,80.0,1,20.0,1,buy,0,sell,0.5529358605422235,17,0,1,block 4 (G second),26.0,12.0,Male,0.0,1.0,1.0,"[5, 'block 4 (G second)']",1,0,1,0.0,7.0,-0.30000000000000004,0.3333333333333333,0.05,0.5,0.0,4,0.5,1.0,Design 1,Design 1,"Have an option between Design #1 and Design #2,",2.0,,
2318,5322,5,Player object (2062),buy,2023-03-10 13:37:05.631446+00:00,"{""priceA"": 90, ""sharesA"": 1, ""secs_since_round_starts"": 257, ""market"": ""A""}",130.0,47.0,10.0,r6br4dt3,t7od4xlw,FULL STUDY,195.0,s2,1,90,100.0,-1,,1,sell,0,sell,0.4627742743797309,17,0,0,block 4 (G second),26.0,12.0,Male,0.0,1.0,1.0,"[5, 'block 4 (G second)']",1,0,1,0.0,7.0,-0.30000000000000004,0.3333333333333333,0.05,0.5,0.0,4,0.5,1.0,Design 1,Design 1,"Have an option between Design #1 and Design #2,",2.0,,
2319,3419,2,Player object (932),sell,2023-03-09 04:10:53.777148+00:00,"{""priceA"": 110, ""sharesA"": 0, ""secs_since_round_starts"": 29, ""market"": ""A""}",160.0,6.0,1.0,rishpgae,vmu7c279,FULL STUDY,250.0,s1,1,110,,1,,1,,0,sell,0.5028735207100592,16,0,0,block 4 (G second),22.0,12.0,Male,1.0,1.0,1.0,"[2, 'block 4 (G second)']",0,1,1,1.0,7.0,-0.30000000000000004,0.1111111111111111,0.0,0.0,0.0,5,0.75,1.0,Design 2,Design 2,"Have an option between Design #1 and Design #2,",,1.0,1.0
2320,3420,2,Player object (932),buy,2023-03-09 04:10:58.798339+00:00,"{""priceA"": 100, ""sharesA"": 1, ""secs_since_round_starts"": 34, ""market"": ""A""}",60.0,7.0,2.0,rishpgae,vmu7c279,FULL STUDY,250.0,s1,1,100,110.0,-1,,1,sell,0,sell,0.4669924949471701,16,0,0,block 4 (G second),22.0,12.0,Male,1.0,1.0,1.0,"[2, 'block 4 (G second)']",0,1,1,1.0,7.0,-0.30000000000000004,0.1111111111111111,0.0,0.0,0.0,5,0.75,1.0,Design 2,Design 2,"Have an option between Design #1 and Design #2,",,1.0,1.0
2321,3426,2,Player object (932),sell,2023-03-09 04:12:32.346312+00:00,"{""priceA"": 160, ""sharesA"": 0, ""secs_since_round_starts"": 127, ""market"": ""A""}",220.0,24.0,4.0,rishpgae,vmu7c279,FULL STUDY,250.0,s1,1,160,75.0,1,85.0,1,buy,0,sell,0.5912834651029929,16,0,0,block 4 (G second),22.0,12.0,Male,1.0,1.0,1.0,"[2, 'block 4 (G second)']",0,1,1,1.0,7.0,-0.30000000000000004,0.1111111111111111,0.0,0.0,0.0,5,0.75,1.0,Design 2,Design 2,"Have an option between Design #1 and Design #2,",,1.0,1.0
2322,3434,2,Player object (932),buy,2023-03-09 04:13:54.780796+00:00,"{""priceA"": 125, ""sharesA"": 1, ""secs_since_round_starts"": 210, ""market"": ""A""}",95.0,39.0,5.0,rishpgae,vmu7c279,FULL STUDY,250.0,s1,1,125,160.0,-1,,1,sell,0,sell,0.4382592777609274,16,1,0,block 4 (G second),22.0,12.0,Male,1.0,1.0,1.0,"[2, 'block 4 (G second)']",0,1,1,1.0,7.0,-0.30000000000000004,0.1111111111111111,0.0,0.0,0.0,5,0.75,1.0,Design 2,Design 2,"Have an option between Design #1 and Design #2,",,1.0,1.0
2323,3436,2,Player object (932),sell,2023-03-09 04:14:59.633078+00:00,"{""priceA"": 140, ""sharesA"": 0, ""secs_since_round_starts"": 274, ""market"": ""A""}",235.0,51.0,6.0,rishpgae,vmu7c279,FULL STUDY,250.0,s1,1,140,125.0,1,15.0,1,buy,0,sell,0.4693918893964308,16,0,0,block 4 (G second),22.0,12.0,Male,1.0,1.0,1.0,"[2, 'block 4 (G second)']",0,1,1,1.0,7.0,-0.30000000000000004,0.1111111111111111,0.0,0.0,0.0,5,0.75,1.0,Design 2,Design 2,"Have an option between Design #1 and Design #2,",,1.0,1.0
2324,3438,2,Player object (932),buy,2023-03-09 04:15:32.390786+00:00,"{""priceA"": 110, ""sharesA"": 1, ""secs_since_round_starts"": 307, ""market"": ""A""}",125.0,57.0,7.0,rishpgae,vmu7c279,FULL STUDY,250.0,s1,1,110,140.0,-1,,1,sell,0,sell,0.4349378880511929,16,1,0,block 4 (G second),22.0,12.0,Male,1.0,1.0,1.0,"[2, 'block 4 (G second)']",0,1,1,1.0,7.0,-0.30000000000000004,0.1111111111111111,0.0,0.0,0.0,5,0.75,1.0,Design 2,Design 2,"Have an option between Design #1 and Design #2,",,1.0,1.0
2325,3465,3,Player object (1052),sell,2023-03-09 04:22:02.653886+00:00,"{""priceA"": 130, ""sharesA"": 0, ""secs_since_round_starts"": 368, ""market"": ""A""}",180.0,53.0,2.0,rishpgae,vmu7c279,FULL STUDY,155.0,s1,1,130,100.0,1,30.0,1,,0,sell,0.4905868559773416,19,0,0,block 4 (G second),22.0,12.0,Male,1.0,1.0,1.0,"[3, 'block 4 (G second)']",0,0,1,1.0,7.0,-0.30000000000000004,0.029411764705882353,0.1111111111111111,0.0,0.0,5,0.75,1.0,Design 2,Design 2,"Have an option between Design #1 and Design #2,",,1.0,1.0
2326,3466,3,Player object (1052),buy,2023-03-09 04:22:20.558433+00:00,"{""priceA"": 145, ""sharesA"": 1, ""secs_since_round_starts"": 386, ""market"": ""A""}",35.0,56.0,3.0,rishpgae,vmu7c279,FULL STUDY,155.0,s1,1,145,130.0,-1,,1,sell,0,sell,0.5032655808500681,19,0,0,block 4 (G second),22.0,12.0,Male,1.0,1.0,1.0,"[3, 'block 4 (G second)']",0,0,1,1.0,7.0,-0.30000000000000004,0.029411764705882353,0.1111111111111111,0.0,0.0,5,0.75,1.0,Design 2,Design 2,"Have an option between Design #1 and Design #2,",,1.0,1.0
2327,3467,3,Player object (1052),sell,2023-03-09 04:22:24.507414+00:00,"{""priceA"": 130, ""sharesA"": 0, ""secs_since_round_starts"": 390, ""market"": ""A""}",165.0,57.0,4.0,rishpgae,vmu7c279,FULL STUDY,155.0,s1,1,130,145.0,1,-15.0,1,buy,0,sell,0.46726452652799,19,0,0,block 4 (G second),22.0,12.0,Male,1.0,1.0,1.0,"[3, 'block 4 (G second)']",0,0,1,1.0,7.0,-0.30000000000000004,0.029411764705882353,0.1111111111111111,0.0,0.0,5,0.75,1.0,Design 2,Design 2,"Have an option between Design #1 and Design #2,",,1.0,1.0
2328,3469,3,Player object (1052),buy,2023-03-09 04:22:35.237986+00:00,"{""priceA"": 125, ""sharesA"": 1, ""secs_since_round_starts"": 401, ""market"": ""A""}",40.0,59.0,5.0,rishpgae,vmu7c279,FULL STUDY,155.0,s1,1,125,130.0,-1,,1,sell,0,sell,0.4946618842475483,19,0,0,block 4 (G second),22.0,12.0,Male,1.0,1.0,1.0,"[3, 'block 4 (G second)']",0,0,1,1.0,7.0,-0.30000000000000004,0.029411764705882353,0.1111111111111111,0.0,0.0,5,0.75,1.0,Design 2,Design 2,"Have an option between Design #1 and Design #2,",,1.0,1.0
2329,3492,4,Player object (1172),sell,2023-03-09 04:28:12.028126+00:00,"{""priceA"": 90, ""sharesA"": 0, ""secs_since_round_starts"": 174, ""market"": ""A""}",140.0,29.0,2.0,rishpgae,vmu7c279,FULL STUDY,125.0,s1,1,90,40.0,1,50.0,1,,0,sell,0.5712793841154561,14,0,0,block 4 (G second),22.0,12.0,Male,1.0,1.0,1.0,"[4, 'block 4 (G second)']",1,1,1,1.0,7.0,-0.30000000000000004,0.3333333333333333,0.047619047619047616,0.0,0.0,5,0.25,1.0,Design 2,Design 2,"Have an option between Design #1 and Design #2,",,1.0,1.0
2330,3493,4,Player object (1172),buy,2023-03-09 04:28:16.035511+00:00,"{""priceA"": 85, ""sharesA"": 1, ""secs_since_round_starts"": 178, ""market"": ""A""}",55.0,30.0,3.0,rishpgae,vmu7c279,FULL STUDY,125.0,s1,1,85,90.0,-1,,1,sell,0,sell,0.5151109892827086,14,0,0,block 4 (G second),22.0,12.0,Male,1.0,1.0,1.0,"[4, 'block 4 (G second)']",1,1,1,1.0,7.0,-0.30000000000000004,0.3333333333333333,0.047619047619047616,0.0,0.0,5,0.25,1.0,Design 2,Design 2,"Have an option between Design #1 and Design #2,",,1.0,1.0
2331,3496,4,Player object (1172),sell,2023-03-09 04:28:27.501067+00:00,"{""priceA"": 95, ""sharesA"": 0, ""secs_since_round_starts"": 190, ""market"": ""A""}",150.0,32.0,4.0,rishpgae,vmu7c279,FULL STUDY,125.0,s1,1,95,85.0,1,10.0,1,buy,0,sell,0.5179404569050043,14,0,0,block 4 (G second),22.0,12.0,Male,1.0,1.0,1.0,"[4, 'block 4 (G second)']",1,1,1,1.0,7.0,-0.30000000000000004,0.3333333333333333,0.047619047619047616,0.0,0.0,5,0.25,1.0,Design 2,Design 2,"Have an option between Design #1 and Design #2,",,1.0,1.0
2332,3499,4,Player object (1172),buy,2023-03-09 04:28:45.269327+00:00,"{""priceA"": 100, ""sharesA"": 1, ""secs_since_round_starts"": 208, ""market"": ""A""}",50.0,35.0,6.0,rishpgae,vmu7c279,FULL STUDY,125.0,s1,1,100,95.0,-1,,1,sell,0,sell,0.5337204628349665,14,0,0,block 4 (G second),22.0,12.0,Male,1.0,1.0,1.0,"[4, 'block 4 (G second)']",1,1,1,1.0,7.0,-0.30000000000000004,0.3333333333333333,0.047619047619047616,0.0,0.0,5,0.25,1.0,Design 2,Design 2,"Have an option between Design #1 and Design #2,",,1.0,1.0
2333,3509,4,Player object (1172),sell,2023-03-09 04:29:57.475996+00:00,"{""priceA"": 100, ""sharesA"": 0, ""secs_since_round_starts"": 280, ""market"": ""A""}",150.0,48.0,9.0,rishpgae,vmu7c279,FULL STUDY,125.0,s1,1,100,100.0,1,0.0,1,buy,0,sell,0.500105737602651,14,0,0,block 4 (G second),22.0,12.0,Male,1.0,1.0,1.0,"[4, 'block 4 (G second)']",1,1,1,1.0,7.0,-0.30000000000000004,0.3333333333333333,0.047619047619047616,0.0,0.0,5,0.25,1.0,Design 2,Design 2,"Have an option between Design #1 and Design #2,",,1.0,1.0
2334,3510,4,Player object (1172),buy,2023-03-09 04:29:59.293510+00:00,"{""priceA"": 105, ""sharesA"": 1, ""secs_since_round_starts"": 282, ""market"": ""A""}",45.0,49.0,10.0,rishpgae,vmu7c279,FULL STUDY,125.0,s1,1,105,100.0,-1,,1,sell,0,sell,0.5350732746090608,14,0,0,block 4 (G second),22.0,12.0,Male,1.0,1.0,1.0,"[4, 'block 4 (G second)']",1,1,1,1.0,7.0,-0.30000000000000004,0.3333333333333333,0.047619047619047616,0.0,0.0,5,0.25,1.0,Design 2,Design 2,"Have an option between Design #1 and Design #2,",,1.0,1.0
2335,3518,4,Player object (1172),sell,2023-03-09 04:30:23.428502+00:00,"{""priceA"": 90, ""sharesA"": 0, ""secs_since_round_starts"": 306, ""market"": ""A""}",135.0,52.0,12.0,rishpgae,vmu7c279,FULL STUDY,125.0,s1,1,90,90.0,1,0.0,5,buy,0,sell,0.4694909620846048,14,0,0,block 4 (G second),22.0,12.0,Male,1.0,1.0,1.0,"[4, 'block 4 (G second)']",1,1,1,1.0,7.0,-0.30000000000000004,0.3333333333333333,0.047619047619047616,0.0,0.0,5,0.25,1.0,Design 2,Design 2,"Have an option between Design #1 and Design #2,",,1.0,1.0
2336,3519,4,Player object (1172),buy,2023-03-09 04:30:29.468504+00:00,"{""priceA"": 85, ""sharesA"": 1, ""secs_since_round_starts"": 312, ""market"": ""A""}",50.0,54.0,13.0,rishpgae,vmu7c279,FULL STUDY,125.0,s1,1,85,90.0,-1,,1,sell,0,sell,0.4957421237757241,14,0,0,block 4 (G second),22.0,12.0,Male,1.0,1.0,1.0,"[4, 'block 4 (G second)']",1,1,1,1.0,7.0,-0.30000000000000004,0.3333333333333333,0.047619047619047616,0.0,0.0,5,0.25,1.0,Design 2,Design 2,"Have an option between Design #1 and Design #2,",,1.0,1.0
2337,3535,5,Player object (1292),sell,2023-03-09 04:33:09.060161+00:00,"{""priceA"": 80, ""sharesA"": 0, ""secs_since_round_starts"": 113, ""market"": ""A""}",130.0,19.0,6.0,rishpgae,vmu7c279,FULL STUDY,120.0,s1,1,80,70.0,1,10.0,1,,0,sell,0.4830991506082083,17,0,0,block 4 (G second),22.0,12.0,Male,1.0,1.0,1.0,"[5, 'block 4 (G second)']",1,0,1,0.5,7.0,-0.30000000000000004,0.25,0.06666666666666667,0.25,0.0,5,0.25,1.0,Design 2,Design 2,"Have an option between Design #1 and Design #2,",,1.0,1.0
2338,3536,5,Player object (1292),buy,2023-03-09 04:33:13.032410+00:00,"{""priceA"": 95, ""sharesA"": 1, ""secs_since_round_starts"": 117, ""market"": ""A""}",35.0,20.0,7.0,rishpgae,vmu7c279,FULL STUDY,120.0,s1,1,95,80.0,-1,,1,sell,0,sell,0.5232479875730728,17,0,0,block 4 (G second),22.0,12.0,Male,1.0,1.0,1.0,"[5, 'block 4 (G second)']",1,0,1,0.5,7.0,-0.30000000000000004,0.25,0.06666666666666667,0.25,0.0,5,0.25,1.0,Design 2,Design 2,"Have an option between Design #1 and Design #2,",,1.0,1.0
2339,3549,5,Player object (1292),sell,2023-03-09 04:35:21.040968+00:00,"{""priceA"": 80, ""sharesA"": 0, ""secs_since_round_starts"": 245, ""market"": ""A""}",115.0,40.0,12.0,rishpgae,vmu7c279,FULL STUDY,120.0,s1,1,80,80.0,1,0.0,3,buy,0,sell,0.4870698015370814,17,0,0,block 4 (G second),22.0,12.0,Male,1.0,1.0,1.0,"[5, 'block 4 (G second)']",1,0,1,0.5,7.0,-0.30000000000000004,0.25,0.06666666666666667,0.25,0.0,5,0.25,1.0,Design 2,Design 2,"Have an option between Design #1 and Design #2,",,1.0,1.0
2340,3550,5,Player object (1292),buy,2023-03-09 04:35:22.102671+00:00,"{""priceA"": 95, ""sharesA"": 1, ""secs_since_round_starts"": 246, ""market"": ""A""}",20.0,41.0,13.0,rishpgae,vmu7c279,FULL STUDY,120.0,s1,1,95,80.0,-1,,1,sell,0,sell,0.5260161398462472,17,0,0,block 4 (G second),22.0,12.0,Male,1.0,1.0,1.0,"[5, 'block 4 (G second)']",1,0,1,0.5,7.0,-0.30000000000000004,0.25,0.06666666666666667,0.25,0.0,5,0.25,1.0,Design 2,Design 2,"Have an option between Design #1 and Design #2,",,1.0,1.0
2341,3551,5,Player object (1292),sell,2023-03-09 04:35:27.885042+00:00,"{""priceA"": 100, ""sharesA"": 0, ""secs_since_round_starts"": 252, ""market"": ""A""}",120.0,42.0,14.0,rishpgae,vmu7c279,FULL STUDY,120.0,s1,1,100,95.0,1,5.0,1,buy,0,sell,0.5529358605422235,17,0,1,block 4 (G second),22.0,12.0,Male,1.0,1.0,1.0,"[5, 'block 4 (G second)']",1,0,1,0.5,7.0,-0.30000000000000004,0.25,0.06666666666666667,0.25,0.0,5,0.25,1.0,Design 2,Design 2,"Have an option between Design #1 and Design #2,",,1.0,1.0
2342,3555,5,Player object (1292),buy,2023-03-09 04:35:45.137864+00:00,"{""priceA"": 105, ""sharesA"": 1, ""secs_since_round_starts"": 269, ""market"": ""A""}",15.0,44.0,15.0,rishpgae,vmu7c279,FULL STUDY,120.0,s1,1,105,105.0,-1,,3,sell,0,sell,0.515125859635568,17,0,0,block 4 (G second),22.0,12.0,Male,1.0,1.0,1.0,"[5, 'block 4 (G second)']",1,0,1,0.5,7.0,-0.30000000000000004,0.25,0.06666666666666667,0.25,0.0,5,0.25,1.0,Design 2,Design 2,"Have an option between Design #1 and Design #2,",,1.0,1.0
2343,3556,5,Player object (1292),sell,2023-03-09 04:35:52.022627+00:00,"{""priceA"": 110, ""sharesA"": 0, ""secs_since_round_starts"": 276, ""market"": ""A""}",125.0,45.0,16.0,rishpgae,vmu7c279,FULL STUDY,120.0,s1,1,110,105.0,1,5.0,1,buy,0,sell,0.5454506058480159,17,0,0,block 4 (G second),22.0,12.0,Male,1.0,1.0,1.0,"[5, 'block 4 (G second)']",1,0,1,0.5,7.0,-0.30000000000000004,0.25,0.06666666666666667,0.25,0.0,5,0.25,1.0,Design 2,Design 2,"Have an option between Design #1 and Design #2,",,1.0,1.0
2344,3557,5,Player object (1292),buy,2023-03-09 04:35:53.258031+00:00,"{""priceA"": 95, ""sharesA"": 1, ""secs_since_round_starts"": 278, ""market"": ""A""}",30.0,46.0,17.0,rishpgae,vmu7c279,FULL STUDY,120.0,s1,1,95,110.0,-1,,1,sell,0,sell,0.4967862103563366,17,0,0,block 4 (G second),22.0,12.0,Male,1.0,1.0,1.0,"[5, 'block 4 (G second)']",1,0,1,0.5,7.0,-0.30000000000000004,0.25,0.06666666666666667,0.25,0.0,5,0.25,1.0,Design 2,Design 2,"Have an option between Design #1 and Design #2,",,1.0,1.0
2345,3565,5,Player object (1292),sell,2023-03-09 04:36:41.726038+00:00,"{""priceA"": 95, ""sharesA"": 0, ""secs_since_round_starts"": 326, ""market"": ""A""}",125.0,54.0,20.0,rishpgae,vmu7c279,FULL STUDY,120.0,s1,1,95,95.0,1,0.0,3,buy,0,sell,0.5299980248683189,17,0,0,block 4 (G second),22.0,12.0,Male,1.0,1.0,1.0,"[5, 'block 4 (G second)']",1,0,1,0.5,7.0,-0.30000000000000004,0.25,0.06666666666666667,0.25,0.0,5,0.25,1.0,Design 2,Design 2,"Have an option between Design #1 and Design #2,",,1.0,1.0
2346,3566,5,Player object (1292),buy,2023-03-09 04:36:45.724975+00:00,"{""priceA"": 80, ""sharesA"": 1, ""secs_since_round_starts"": 330, ""market"": ""A""}",45.0,55.0,21.0,rishpgae,vmu7c279,FULL STUDY,120.0,s1,1,80,95.0,-1,,1,sell,0,sell,0.4859141076178286,17,0,0,block 4 (G second),22.0,12.0,Male,1.0,1.0,1.0,"[5, 'block 4 (G second)']",1,0,1,0.5,7.0,-0.30000000000000004,0.25,0.06666666666666667,0.25,0.0,5,0.25,1.0,Design 2,Design 2,"Have an option between Design #1 and Design #2,",,1.0,1.0
2347,3567,5,Player object (1292),sell,2023-03-09 04:36:52.779871+00:00,"{""priceA"": 95, ""sharesA"": 0, ""secs_since_round_starts"": 337, ""market"": ""A""}",140.0,56.0,22.0,rishpgae,vmu7c279,FULL STUDY,120.0,s1,1,95,80.0,1,15.0,1,buy,0,sell,0.5252108989343294,17,0,0,block 4 (G second),22.0,12.0,Male,1.0,1.0,1.0,"[5, 'block 4 (G second)']",1,0,1,0.5,7.0,-0.30000000000000004,0.25,0.06666666666666667,0.25,0.0,5,0.25,1.0,Design 2,Design 2,"Have an option between Design #1 and Design #2,",,1.0,1.0
2348,3568,5,Player object (1292),buy,2023-03-09 04:36:56.962610+00:00,"{""priceA"": 85, ""sharesA"": 1, ""secs_since_round_starts"": 341, ""market"": ""A""}",55.0,57.0,23.0,rishpgae,vmu7c279,FULL STUDY,120.0,s1,1,85,95.0,-1,,1,sell,0,sell,0.4825596920859898,17,0,0,block 4 (G second),22.0,12.0,Male,1.0,1.0,1.0,"[5, 'block 4 (G second)']",1,0,1,0.5,7.0,-0.30000000000000004,0.25,0.06666666666666667,0.25,0.0,5,0.25,1.0,Design 2,Design 2,"Have an option between Design #1 and Design #2,",,1.0,1.0
2349,5448,2,Player object (1529),sell,2023-03-10 14:25:01.943874+00:00,"{""priceA"": 110, ""sharesA"": 0, ""secs_since_round_starts"": 27, ""market"": ""A""}",160.0,6.0,1.0,s1qm3487,t7od4xlw,FULL STUDY,215.0,s3,1,110,,1,,1,,0,sell,0.5028735207100592,16,0,0,block 1 (G first),19.0,11.0,Male,0.0,0.0,0.0,"[2, 'block 1 (G first)']",1,0,0,0.5,1.0,-0.8166666666666667,0.6153846153846154,0.11538461538461539,0.0,0.2857142857142857,4,1.0,0.75,Design 2,Design 2,Only trade on Design #1,5.0,5.0,5.0
2350,5450,2,Player object (1529),buy,2023-03-10 14:25:15.756401+00:00,"{""priceA"": 70, ""sharesA"": 1, ""secs_since_round_starts"": 41, ""market"": ""A""}",90.0,9.0,2.0,s1qm3487,t7od4xlw,FULL STUDY,215.0,s3,1,70,110.0,-1,,1,sell,0,sell,0.4254536939069079,16,0,0,block 1 (G first),19.0,11.0,Male,0.0,0.0,0.0,"[2, 'block 1 (G first)']",1,0,0,0.5,1.0,-0.8166666666666667,0.6153846153846154,0.11538461538461539,0.0,0.2857142857142857,4,1.0,0.75,Design 2,Design 2,Only trade on Design #1,5.0,5.0,5.0
2351,5452,2,Player object (1529),sell,2023-03-10 14:25:39.400350+00:00,"{""priceA"": 90, ""sharesA"": 0, ""secs_since_round_starts"": 65, ""market"": ""A""}",180.0,13.0,3.0,s1qm3487,t7od4xlw,FULL STUDY,215.0,s3,1,90,70.0,1,20.0,1,buy,0,sell,0.5364461838942041,16,0,0,block 1 (G first),19.0,11.0,Male,0.0,0.0,0.0,"[2, 'block 1 (G first)']",1,0,0,0.5,1.0,-0.8166666666666667,0.6153846153846154,0.11538461538461539,0.0,0.2857142857142857,4,1.0,0.75,Design 2,Design 2,Only trade on Design #1,5.0,5.0,5.0
2352,5454,2,Player object (1529),buy,2023-03-10 14:25:44.582997+00:00,"{""priceA"": 105, ""sharesA"": 1, ""secs_since_round_starts"": 70, ""market"": ""A""}",75.0,14.0,4.0,s1qm3487,t7od4xlw,FULL STUDY,215.0,s3,1,105,90.0,-1,,1,sell,0,sell,0.5600744319669811,16,0,1,block 1 (G first),19.0,11.0,Male,0.0,0.0,0.0,"[2, 'block 1 (G first)']",1,0,0,0.5,1.0,-0.8166666666666667,0.6153846153846154,0.11538461538461539,0.0,0.2857142857142857,4,1.0,0.75,Design 2,Design 2,Only trade on Design #1,5.0,5.0,5.0
2353,5455,2,Player object (1529),sell,2023-03-10 14:25:49.995457+00:00,"{""priceA"": 120, ""sharesA"": 0, ""secs_since_round_starts"": 75, ""market"": ""A""}",195.0,15.0,5.0,s1qm3487,t7od4xlw,FULL STUDY,215.0,s3,1,120,105.0,1,15.0,1,buy,0,sell,0.5761373211134116,16,0,0,block 1 (G first),19.0,11.0,Male,0.0,0.0,0.0,"[2, 'block 1 (G first)']",1,0,0,0.5,1.0,-0.8166666666666667,0.6153846153846154,0.11538461538461539,0.0,0.2857142857142857,4,1.0,0.75,Design 2,Design 2,Only trade on Design #1,5.0,5.0,5.0
2354,5457,2,Player object (1529),buy,2023-03-10 14:25:55.302444+00:00,"{""priceA"": 105, ""sharesA"": 1, ""secs_since_round_starts"": 80, ""market"": ""A""}",90.0,16.0,6.0,s1qm3487,t7od4xlw,FULL STUDY,215.0,s3,1,105,120.0,-1,,1,sell,0,sell,0.5185790363913291,16,0,0,block 1 (G first),19.0,11.0,Male,0.0,0.0,0.0,"[2, 'block 1 (G first)']",1,0,0,0.5,1.0,-0.8166666666666667,0.6153846153846154,0.11538461538461539,0.0,0.2857142857142857,4,1.0,0.75,Design 2,Design 2,Only trade on Design #1,5.0,5.0,5.0
2355,5458,2,Player object (1529),sell,2023-03-10 14:26:00.571990+00:00,"{""priceA"": 110, ""sharesA"": 0, ""secs_since_round_starts"": 86, ""market"": ""A""}",200.0,17.0,7.0,s1qm3487,t7od4xlw,FULL STUDY,215.0,s3,1,110,105.0,1,5.0,1,buy,0,sell,0.5478276073026133,16,0,0,block 1 (G first),19.0,11.0,Male,0.0,0.0,0.0,"[2, 'block 1 (G first)']",1,0,0,0.5,1.0,-0.8166666666666667,0.6153846153846154,0.11538461538461539,0.0,0.2857142857142857,4,1.0,0.75,Design 2,Design 2,Only trade on Design #1,5.0,5.0,5.0
2356,5459,2,Player object (1529),buy,2023-03-10 14:26:11.836462+00:00,"{""priceA"": 130, ""sharesA"": 1, ""secs_since_round_starts"": 97, ""market"": ""A""}",70.0,19.0,8.0,s1qm3487,t7od4xlw,FULL STUDY,215.0,s3,1,130,110.0,-1,,1,sell,0,sell,0.5813773703663461,16,0,1,block 1 (G first),19.0,11.0,Male,0.0,0.0,0.0,"[2, 'block 1 (G first)']",1,0,0,0.5,1.0,-0.8166666666666667,0.6153846153846154,0.11538461538461539,0.0,0.2857142857142857,4,1.0,0.75,Design 2,Design 2,Only trade on Design #1,5.0,5.0,5.0
2357,5472,2,Player object (1529),sell,2023-03-10 14:26:44.263624+00:00,"{""priceA"": 160, ""sharesA"": 0, ""secs_since_round_starts"": 129, ""market"": ""A""}",230.0,24.0,13.0,s1qm3487,t7od4xlw,FULL STUDY,215.0,s3,1,160,150.0,1,10.0,1,buy,0,sell,0.5912834651029929,16,0,0,block 1 (G first),19.0,11.0,Male,0.0,0.0,0.0,"[2, 'block 1 (G first)']",1,0,0,0.5,1.0,-0.8166666666666667,0.6153846153846154,0.11538461538461539,0.0,0.2857142857142857,4,1.0,0.75,Design 2,Design 2,Only trade on Design #1,5.0,5.0,5.0
2358,5473,2,Player object (1529),buy,2023-03-10 14:26:50.260200+00:00,"{""priceA"": 145, ""sharesA"": 1, ""secs_since_round_starts"": 135, ""market"": ""A""}",85.0,25.0,14.0,s1qm3487,t7od4xlw,FULL STUDY,215.0,s3,1,145,160.0,-1,,1,sell,0,sell,0.5294358264188312,16,0,0,block 1 (G first),19.0,11.0,Male,0.0,0.0,0.0,"[2, 'block 1 (G first)']",1,0,0,0.5,1.0,-0.8166666666666667,0.6153846153846154,0.11538461538461539,0.0,0.2857142857142857,4,1.0,0.75,Design 2,Design 2,Only trade on Design #1,5.0,5.0,5.0
2359,5483,2,Player object (1529),sell,2023-03-10 14:27:36.252365+00:00,"{""priceA"": 135, ""sharesA"": 0, ""secs_since_round_starts"": 181, ""market"": ""A""}",220.0,32.0,16.0,s1qm3487,t7od4xlw,FULL STUDY,215.0,s3,1,135,140.0,1,-5.0,1,buy,0,sell,0.5488776546772527,16,0,1,block 1 (G first),19.0,11.0,Male,0.0,0.0,0.0,"[2, 'block 1 (G first)']",1,0,0,0.5,1.0,-0.8166666666666667,0.6153846153846154,0.11538461538461539,0.0,0.2857142857142857,4,1.0,0.75,Design 2,Design 2,Only trade on Design #1,5.0,5.0,5.0
2360,5484,2,Player object (1529),buy,2023-03-10 14:27:39.745452+00:00,"{""priceA"": 130, ""sharesA"": 1, ""secs_since_round_starts"": 185, ""market"": ""A""}",90.0,33.0,17.0,s1qm3487,t7od4xlw,FULL STUDY,215.0,s3,1,130,135.0,-1,,1,sell,0,sell,0.499206602391208,16,0,0,block 1 (G first),19.0,11.0,Male,0.0,0.0,0.0,"[2, 'block 1 (G first)']",1,0,0,0.5,1.0,-0.8166666666666667,0.6153846153846154,0.11538461538461539,0.0,0.2857142857142857,4,1.0,0.75,Design 2,Design 2,Only trade on Design #1,5.0,5.0,5.0
2361,5487,2,Player object (1529),sell,2023-03-10 14:27:51.016381+00:00,"{""priceA"": 140, ""sharesA"": 0, ""secs_since_round_starts"": 196, ""market"": ""A""}",230.0,35.0,19.0,s1qm3487,t7od4xlw,FULL STUDY,215.0,s3,1,140,125.0,1,15.0,1,buy,0,sell,0.5101876173062244,16,0,0,block 1 (G first),19.0,11.0,Male,0.0,0.0,0.0,"[2, 'block 1 (G first)']",1,0,0,0.5,1.0,-0.8166666666666667,0.6153846153846154,0.11538461538461539,0.0,0.2857142857142857,4,1.0,0.75,Design 2,Design 2,Only trade on Design #1,5.0,5.0,5.0
2362,5492,2,Player object (1529),buy,2023-03-10 14:28:07.215242+00:00,"{""priceA"": 145, ""sharesA"": 1, ""secs_since_round_starts"": 212, ""market"": ""A""}",85.0,37.0,21.0,s1qm3487,t7od4xlw,FULL STUDY,215.0,s3,1,145,150.0,-1,,1,sell,0,sell,0.494384744736363,16,0,0,block 1 (G first),19.0,11.0,Male,0.0,0.0,0.0,"[2, 'block 1 (G first)']",1,0,0,0.5,1.0,-0.8166666666666667,0.6153846153846154,0.11538461538461539,0.0,0.2857142857142857,4,1.0,0.75,Design 2,Design 2,Only trade on Design #1,5.0,5.0,5.0
2363,5494,2,Player object (1529),sell,2023-03-10 14:28:23.822428+00:00,"{""priceA"": 140, ""sharesA"": 0, ""secs_since_round_starts"": 229, ""market"": ""A""}",225.0,40.0,22.0,s1qm3487,t7od4xlw,FULL STUDY,215.0,s3,1,140,145.0,1,-5.0,1,buy,0,sell,0.4916787423410894,16,0,0,block 1 (G first),19.0,11.0,Male,0.0,0.0,0.0,"[2, 'block 1 (G first)']",1,0,0,0.5,1.0,-0.8166666666666667,0.6153846153846154,0.11538461538461539,0.0,0.2857142857142857,4,1.0,0.75,Design 2,Design 2,Only trade on Design #1,5.0,5.0,5.0
2364,5496,2,Player object (1529),buy,2023-03-10 14:28:29.102687+00:00,"{""priceA"": 135, ""sharesA"": 1, ""secs_since_round_starts"": 234, ""market"": ""A""}",90.0,41.0,23.0,s1qm3487,t7od4xlw,FULL STUDY,215.0,s3,1,135,140.0,-1,,1,sell,0,sell,0.4592429496222846,16,0,0,block 1 (G first),19.0,11.0,Male,0.0,0.0,0.0,"[2, 'block 1 (G first)']",1,0,0,0.5,1.0,-0.8166666666666667,0.6153846153846154,0.11538461538461539,0.0,0.2857142857142857,4,1.0,0.75,Design 2,Design 2,Only trade on Design #1,5.0,5.0,5.0
2365,5503,2,Player object (1529),sell,2023-03-10 14:28:51.981231+00:00,"{""priceA"": 140, ""sharesA"": 0, ""secs_since_round_starts"": 257, ""market"": ""A""}",230.0,45.0,25.0,s1qm3487,t7od4xlw,FULL STUDY,215.0,s3,1,140,130.0,1,10.0,1,buy,0,sell,0.5210834711709403,16,0,0,block 1 (G first),19.0,11.0,Male,0.0,0.0,0.0,"[2, 'block 1 (G first)']",1,0,0,0.5,1.0,-0.8166666666666667,0.6153846153846154,0.11538461538461539,0.0,0.2857142857142857,4,1.0,0.75,Design 2,Design 2,Only trade on Design #1,5.0,5.0,5.0
2366,5508,2,Player object (1529),buy,2023-03-10 14:29:07.508462+00:00,"{""priceA"": 140, ""sharesA"": 1, ""secs_since_round_starts"": 273, ""market"": ""A""}",90.0,47.0,27.0,s1qm3487,t7od4xlw,FULL STUDY,215.0,s3,1,140,155.0,-1,,1,sell,0,sell,0.4996814899229063,16,0,0,block 1 (G first),19.0,11.0,Male,0.0,0.0,0.0,"[2, 'block 1 (G first)']",1,0,0,0.5,1.0,-0.8166666666666667,0.6153846153846154,0.11538461538461539,0.0,0.2857142857142857,4,1.0,0.75,Design 2,Design 2,Only trade on Design #1,5.0,5.0,5.0
2367,5509,2,Player object (1529),sell,2023-03-10 14:29:12.263291+00:00,"{""priceA"": 155, ""sharesA"": 0, ""secs_since_round_starts"": 277, ""market"": ""A""}",245.0,48.0,28.0,s1qm3487,t7od4xlw,FULL STUDY,215.0,s3,1,155,140.0,1,15.0,1,buy,0,sell,0.5347792584548927,16,0,0,block 1 (G first),19.0,11.0,Male,0.0,0.0,0.0,"[2, 'block 1 (G first)']",1,0,0,0.5,1.0,-0.8166666666666667,0.6153846153846154,0.11538461538461539,0.0,0.2857142857142857,4,1.0,0.75,Design 2,Design 2,Only trade on Design #1,5.0,5.0,5.0
2368,5514,2,Player object (1529),buy,2023-03-10 14:29:22.198409+00:00,"{""priceA"": 155, ""sharesA"": 1, ""secs_since_round_starts"": 287, ""market"": ""A""}",90.0,50.0,30.0,s1qm3487,t7od4xlw,FULL STUDY,215.0,s3,1,155,170.0,-1,,1,sell,0,sell,0.5063294801170398,16,0,0,block 1 (G first),19.0,11.0,Male,0.0,0.0,0.0,"[2, 'block 1 (G first)']",1,0,0,0.5,1.0,-0.8166666666666667,0.6153846153846154,0.11538461538461539,0.0,0.2857142857142857,4,1.0,0.75,Design 2,Design 2,Only trade on Design #1,5.0,5.0,5.0
2369,5522,2,Player object (1529),sell,2023-03-10 14:30:21.827635+00:00,"{""priceA"": 125, ""sharesA"": 0, ""secs_since_round_starts"": 347, ""market"": ""A""}",215.0,60.0,31.0,s1qm3487,t7od4xlw,FULL STUDY,215.0,s3,1,125,155.0,1,-30.0,1,buy,0,sell,0.5540089061739091,16,0,1,block 1 (G first),19.0,11.0,Male,0.0,0.0,0.0,"[2, 'block 1 (G first)']",1,0,0,0.5,1.0,-0.8166666666666667,0.6153846153846154,0.11538461538461539,0.0,0.2857142857142857,4,1.0,0.75,Design 2,Design 2,Only trade on Design #1,5.0,5.0,5.0
2370,5526,3,Player object (1709),sell,2023-03-10 14:30:57.231345+00:00,"{""priceA"": 95, ""sharesA"": 0, ""secs_since_round_starts"": 28, ""market"": ""A""}",145.0,6.0,1.0,s1qm3487,t7od4xlw,FULL STUDY,185.0,s3,1,95,,1,,1,,0,sell,0.4900186148515444,19,0,0,block 1 (G first),19.0,11.0,Male,0.0,0.0,0.0,"[3, 'block 1 (G first)']",1,1,0,1.0,1.0,-0.8166666666666667,0.19047619047619047,0.29411764705882354,0.25,0.4,1,0.25,0.25,Design 2,Design 2,Only trade on Design #1,5.0,5.0,5.0
2371,5527,3,Player object (1709),buy,2023-03-10 14:30:58.416406+00:00,"{""priceA"": 90, ""sharesA"": 1, ""secs_since_round_starts"": 29, ""market"": ""A""}",55.0,7.0,2.0,s1qm3487,t7od4xlw,FULL STUDY,185.0,s3,1,90,95.0,-1,,1,sell,0,sell,0.4580966810292103,19,0,0,block 1 (G first),19.0,11.0,Male,0.0,0.0,0.0,"[3, 'block 1 (G first)']",1,1,0,1.0,1.0,-0.8166666666666667,0.19047619047619047,0.29411764705882354,0.25,0.4,1,0.25,0.25,Design 2,Design 2,Only trade on Design #1,5.0,5.0,5.0
2372,5557,3,Player object (1709),sell,2023-03-10 14:32:30.268363+00:00,"{""priceA"": 85, ""sharesA"": 0, ""secs_since_round_starts"": 121, ""market"": ""A""}",140.0,22.0,14.0,s1qm3487,t7od4xlw,FULL STUDY,185.0,s3,1,85,115.0,1,-30.0,1,buy,0,sell,0.443819468959905,19,1,0,block 1 (G first),19.0,11.0,Male,0.0,0.0,0.0,"[3, 'block 1 (G first)']",1,1,0,1.0,1.0,-0.8166666666666667,0.19047619047619047,0.29411764705882354,0.25,0.4,1,0.25,0.25,Design 2,Design 2,Only trade on Design #1,5.0,5.0,5.0
2373,5567,3,Player object (1709),buy,2023-03-10 14:32:44.743515+00:00,"{""priceA"": 115, ""sharesA"": 1, ""secs_since_round_starts"": 136, ""market"": ""A""}",25.0,24.0,16.0,s1qm3487,t7od4xlw,FULL STUDY,185.0,s3,1,115,115.0,-1,,3,sell,0,sell,0.5319650978870379,19,0,0,block 1 (G first),19.0,11.0,Male,0.0,0.0,0.0,"[3, 'block 1 (G first)']",1,1,0,1.0,1.0,-0.8166666666666667,0.19047619047619047,0.29411764705882354,0.25,0.4,1,0.25,0.25,Design 2,Design 2,Only trade on Design #1,5.0,5.0,5.0
2374,5574,3,Player object (1709),sell,2023-03-10 14:33:08.770676+00:00,"{""priceA"": 115, ""sharesA"": 0, ""secs_since_round_starts"": 160, ""market"": ""A""}",140.0,29.0,19.0,s1qm3487,t7od4xlw,FULL STUDY,185.0,s3,1,115,115.0,1,0.0,1,buy,0,sell,0.5511004178331719,19,0,0,block 1 (G first),19.0,11.0,Male,0.0,0.0,0.0,"[3, 'block 1 (G first)']",1,1,0,1.0,1.0,-0.8166666666666667,0.19047619047619047,0.29411764705882354,0.25,0.4,1,0.25,0.25,Design 2,Design 2,Only trade on Design #1,5.0,5.0,5.0
2375,5575,3,Player object (1709),buy,2023-03-10 14:33:15.578517+00:00,"{""priceA"": 120, ""sharesA"": 1, ""secs_since_round_starts"": 167, ""market"": ""A""}",20.0,30.0,20.0,s1qm3487,t7od4xlw,FULL STUDY,185.0,s3,1,120,115.0,-1,,1,sell,0,sell,0.570054331362491,19,0,1,block 1 (G first),19.0,11.0,Male,0.0,0.0,0.0,"[3, 'block 1 (G first)']",1,1,0,1.0,1.0,-0.8166666666666667,0.19047619047619047,0.29411764705882354,0.25,0.4,1,0.25,0.25,Design 2,Design 2,Only trade on Design #1,5.0,5.0,5.0
2376,5581,3,Player object (1709),sell,2023-03-10 14:33:43.224347+00:00,"{""priceA"": 110, ""sharesA"": 0, ""secs_since_round_starts"": 194, ""market"": ""A""}",130.0,34.0,22.0,s1qm3487,t7od4xlw,FULL STUDY,185.0,s3,1,110,100.0,1,10.0,1,buy,0,sell,0.4983651933170437,19,0,0,block 1 (G first),19.0,11.0,Male,0.0,0.0,0.0,"[3, 'block 1 (G first)']",1,1,0,1.0,1.0,-0.8166666666666667,0.19047619047619047,0.29411764705882354,0.25,0.4,1,0.25,0.25,Design 2,Design 2,Only trade on Design #1,5.0,5.0,5.0
2377,5582,3,Player object (1709),buy,2023-03-10 14:33:48.724607+00:00,"{""priceA"": 105, ""sharesA"": 1, ""secs_since_round_starts"": 200, ""market"": ""A""}",25.0,35.0,23.0,s1qm3487,t7od4xlw,FULL STUDY,185.0,s3,1,105,110.0,-1,,1,sell,0,sell,0.463867449269012,19,0,0,block 1 (G first),19.0,11.0,Male,0.0,0.0,0.0,"[3, 'block 1 (G first)']",1,1,0,1.0,1.0,-0.8166666666666667,0.19047619047619047,0.29411764705882354,0.25,0.4,1,0.25,0.25,Design 2,Design 2,Only trade on Design #1,5.0,5.0,5.0
2378,5584,3,Player object (1709),sell,2023-03-10 14:34:00.402981+00:00,"{""priceA"": 95, ""sharesA"": 0, ""secs_since_round_starts"": 211, ""market"": ""A""}",120.0,37.0,24.0,s1qm3487,t7od4xlw,FULL STUDY,185.0,s3,1,95,105.0,1,-10.0,1,buy,0,sell,0.4240076400585448,19,1,0,block 1 (G first),19.0,11.0,Male,0.0,0.0,0.0,"[3, 'block 1 (G first)']",1,1,0,1.0,1.0,-0.8166666666666667,0.19047619047619047,0.29411764705882354,0.25,0.4,1,0.25,0.25,Design 2,Design 2,Only trade on Design #1,5.0,5.0,5.0
2379,5585,3,Player object (1709),buy,2023-03-10 14:34:06.210685+00:00,"{""priceA"": 100, ""sharesA"": 1, ""secs_since_round_starts"": 217, ""market"": ""A""}",20.0,38.0,25.0,s1qm3487,t7od4xlw,FULL STUDY,185.0,s3,1,100,95.0,-1,,1,sell,0,sell,0.4815245494229145,19,0,0,block 1 (G first),19.0,11.0,Male,0.0,0.0,0.0,"[3, 'block 1 (G first)']",1,1,0,1.0,1.0,-0.8166666666666667,0.19047619047619047,0.29411764705882354,0.25,0.4,1,0.25,0.25,Design 2,Design 2,Only trade on Design #1,5.0,5.0,5.0
2380,5587,3,Player object (1709),sell,2023-03-10 14:34:15.618570+00:00,"{""priceA"": 115, ""sharesA"": 0, ""secs_since_round_starts"": 227, ""market"": ""A""}",135.0,39.0,26.0,s1qm3487,t7od4xlw,FULL STUDY,185.0,s3,1,115,100.0,1,15.0,1,buy,0,sell,0.5221490272476892,19,0,0,block 1 (G first),19.0,11.0,Male,0.0,0.0,0.0,"[3, 'block 1 (G first)']",1,1,0,1.0,1.0,-0.8166666666666667,0.19047619047619047,0.29411764705882354,0.25,0.4,1,0.25,0.25,Design 2,Design 2,Only trade on Design #1,5.0,5.0,5.0
2381,5588,3,Player object (1709),buy,2023-03-10 14:34:21.336339+00:00,"{""priceA"": 100, ""sharesA"": 1, ""secs_since_round_starts"": 232, ""market"": ""A""}",35.0,40.0,27.0,s1qm3487,t7od4xlw,FULL STUDY,185.0,s3,1,100,115.0,-1,,1,sell,0,sell,0.4804175727303482,19,0,0,block 1 (G first),19.0,11.0,Male,0.0,0.0,0.0,"[3, 'block 1 (G first)']",1,1,0,1.0,1.0,-0.8166666666666667,0.19047619047619047,0.29411764705882354,0.25,0.4,1,0.25,0.25,Design 2,Design 2,Only trade on Design #1,5.0,5.0,5.0
2382,5598,3,Player object (1709),sell,2023-03-10 14:34:47.184486+00:00,"{""priceA"": 135, ""sharesA"": 0, ""secs_since_round_starts"": 258, ""market"": ""A""}",170.0,44.0,31.0,s1qm3487,t7od4xlw,FULL STUDY,185.0,s3,1,135,120.0,1,15.0,1,buy,0,sell,0.5595824488336746,19,0,1,block 1 (G first),19.0,11.0,Male,0.0,0.0,0.0,"[3, 'block 1 (G first)']",1,1,0,1.0,1.0,-0.8166666666666667,0.19047619047619047,0.29411764705882354,0.25,0.4,1,0.25,0.25,Design 2,Design 2,Only trade on Design #1,5.0,5.0,5.0
2383,5600,3,Player object (1709),buy,2023-03-10 14:34:55.476218+00:00,"{""priceA"": 125, ""sharesA"": 1, ""secs_since_round_starts"": 266, ""market"": ""A""}",45.0,45.0,32.0,s1qm3487,t7od4xlw,FULL STUDY,185.0,s3,1,125,135.0,-1,,1,sell,0,sell,0.5067886105922249,19,0,0,block 1 (G first),19.0,11.0,Male,0.0,0.0,0.0,"[3, 'block 1 (G first)']",1,1,0,1.0,1.0,-0.8166666666666667,0.19047619047619047,0.29411764705882354,0.25,0.4,1,0.25,0.25,Design 2,Design 2,Only trade on Design #1,5.0,5.0,5.0
2384,5601,3,Player object (1709),sell,2023-03-10 14:34:58.015386+00:00,"{""priceA"": 135, ""sharesA"": 0, ""secs_since_round_starts"": 269, ""market"": ""A""}",180.0,46.0,33.0,s1qm3487,t7od4xlw,FULL STUDY,185.0,s3,1,135,125.0,1,10.0,1,buy,0,sell,0.5396981283875847,19,0,0,block 1 (G first),19.0,11.0,Male,0.0,0.0,0.0,"[3, 'block 1 (G first)']",1,1,0,1.0,1.0,-0.8166666666666667,0.19047619047619047,0.29411764705882354,0.25,0.4,1,0.25,0.25,Design 2,Design 2,Only trade on Design #1,5.0,5.0,5.0
2385,5602,3,Player object (1709),buy,2023-03-10 14:35:05.613768+00:00,"{""priceA"": 130, ""sharesA"": 1, ""secs_since_round_starts"": 276, ""market"": ""A""}",50.0,47.0,34.0,s1qm3487,t7od4xlw,FULL STUDY,185.0,s3,1,130,135.0,-1,,1,sell,0,sell,0.4927309765460438,19,0,0,block 1 (G first),19.0,11.0,Male,0.0,0.0,0.0,"[3, 'block 1 (G first)']",1,1,0,1.0,1.0,-0.8166666666666667,0.19047619047619047,0.29411764705882354,0.25,0.4,1,0.25,0.25,Design 2,Design 2,Only trade on Design #1,5.0,5.0,5.0
2386,5605,3,Player object (1709),sell,2023-03-10 14:35:20.888222+00:00,"{""priceA"": 125, ""sharesA"": 0, ""secs_since_round_starts"": 292, ""market"": ""A""}",175.0,50.0,36.0,s1qm3487,t7od4xlw,FULL STUDY,185.0,s3,1,125,125.0,1,0.0,1,buy,0,sell,0.4911246412164243,19,0,0,block 1 (G first),19.0,11.0,Male,0.0,0.0,0.0,"[3, 'block 1 (G first)']",1,1,0,1.0,1.0,-0.8166666666666667,0.19047619047619047,0.29411764705882354,0.25,0.4,1,0.25,0.25,Design 2,Design 2,Only trade on Design #1,5.0,5.0,5.0
2387,5606,3,Player object (1709),buy,2023-03-10 14:35:26.338442+00:00,"{""priceA"": 120, ""sharesA"": 1, ""secs_since_round_starts"": 297, ""market"": ""A""}",55.0,51.0,37.0,s1qm3487,t7od4xlw,FULL STUDY,185.0,s3,1,120,125.0,-1,,1,sell,0,sell,0.4588602748157505,19,0,0,block 1 (G first),19.0,11.0,Male,0.0,0.0,0.0,"[3, 'block 1 (G first)']",1,1,0,1.0,1.0,-0.8166666666666667,0.19047619047619047,0.29411764705882354,0.25,0.4,1,0.25,0.25,Design 2,Design 2,Only trade on Design #1,5.0,5.0,5.0
2388,5610,3,Player object (1709),sell,2023-03-10 14:35:36.867122+00:00,"{""priceA"": 130, ""sharesA"": 0, ""secs_since_round_starts"": 308, ""market"": ""A""}",185.0,53.0,39.0,s1qm3487,t7od4xlw,FULL STUDY,185.0,s3,1,130,115.0,1,15.0,1,buy,0,sell,0.4905868559773416,19,0,0,block 1 (G first),19.0,11.0,Male,0.0,0.0,0.0,"[3, 'block 1 (G first)']",1,1,0,1.0,1.0,-0.8166666666666667,0.19047619047619047,0.29411764705882354,0.25,0.4,1,0.25,0.25,Design 2,Design 2,Only trade on Design #1,5.0,5.0,5.0
2389,5617,3,Player object (1709),buy,2023-03-10 14:36:04.758304+00:00,"{""priceA"": 115, ""sharesA"": 1, ""secs_since_round_starts"": 336, ""market"": ""A""}",70.0,58.0,42.0,s1qm3487,t7od4xlw,FULL STUDY,185.0,s3,1,115,130.0,-1,,1,sell,0,sell,0.442461876115205,19,1,0,block 1 (G first),19.0,11.0,Male,0.0,0.0,0.0,"[3, 'block 1 (G first)']",1,1,0,1.0,1.0,-0.8166666666666667,0.19047619047619047,0.29411764705882354,0.25,0.4,1,0.25,0.25,Design 2,Design 2,Only trade on Design #1,5.0,5.0,5.0
2390,5621,3,Player object (1709),sell,2023-03-10 14:36:16.768165+00:00,"{""priceA"": 115, ""sharesA"": 0, ""secs_since_round_starts"": 348, ""market"": ""A""}",185.0,60.0,44.0,s1qm3487,t7od4xlw,FULL STUDY,185.0,s3,1,115,125.0,1,-10.0,1,buy,0,sell,0.4613046310449969,19,0,0,block 1 (G first),19.0,11.0,Male,0.0,0.0,0.0,"[3, 'block 1 (G first)']",1,1,0,1.0,1.0,-0.8166666666666667,0.19047619047619047,0.29411764705882354,0.25,0.4,1,0.25,0.25,Design 2,Design 2,Only trade on Design #1,5.0,5.0,5.0
2391,5627,4,Player object (1889),sell,2023-03-10 14:36:52.476836+00:00,"{""priceA"": 45, ""sharesA"": 0, ""secs_since_round_starts"": 30, ""market"": ""A""}",95.0,7.0,1.0,s1qm3487,t7od4xlw,FULL STUDY,105.0,s3,1,45,,1,,1,,0,sell,0.4686531252667821,14,0,0,block 1 (G first),19.0,11.0,Male,0.0,0.0,0.0,"[4, 'block 1 (G first)']",0,0,0,0.5,1.0,-0.8166666666666667,0.625,0.14285714285714285,1.0,0.0,1,0.75,1.0,Design 2,Design 2,Only trade on Design #1,5.0,5.0,5.0
2392,5630,4,Player object (1889),buy,2023-03-10 14:37:25.010465+00:00,"{""priceA"": 75, ""sharesA"": 1, ""secs_since_round_starts"": 62, ""market"": ""A""}",20.0,13.0,2.0,s1qm3487,t7od4xlw,FULL STUDY,105.0,s3,1,75,45.0,-1,,1,sell,0,sell,0.479681559969247,14,0,0,block 1 (G first),19.0,11.0,Male,0.0,0.0,0.0,"[4, 'block 1 (G first)']",0,0,0,0.5,1.0,-0.8166666666666667,0.625,0.14285714285714285,1.0,0.0,1,0.75,1.0,Design 2,Design 2,Only trade on Design #1,5.0,5.0,5.0
2393,5631,4,Player object (1889),sell,2023-03-10 14:37:30.810827+00:00,"{""priceA"": 90, ""sharesA"": 0, ""secs_since_round_starts"": 68, ""market"": ""A""}",110.0,14.0,3.0,s1qm3487,t7od4xlw,FULL STUDY,105.0,s3,1,90,75.0,1,15.0,1,buy,0,sell,0.5208618681016636,14,0,0,block 1 (G first),19.0,11.0,Male,0.0,0.0,0.0,"[4, 'block 1 (G first)']",0,0,0,0.5,1.0,-0.8166666666666667,0.625,0.14285714285714285,1.0,0.0,1,0.75,1.0,Design 2,Design 2,Only trade on Design #1,5.0,5.0,5.0
2394,5632,4,Player object (1889),buy,2023-03-10 14:37:36.080314+00:00,"{""priceA"": 95, ""sharesA"": 1, ""secs_since_round_starts"": 73, ""market"": ""A""}",15.0,15.0,4.0,s1qm3487,t7od4xlw,FULL STUDY,105.0,s3,1,95,90.0,-1,,1,sell,0,sell,0.5493972040799432,14,0,0,block 1 (G first),19.0,11.0,Male,0.0,0.0,0.0,"[4, 'block 1 (G first)']",0,0,0,0.5,1.0,-0.8166666666666667,0.625,0.14285714285714285,1.0,0.0,1,0.75,1.0,Design 2,Design 2,Only trade on Design #1,5.0,5.0,5.0
2395,5640,4,Player object (1889),sell,2023-03-10 14:38:21.844487+00:00,"{""priceA"": 65, ""sharesA"": 0, ""secs_since_round_starts"": 119, ""market"": ""A""}",80.0,23.0,8.0,s1qm3487,t7od4xlw,FULL STUDY,105.0,s3,1,65,85.0,1,-20.0,1,buy,0,sell,0.4803954371098747,14,0,0,block 1 (G first),19.0,11.0,Male,0.0,0.0,0.0,"[4, 'block 1 (G first)']",0,0,0,0.5,1.0,-0.8166666666666667,0.625,0.14285714285714285,1.0,0.0,1,0.75,1.0,Design 2,Design 2,Only trade on Design #1,5.0,5.0,5.0
2396,5642,4,Player object (1889),buy,2023-03-10 14:38:26.952349+00:00,"{""priceA"": 55, ""sharesA"": 1, ""secs_since_round_starts"": 124, ""market"": ""A""}",25.0,24.0,9.0,s1qm3487,t7od4xlw,FULL STUDY,105.0,s3,1,55,65.0,-1,,1,sell,0,sell,0.4514670992379582,14,0,0,block 1 (G first),19.0,11.0,Male,0.0,0.0,0.0,"[4, 'block 1 (G first)']",0,0,0,0.5,1.0,-0.8166666666666667,0.625,0.14285714285714285,1.0,0.0,1,0.75,1.0,Design 2,Design 2,Only trade on Design #1,5.0,5.0,5.0
2397,5644,4,Player object (1889),sell,2023-03-10 14:38:36.651807+00:00,"{""priceA"": 55, ""sharesA"": 0, ""secs_since_round_starts"": 134, ""market"": ""A""}",80.0,26.0,10.0,s1qm3487,t7od4xlw,FULL STUDY,105.0,s3,1,55,55.0,1,0.0,1,buy,0,sell,0.4870054870256314,14,0,0,block 1 (G first),19.0,11.0,Male,0.0,0.0,0.0,"[4, 'block 1 (G first)']",0,0,0,0.5,1.0,-0.8166666666666667,0.625,0.14285714285714285,1.0,0.0,1,0.75,1.0,Design 2,Design 2,Only trade on Design #1,5.0,5.0,5.0
2398,5645,4,Player object (1889),buy,2023-03-10 14:38:53.560679+00:00,"{""priceA"": 90, ""sharesA"": 1, ""secs_since_round_starts"": 151, ""market"": ""A""}",-10.0,29.0,11.0,s1qm3487,t7od4xlw,FULL STUDY,105.0,s3,1,90,55.0,-1,,1,sell,0,sell,0.5712793841154561,14,0,0,block 1 (G first),19.0,11.0,Male,0.0,0.0,0.0,"[4, 'block 1 (G first)']",0,0,0,0.5,1.0,-0.8166666666666667,0.625,0.14285714285714285,1.0,0.0,1,0.75,1.0,Design 2,Design 2,Only trade on Design #1,5.0,5.0,5.0
2399,5649,4,Player object (1889),sell,2023-03-10 14:39:25.048810+00:00,"{""priceA"": 100, ""sharesA"": 0, ""secs_since_round_starts"": 182, ""market"": ""A""}",90.0,33.0,12.0,s1qm3487,t7od4xlw,FULL STUDY,105.0,s3,1,100,90.0,1,10.0,1,buy,0,sell,0.5473882863317556,14,0,0,block 1 (G first),19.0,11.0,Male,0.0,0.0,0.0,"[4, 'block 1 (G first)']",0,0,0,0.5,1.0,-0.8166666666666667,0.625,0.14285714285714285,1.0,0.0,1,0.75,1.0,Design 2,Design 2,Only trade on Design #1,5.0,5.0,5.0
2400,5650,4,Player object (1889),buy,2023-03-10 14:39:33.691711+00:00,"{""priceA"": 95, ""sharesA"": 1, ""secs_since_round_starts"": 191, ""market"": ""A""}",-5.0,34.0,13.0,s1qm3487,t7od4xlw,FULL STUDY,105.0,s3,1,95,100.0,-1,,1,sell,0,sell,0.4981543075921684,14,0,0,block 1 (G first),19.0,11.0,Male,0.0,0.0,0.0,"[4, 'block 1 (G first)']",0,0,0,0.5,1.0,-0.8166666666666667,0.625,0.14285714285714285,1.0,0.0,1,0.75,1.0,Design 2,Design 2,Only trade on Design #1,5.0,5.0,5.0
2401,5651,4,Player object (1889),sell,2023-03-10 14:39:35.520421+00:00,"{""priceA"": 100, ""sharesA"": 0, ""secs_since_round_starts"": 193, ""market"": ""A""}",95.0,35.0,14.0,s1qm3487,t7od4xlw,FULL STUDY,105.0,s3,1,100,95.0,1,5.0,1,buy,0,sell,0.5337204628349665,14,0,0,block 1 (G first),19.0,11.0,Male,0.0,0.0,0.0,"[4, 'block 1 (G first)']",0,0,0,0.5,1.0,-0.8166666666666667,0.625,0.14285714285714285,1.0,0.0,1,0.75,1.0,Design 2,Design 2,Only trade on Design #1,5.0,5.0,5.0
2402,5652,4,Player object (1889),buy,2023-03-10 14:39:40.959092+00:00,"{""priceA"": 85, ""sharesA"": 1, ""secs_since_round_starts"": 198, ""market"": ""A""}",10.0,36.0,15.0,s1qm3487,t7od4xlw,FULL STUDY,105.0,s3,1,85,100.0,-1,,1,sell,0,sell,0.4885269486642424,14,0,0,block 1 (G first),19.0,11.0,Male,0.0,0.0,0.0,"[4, 'block 1 (G first)']",0,0,0,0.5,1.0,-0.8166666666666667,0.625,0.14285714285714285,1.0,0.0,1,0.75,1.0,Design 2,Design 2,Only trade on Design #1,5.0,5.0,5.0
2403,5654,4,Player object (1889),sell,2023-03-10 14:40:17.543453+00:00,"{""priceA"": 95, ""sharesA"": 0, ""secs_since_round_starts"": 235, ""market"": ""A""}",105.0,42.0,16.0,s1qm3487,t7od4xlw,FULL STUDY,105.0,s3,1,95,85.0,1,10.0,1,buy,0,sell,0.5388552795609507,14,0,0,block 1 (G first),19.0,11.0,Male,0.0,0.0,0.0,"[4, 'block 1 (G first)']",0,0,0,0.5,1.0,-0.8166666666666667,0.625,0.14285714285714285,1.0,0.0,1,0.75,1.0,Design 2,Design 2,Only trade on Design #1,5.0,5.0,5.0
2404,5656,4,Player object (1889),buy,2023-03-10 14:40:27.425015+00:00,"{""priceA"": 115, ""sharesA"": 1, ""secs_since_round_starts"": 244, ""market"": ""A""}",-10.0,44.0,17.0,s1qm3487,t7od4xlw,FULL STUDY,105.0,s3,1,115,95.0,-1,,1,sell,0,sell,0.5772497941838325,14,0,0,block 1 (G first),19.0,11.0,Male,0.0,0.0,0.0,"[4, 'block 1 (G first)']",0,0,0,0.5,1.0,-0.8166666666666667,0.625,0.14285714285714285,1.0,0.0,1,0.75,1.0,Design 2,Design 2,Only trade on Design #1,5.0,5.0,5.0
2405,5657,4,Player object (1889),sell,2023-03-10 14:40:39.452434+00:00,"{""priceA"": 95, ""sharesA"": 0, ""secs_since_round_starts"": 256, ""market"": ""A""}",85.0,46.0,18.0,s1qm3487,t7od4xlw,FULL STUDY,105.0,s3,1,95,115.0,1,-20.0,1,buy,0,sell,0.4784785382548627,14,0,0,block 1 (G first),19.0,11.0,Male,0.0,0.0,0.0,"[4, 'block 1 (G first)']",0,0,0,0.5,1.0,-0.8166666666666667,0.625,0.14285714285714285,1.0,0.0,1,0.75,1.0,Design 2,Design 2,Only trade on Design #1,5.0,5.0,5.0
2406,5660,4,Player object (1889),buy,2023-03-10 14:41:40.094420+00:00,"{""priceA"": 55, ""sharesA"": 1, ""secs_since_round_starts"": 317, ""market"": ""A""}",30.0,57.0,19.0,s1qm3487,t7od4xlw,FULL STUDY,105.0,s3,1,55,95.0,-1,,1,sell,0,sell,0.4231688687101841,14,1,0,block 1 (G first),19.0,11.0,Male,0.0,0.0,0.0,"[4, 'block 1 (G first)']",0,0,0,0.5,1.0,-0.8166666666666667,0.625,0.14285714285714285,1.0,0.0,1,0.75,1.0,Design 2,Design 2,Only trade on Design #1,5.0,5.0,5.0
2407,5663,4,Player object (1889),sell,2023-03-10 14:41:53.096582+00:00,"{""priceA"": 75, ""sharesA"": 0, ""secs_since_round_starts"": 330, ""market"": ""A""}",105.0,60.0,21.0,s1qm3487,t7od4xlw,FULL STUDY,105.0,s3,1,75,70.0,1,5.0,1,buy,0,sell,0.5499940505093152,14,0,1,block 1 (G first),19.0,11.0,Male,0.0,0.0,0.0,"[4, 'block 1 (G first)']",0,0,0,0.5,1.0,-0.8166666666666667,0.625,0.14285714285714285,1.0,0.0,1,0.75,1.0,Design 2,Design 2,Only trade on Design #1,5.0,5.0,5.0
2408,5667,5,Player object (2069),sell,2023-03-10 14:42:35.635950+00:00,"{""priceA"": 100, ""sharesA"": 0, ""secs_since_round_starts"": 35, ""market"": ""A""}",150.0,7.0,1.0,s1qm3487,t7od4xlw,FULL STUDY,100.0,s3,1,100,,1,,1,,0,sell,0.5733994727268583,17,0,0,block 1 (G first),19.0,11.0,Male,0.0,0.0,0.0,"[5, 'block 1 (G first)']",0,1,0,0.5,1.0,-0.8166666666666667,0.6666666666666666,0.0,,0.0,1,0.75,1.0,Design 2,Design 2,Only trade on Design #1,5.0,5.0,5.0
2409,5668,5,Player object (2069),buy,2023-03-10 14:42:41.008349+00:00,"{""priceA"": 90, ""sharesA"": 1, ""secs_since_round_starts"": 40, ""market"": ""A""}",60.0,8.0,2.0,s1qm3487,t7od4xlw,FULL STUDY,100.0,s3,1,90,100.0,-1,,1,sell,0,sell,0.5166236645513725,17,0,0,block 1 (G first),19.0,11.0,Male,0.0,0.0,0.0,"[5, 'block 1 (G first)']",0,1,0,0.5,1.0,-0.8166666666666667,0.6666666666666666,0.0,,0.0,1,0.75,1.0,Design 2,Design 2,Only trade on Design #1,5.0,5.0,5.0
2410,5675,5,Player object (2069),sell,2023-03-10 14:43:44.536407+00:00,"{""priceA"": 95, ""sharesA"": 0, ""secs_since_round_starts"": 104, ""market"": ""A""}",155.0,20.0,6.0,s1qm3487,t7od4xlw,FULL STUDY,100.0,s3,1,95,90.0,1,5.0,1,buy,0,sell,0.5232479875730728,17,0,0,block 1 (G first),19.0,11.0,Male,0.0,0.0,0.0,"[5, 'block 1 (G first)']",0,1,0,0.5,1.0,-0.8166666666666667,0.6666666666666666,0.0,,0.0,1,0.75,1.0,Design 2,Design 2,Only trade on Design #1,5.0,5.0,5.0
2411,5676,5,Player object (2069),buy,2023-03-10 14:43:49.916412+00:00,"{""priceA"": 105, ""sharesA"": 1, ""secs_since_round_starts"": 109, ""market"": ""A""}",50.0,21.0,7.0,s1qm3487,t7od4xlw,FULL STUDY,100.0,s3,1,105,95.0,-1,,1,sell,0,sell,0.5510362930796925,17,0,1,block 1 (G first),19.0,11.0,Male,0.0,0.0,0.0,"[5, 'block 1 (G first)']",0,1,0,0.5,1.0,-0.8166666666666667,0.6666666666666666,0.0,,0.0,1,0.75,1.0,Design 2,Design 2,Only trade on Design #1,5.0,5.0,5.0
2412,5677,5,Player object (2069),sell,2023-03-10 14:44:07.971632+00:00,"{""priceA"": 105, ""sharesA"": 0, ""secs_since_round_starts"": 127, ""market"": ""A""}",155.0,24.0,8.0,s1qm3487,t7od4xlw,FULL STUDY,100.0,s3,1,105,105.0,1,0.0,1,buy,0,sell,0.5594334008058068,17,0,0,block 1 (G first),19.0,11.0,Male,0.0,0.0,0.0,"[5, 'block 1 (G first)']",0,1,0,0.5,1.0,-0.8166666666666667,0.6666666666666666,0.0,,0.0,1,0.75,1.0,Design 2,Design 2,Only trade on Design #1,5.0,5.0,5.0
2413,5678,5,Player object (2069),buy,2023-03-10 14:44:12.398775+00:00,"{""priceA"": 115, ""sharesA"": 1, ""secs_since_round_starts"": 132, ""market"": ""A""}",40.0,25.0,9.0,s1qm3487,t7od4xlw,FULL STUDY,100.0,s3,1,115,105.0,-1,,1,sell,0,sell,0.5757035170695836,17,0,1,block 1 (G first),19.0,11.0,Male,0.0,0.0,0.0,"[5, 'block 1 (G first)']",0,1,0,0.5,1.0,-0.8166666666666667,0.6666666666666666,0.0,,0.0,1,0.75,1.0,Design 2,Design 2,Only trade on Design #1,5.0,5.0,5.0
2414,5680,5,Player object (2069),sell,2023-03-10 14:45:02.797070+00:00,"{""priceA"": 120, ""sharesA"": 0, ""secs_since_round_starts"": 182, ""market"": ""A""}",160.0,34.0,10.0,s1qm3487,t7od4xlw,FULL STUDY,100.0,s3,1,120,115.0,1,5.0,1,buy,0,sell,0.5679672812132522,17,0,0,block 1 (G first),19.0,11.0,Male,0.0,0.0,0.0,"[5, 'block 1 (G first)']",0,1,0,0.5,1.0,-0.8166666666666667,0.6666666666666666,0.0,,0.0,1,0.75,1.0,Design 2,Design 2,Only trade on Design #1,5.0,5.0,5.0
2415,5681,5,Player object (2069),buy,2023-03-10 14:45:08.271742+00:00,"{""priceA"": 125, ""sharesA"": 1, ""secs_since_round_starts"": 188, ""market"": ""A""}",35.0,35.0,11.0,s1qm3487,t7od4xlw,FULL STUDY,100.0,s3,1,125,120.0,-1,,1,sell,0,sell,0.5814696428244381,17,0,0,block 1 (G first),19.0,11.0,Male,0.0,0.0,0.0,"[5, 'block 1 (G first)']",0,1,0,0.5,1.0,-0.8166666666666667,0.6666666666666666,0.0,,0.0,1,0.75,1.0,Design 2,Design 2,Only trade on Design #1,5.0,5.0,5.0
2416,4747,2,Player object (960),sell,2023-03-10 03:55:44.080682+00:00,"{""priceA"": 105, ""sharesA"": 0, ""secs_since_round_starts"": 78, ""market"": ""A""}",155.0,8.0,1.0,sxogauy0,vmu7c279,FULL STUDY,180.0,s4,1,105,,1,,1,,0,sell,0.5,0,0,0,block 4 (G second),19.0,12.0,Female,1.0,0.0,1.0,"[2, 'block 4 (G second)']",0,1,1,0.0,3.0,-0.7,0.3,0.1,0.5,0.25,3,1.0,0.25,Design 2,Design 1,"Have an option between Design #1 and Design #2,",4.0,,
2417,4748,2,Player object (960),buy,2023-03-10 03:55:49.306199+00:00,"{""priceA"": 90, ""sharesA"": 1, ""secs_since_round_starts"": 84, ""market"": ""A""}",65.0,9.0,2.0,sxogauy0,vmu7c279,FULL STUDY,180.0,s4,1,90,105.0,-1,,1,sell,0,sell,0.5,0,0,0,block 4 (G second),19.0,12.0,Female,1.0,0.0,1.0,"[2, 'block 4 (G second)']",0,1,1,0.0,3.0,-0.7,0.3,0.1,0.5,0.25,3,1.0,0.25,Design 2,Design 1,"Have an option between Design #1 and Design #2,",4.0,,
2418,4749,2,Player object (960),sell,2023-03-10 03:55:56.967989+00:00,"{""priceA"": 85, ""sharesA"": 0, ""secs_since_round_starts"": 91, ""market"": ""A""}",150.0,11.0,3.0,sxogauy0,vmu7c279,FULL STUDY,180.0,s4,1,85,90.0,1,-5.0,1,buy,0,sell,0.5,0,0,0,block 4 (G second),19.0,12.0,Female,1.0,0.0,1.0,"[2, 'block 4 (G second)']",0,1,1,0.0,3.0,-0.7,0.3,0.1,0.5,0.25,3,1.0,0.25,Design 2,Design 1,"Have an option between Design #1 and Design #2,",4.0,,
2419,4750,2,Player object (960),buy,2023-03-10 03:56:14.814738+00:00,"{""priceA"": 70, ""sharesA"": 1, ""secs_since_round_starts"": 109, ""market"": ""A""}",80.0,14.0,4.0,sxogauy0,vmu7c279,FULL STUDY,180.0,s4,1,70,85.0,-1,,1,sell,0,sell,0.5,0,0,0,block 4 (G second),19.0,12.0,Female,1.0,0.0,1.0,"[2, 'block 4 (G second)']",0,1,1,0.0,3.0,-0.7,0.3,0.1,0.5,0.25,3,1.0,0.25,Design 2,Design 1,"Have an option between Design #1 and Design #2,",4.0,,
2420,4751,2,Player object (960),sell,2023-03-10 03:57:07.379003+00:00,"{""priceA"": 85, ""sharesA"": 0, ""secs_since_round_starts"": 162, ""market"": ""A""}",165.0,24.0,5.0,sxogauy0,vmu7c279,FULL STUDY,180.0,s4,1,85,70.0,1,15.0,1,buy,0,sell,0.5,0,0,0,block 4 (G second),19.0,12.0,Female,1.0,0.0,1.0,"[2, 'block 4 (G second)']",0,1,1,0.0,3.0,-0.7,0.3,0.1,0.5,0.25,3,1.0,0.25,Design 2,Design 1,"Have an option between Design #1 and Design #2,",4.0,,
2421,4753,2,Player object (960),buy,2023-03-10 03:58:14.567293+00:00,"{""priceA"": 75, ""sharesA"": 1, ""secs_since_round_starts"": 229, ""market"": ""A""}",90.0,34.0,6.0,sxogauy0,vmu7c279,FULL STUDY,180.0,s4,1,75,85.0,-1,,1,sell,0,sell,0.5,0,1,0,block 4 (G second),19.0,12.0,Female,1.0,0.0,1.0,"[2, 'block 4 (G second)']",0,1,1,0.0,3.0,-0.7,0.3,0.1,0.5,0.25,3,1.0,0.25,Design 2,Design 1,"Have an option between Design #1 and Design #2,",4.0,,
2422,4756,2,Player object (960),sell,2023-03-10 03:59:37.317511+00:00,"{""priceA"": 65, ""sharesA"": 0, ""secs_since_round_starts"": 312, ""market"": ""A""}",155.0,49.0,8.0,sxogauy0,vmu7c279,FULL STUDY,180.0,s4,1,65,45.0,1,20.0,1,buy,0,sell,0.5,0,0,1,block 4 (G second),19.0,12.0,Female,1.0,0.0,1.0,"[2, 'block 4 (G second)']",0,1,1,0.0,3.0,-0.7,0.3,0.1,0.5,0.25,3,1.0,0.25,Design 2,Design 1,"Have an option between Design #1 and Design #2,",4.0,,
2423,4757,2,Player object (960),buy,2023-03-10 04:00:16.284685+00:00,"{""priceA"": 85, ""sharesA"": 1, ""secs_since_round_starts"": 350, ""market"": ""A""}",70.0,56.0,9.0,sxogauy0,vmu7c279,FULL STUDY,180.0,s4,1,85,65.0,-1,,1,sell,0,sell,0.5,0,0,0,block 4 (G second),19.0,12.0,Female,1.0,0.0,1.0,"[2, 'block 4 (G second)']",0,1,1,0.0,3.0,-0.7,0.3,0.1,0.5,0.25,3,1.0,0.25,Design 2,Design 1,"Have an option between Design #1 and Design #2,",4.0,,
2424,4758,2,Player object (960),sell,2023-03-10 04:00:28.487959+00:00,"{""priceA"": 110, ""sharesA"": 0, ""secs_since_round_starts"": 363, ""market"": ""A""}",180.0,58.0,10.0,sxogauy0,vmu7c279,FULL STUDY,180.0,s4,1,110,85.0,1,25.0,1,buy,0,sell,0.5,0,0,1,block 4 (G second),19.0,12.0,Female,1.0,0.0,1.0,"[2, 'block 4 (G second)']",0,1,1,0.0,3.0,-0.7,0.3,0.1,0.5,0.25,3,1.0,0.25,Design 2,Design 1,"Have an option between Design #1 and Design #2,",4.0,,
2425,4762,3,Player object (1080),sell,2023-03-10 04:03:49.537426+00:00,"{""priceA"": 120, ""sharesA"": 0, ""secs_since_round_starts"": 184, ""market"": ""A""}",170.0,8.0,1.0,sxogauy0,vmu7c279,FULL STUDY,245.0,s4,1,120,,1,,1,,0,sell,0.5,0,0,0,block 4 (G second),19.0,12.0,Female,1.0,0.0,1.0,"[3, 'block 4 (G second)']",0,0,1,0.0,3.0,-0.7,0.5333333333333333,0.058823529411764705,0.5,0.0,4,0.75,0.25,Design 2,Design 1,"Have an option between Design #1 and Design #2,",4.0,,
2426,4763,3,Player object (1080),buy,2023-03-10 04:04:28.770819+00:00,"{""priceA"": 145, ""sharesA"": 1, ""secs_since_round_starts"": 223, ""market"": ""A""}",25.0,15.0,2.0,sxogauy0,vmu7c279,FULL STUDY,245.0,s4,1,145,120.0,-1,,1,sell,0,sell,0.5,0,0,0,block 4 (G second),19.0,12.0,Female,1.0,0.0,1.0,"[3, 'block 4 (G second)']",0,0,1,0.0,3.0,-0.7,0.5333333333333333,0.058823529411764705,0.5,0.0,4,0.75,0.25,Design 2,Design 1,"Have an option between Design #1 and Design #2,",4.0,,
2427,4764,3,Player object (1080),sell,2023-03-10 04:04:38.418293+00:00,"{""priceA"": 155, ""sharesA"": 0, ""secs_since_round_starts"": 233, ""market"": ""A""}",180.0,17.0,3.0,sxogauy0,vmu7c279,FULL STUDY,245.0,s4,1,155,145.0,1,10.0,1,buy,0,sell,0.5,0,0,0,block 4 (G second),19.0,12.0,Female,1.0,0.0,1.0,"[3, 'block 4 (G second)']",0,0,1,0.0,3.0,-0.7,0.5333333333333333,0.058823529411764705,0.5,0.0,4,0.75,0.25,Design 2,Design 1,"Have an option between Design #1 and Design #2,",4.0,,
2428,4765,3,Player object (1080),buy,2023-03-10 04:04:56.907254+00:00,"{""priceA"": 135, ""sharesA"": 1, ""secs_since_round_starts"": 251, ""market"": ""A""}",45.0,20.0,4.0,sxogauy0,vmu7c279,FULL STUDY,245.0,s4,1,135,155.0,-1,,1,sell,0,sell,0.5,0,0,0,block 4 (G second),19.0,12.0,Female,1.0,0.0,1.0,"[3, 'block 4 (G second)']",0,0,1,0.0,3.0,-0.7,0.5333333333333333,0.058823529411764705,0.5,0.0,4,0.75,0.25,Design 2,Design 1,"Have an option between Design #1 and Design #2,",4.0,,
2429,4766,3,Player object (1080),sell,2023-03-10 04:05:16.973020+00:00,"{""priceA"": 145, ""sharesA"": 0, ""secs_since_round_starts"": 272, ""market"": ""A""}",190.0,24.0,5.0,sxogauy0,vmu7c279,FULL STUDY,245.0,s4,1,145,135.0,1,10.0,1,buy,0,sell,0.5,0,0,0,block 4 (G second),19.0,12.0,Female,1.0,0.0,1.0,"[3, 'block 4 (G second)']",0,0,1,0.0,3.0,-0.7,0.5333333333333333,0.058823529411764705,0.5,0.0,4,0.75,0.25,Design 2,Design 1,"Have an option between Design #1 and Design #2,",4.0,,
2430,4767,3,Player object (1080),buy,2023-03-10 04:05:24.404945+00:00,"{""priceA"": 155, ""sharesA"": 1, ""secs_since_round_starts"": 279, ""market"": ""A""}",35.0,25.0,6.0,sxogauy0,vmu7c279,FULL STUDY,245.0,s4,1,155,145.0,-1,,1,sell,0,sell,0.5,0,0,1,block 4 (G second),19.0,12.0,Female,1.0,0.0,1.0,"[3, 'block 4 (G second)']",0,0,1,0.0,3.0,-0.7,0.5333333333333333,0.058823529411764705,0.5,0.0,4,0.75,0.25,Design 2,Design 1,"Have an option between Design #1 and Design #2,",4.0,,
2431,4768,3,Player object (1080),sell,2023-03-10 04:05:49.720804+00:00,"{""priceA"": 175, ""sharesA"": 0, ""secs_since_round_starts"": 304, ""market"": ""A""}",210.0,30.0,7.0,sxogauy0,vmu7c279,FULL STUDY,245.0,s4,1,175,155.0,1,20.0,1,buy,0,sell,0.5,0,0,0,block 4 (G second),19.0,12.0,Female,1.0,0.0,1.0,"[3, 'block 4 (G second)']",0,0,1,0.0,3.0,-0.7,0.5333333333333333,0.058823529411764705,0.5,0.0,4,0.75,0.25,Design 2,Design 1,"Have an option between Design #1 and Design #2,",4.0,,
2432,4770,3,Player object (1080),buy,2023-03-10 04:06:16.650820+00:00,"{""priceA"": 140, ""sharesA"": 1, ""secs_since_round_starts"": 331, ""market"": ""A""}",70.0,33.0,8.0,sxogauy0,vmu7c279,FULL STUDY,245.0,s4,1,140,175.0,-1,,1,sell,0,sell,0.5,0,1,0,block 4 (G second),19.0,12.0,Female,1.0,0.0,1.0,"[3, 'block 4 (G second)']",0,0,1,0.0,3.0,-0.7,0.5333333333333333,0.058823529411764705,0.5,0.0,4,0.75,0.25,Design 2,Design 1,"Have an option between Design #1 and Design #2,",4.0,,
2433,4771,3,Player object (1080),sell,2023-03-10 04:06:29.359653+00:00,"{""priceA"": 150, ""sharesA"": 0, ""secs_since_round_starts"": 344, ""market"": ""A""}",220.0,35.0,9.0,sxogauy0,vmu7c279,FULL STUDY,245.0,s4,1,150,140.0,1,10.0,1,buy,0,sell,0.5,0,0,0,block 4 (G second),19.0,12.0,Female,1.0,0.0,1.0,"[3, 'block 4 (G second)']",0,0,1,0.0,3.0,-0.7,0.5333333333333333,0.058823529411764705,0.5,0.0,4,0.75,0.25,Design 2,Design 1,"Have an option between Design #1 and Design #2,",4.0,,
2434,4772,3,Player object (1080),buy,2023-03-10 04:06:33.130188+00:00,"{""priceA"": 155, ""sharesA"": 1, ""secs_since_round_starts"": 348, ""market"": ""A""}",65.0,36.0,10.0,sxogauy0,vmu7c279,FULL STUDY,245.0,s4,1,155,150.0,-1,,1,sell,0,sell,0.5,0,0,1,block 4 (G second),19.0,12.0,Female,1.0,0.0,1.0,"[3, 'block 4 (G second)']",0,0,1,0.0,3.0,-0.7,0.5333333333333333,0.058823529411764705,0.5,0.0,4,0.75,0.25,Design 2,Design 1,"Have an option between Design #1 and Design #2,",4.0,,
2435,4773,3,Player object (1080),sell,2023-03-10 04:07:21.285899+00:00,"{""priceA"": 150, ""sharesA"": 0, ""secs_since_round_starts"": 396, ""market"": ""A""}",215.0,45.0,11.0,sxogauy0,vmu7c279,FULL STUDY,245.0,s4,1,150,155.0,1,-5.0,1,buy,0,sell,0.5,0,0,0,block 4 (G second),19.0,12.0,Female,1.0,0.0,1.0,"[3, 'block 4 (G second)']",0,0,1,0.0,3.0,-0.7,0.5333333333333333,0.058823529411764705,0.5,0.0,4,0.75,0.25,Design 2,Design 1,"Have an option between Design #1 and Design #2,",4.0,,
2436,4774,3,Player object (1080),buy,2023-03-10 04:07:32.106460+00:00,"{""priceA"": 140, ""sharesA"": 1, ""secs_since_round_starts"": 407, ""market"": ""A""}",75.0,47.0,12.0,sxogauy0,vmu7c279,FULL STUDY,245.0,s4,1,140,150.0,-1,,1,sell,0,sell,0.5,0,0,0,block 4 (G second),19.0,12.0,Female,1.0,0.0,1.0,"[3, 'block 4 (G second)']",0,0,1,0.0,3.0,-0.7,0.5333333333333333,0.058823529411764705,0.5,0.0,4,0.75,0.25,Design 2,Design 1,"Have an option between Design #1 and Design #2,",4.0,,
2437,4775,3,Player object (1080),sell,2023-03-10 04:07:37.546992+00:00,"{""priceA"": 150, ""sharesA"": 0, ""secs_since_round_starts"": 412, ""market"": ""A""}",225.0,48.0,13.0,sxogauy0,vmu7c279,FULL STUDY,245.0,s4,1,150,140.0,1,10.0,1,buy,0,sell,0.5,0,0,0,block 4 (G second),19.0,12.0,Female,1.0,0.0,1.0,"[3, 'block 4 (G second)']",0,0,1,0.0,3.0,-0.7,0.5333333333333333,0.058823529411764705,0.5,0.0,4,0.75,0.25,Design 2,Design 1,"Have an option between Design #1 and Design #2,",4.0,,
2438,4776,3,Player object (1080),buy,2023-03-10 04:07:43.769165+00:00,"{""priceA"": 165, ""sharesA"": 1, ""secs_since_round_starts"": 418, ""market"": ""A""}",60.0,49.0,14.0,sxogauy0,vmu7c279,FULL STUDY,245.0,s4,1,165,150.0,-1,,1,sell,0,sell,0.5,0,0,0,block 4 (G second),19.0,12.0,Female,1.0,0.0,1.0,"[3, 'block 4 (G second)']",0,0,1,0.0,3.0,-0.7,0.5333333333333333,0.058823529411764705,0.5,0.0,4,0.75,0.25,Design 2,Design 1,"Have an option between Design #1 and Design #2,",4.0,,
2439,4777,3,Player object (1080),sell,2023-03-10 04:07:48.612104+00:00,"{""priceA"": 170, ""sharesA"": 0, ""secs_since_round_starts"": 423, ""market"": ""A""}",230.0,50.0,15.0,sxogauy0,vmu7c279,FULL STUDY,245.0,s4,1,170,165.0,1,5.0,1,buy,0,sell,0.5,0,0,1,block 4 (G second),19.0,12.0,Female,1.0,0.0,1.0,"[3, 'block 4 (G second)']",0,0,1,0.0,3.0,-0.7,0.5333333333333333,0.058823529411764705,0.5,0.0,4,0.75,0.25,Design 2,Design 1,"Have an option between Design #1 and Design #2,",4.0,,
2440,4778,3,Player object (1080),buy,2023-03-10 04:08:02.901218+00:00,"{""priceA"": 200, ""sharesA"": 1, ""secs_since_round_starts"": 438, ""market"": ""A""}",30.0,52.0,16.0,sxogauy0,vmu7c279,FULL STUDY,245.0,s4,1,200,170.0,-1,,1,sell,0,sell,0.5,0,0,0,block 4 (G second),19.0,12.0,Female,1.0,0.0,1.0,"[3, 'block 4 (G second)']",0,0,1,0.0,3.0,-0.7,0.5333333333333333,0.058823529411764705,0.5,0.0,4,0.75,0.25,Design 2,Design 1,"Have an option between Design #1 and Design #2,",4.0,,
2441,4779,3,Player object (1080),sell,2023-03-10 04:08:07.361140+00:00,"{""priceA"": 210, ""sharesA"": 0, ""secs_since_round_starts"": 442, ""market"": ""A""}",240.0,53.0,17.0,sxogauy0,vmu7c279,FULL STUDY,245.0,s4,1,210,200.0,1,10.0,1,buy,0,sell,0.5,0,0,0,block 4 (G second),19.0,12.0,Female,1.0,0.0,1.0,"[3, 'block 4 (G second)']",0,0,1,0.0,3.0,-0.7,0.5333333333333333,0.058823529411764705,0.5,0.0,4,0.75,0.25,Design 2,Design 1,"Have an option between Design #1 and Design #2,",4.0,,
2442,4780,3,Player object (1080),buy,2023-03-10 04:08:20.558346+00:00,"{""priceA"": 175, ""sharesA"": 1, ""secs_since_round_starts"": 455, ""market"": ""A""}",65.0,56.0,18.0,sxogauy0,vmu7c279,FULL STUDY,245.0,s4,1,175,210.0,-1,,1,sell,0,sell,0.5,0,1,0,block 4 (G second),19.0,12.0,Female,1.0,0.0,1.0,"[3, 'block 4 (G second)']",0,0,1,0.0,3.0,-0.7,0.5333333333333333,0.058823529411764705,0.5,0.0,4,0.75,0.25,Design 2,Design 1,"Have an option between Design #1 and Design #2,",4.0,,
2443,4786,4,Player object (1200),sell,2023-03-10 04:09:31.306235+00:00,"{""priceA"": 130, ""sharesA"": 0, ""secs_since_round_starts"": 39, ""market"": ""A""}",180.0,8.0,1.0,sxogauy0,vmu7c279,FULL STUDY,110.0,s4,1,130,,1,,1,,0,sell,0.5,0,0,0,block 4 (G second),19.0,12.0,Female,1.0,0.0,1.0,"[4, 'block 4 (G second)']",1,1,1,0.5,3.0,-0.7,0.5,0.35294117647058826,0.5,0.3333333333333333,2,0.75,0.25,Design 2,Design 1,"Have an option between Design #1 and Design #2,",4.0,,
2444,4787,4,Player object (1200),buy,2023-03-10 04:09:44.930889+00:00,"{""priceA"": 135, ""sharesA"": 1, ""secs_since_round_starts"": 53, ""market"": ""A""}",45.0,10.0,2.0,sxogauy0,vmu7c279,FULL STUDY,110.0,s4,1,135,130.0,-1,,1,sell,0,sell,0.5,0,0,0,block 4 (G second),19.0,12.0,Female,1.0,0.0,1.0,"[4, 'block 4 (G second)']",1,1,1,0.5,3.0,-0.7,0.5,0.35294117647058826,0.5,0.3333333333333333,2,0.75,0.25,Design 2,Design 1,"Have an option between Design #1 and Design #2,",4.0,,
2445,4788,4,Player object (1200),sell,2023-03-10 04:10:09.654115+00:00,"{""priceA"": 100, ""sharesA"": 0, ""secs_since_round_starts"": 78, ""market"": ""A""}",145.0,15.0,3.0,sxogauy0,vmu7c279,FULL STUDY,110.0,s4,1,100,135.0,1,-35.0,1,buy,0,sell,0.5,0,0,0,block 4 (G second),19.0,12.0,Female,1.0,0.0,1.0,"[4, 'block 4 (G second)']",1,1,1,0.5,3.0,-0.7,0.5,0.35294117647058826,0.5,0.3333333333333333,2,0.75,0.25,Design 2,Design 1,"Have an option between Design #1 and Design #2,",4.0,,
2446,4789,4,Player object (1200),buy,2023-03-10 04:10:16.203599+00:00,"{""priceA"": 85, ""sharesA"": 1, ""secs_since_round_starts"": 84, ""market"": ""A""}",60.0,16.0,4.0,sxogauy0,vmu7c279,FULL STUDY,110.0,s4,1,85,100.0,-1,,1,sell,0,sell,0.5,0,1,0,block 4 (G second),19.0,12.0,Female,1.0,0.0,1.0,"[4, 'block 4 (G second)']",1,1,1,0.5,3.0,-0.7,0.5,0.35294117647058826,0.5,0.3333333333333333,2,0.75,0.25,Design 2,Design 1,"Have an option between Design #1 and Design #2,",4.0,,
2447,4792,4,Player object (1200),sell,2023-03-10 04:10:42.657712+00:00,"{""priceA"": 60, ""sharesA"": 0, ""secs_since_round_starts"": 111, ""market"": ""A""}",120.0,21.0,6.0,sxogauy0,vmu7c279,FULL STUDY,110.0,s4,1,60,85.0,1,-25.0,1,buy,0,sell,0.5,0,0,0,block 4 (G second),19.0,12.0,Female,1.0,0.0,1.0,"[4, 'block 4 (G second)']",1,1,1,0.5,3.0,-0.7,0.5,0.35294117647058826,0.5,0.3333333333333333,2,0.75,0.25,Design 2,Design 1,"Have an option between Design #1 and Design #2,",4.0,,
2448,4793,4,Player object (1200),buy,2023-03-10 04:10:51.515160+00:00,"{""priceA"": 55, ""sharesA"": 1, ""secs_since_round_starts"": 120, ""market"": ""A""}",65.0,22.0,7.0,sxogauy0,vmu7c279,FULL STUDY,110.0,s4,1,55,60.0,-1,,1,sell,0,sell,0.5,0,1,0,block 4 (G second),19.0,12.0,Female,1.0,0.0,1.0,"[4, 'block 4 (G second)']",1,1,1,0.5,3.0,-0.7,0.5,0.35294117647058826,0.5,0.3333333333333333,2,0.75,0.25,Design 2,Design 1,"Have an option between Design #1 and Design #2,",4.0,,
2449,4794,4,Player object (1200),sell,2023-03-10 04:10:57.777767+00:00,"{""priceA"": 50, ""sharesA"": 0, ""secs_since_round_starts"": 126, ""market"": ""A""}",115.0,24.0,8.0,sxogauy0,vmu7c279,FULL STUDY,110.0,s4,1,50,55.0,1,-5.0,1,buy,0,sell,0.5,0,0,0,block 4 (G second),19.0,12.0,Female,1.0,0.0,1.0,"[4, 'block 4 (G second)']",1,1,1,0.5,3.0,-0.7,0.5,0.35294117647058826,0.5,0.3333333333333333,2,0.75,0.25,Design 2,Design 1,"Have an option between Design #1 and Design #2,",4.0,,
2450,4795,4,Player object (1200),buy,2023-03-10 04:11:03.597073+00:00,"{""priceA"": 40, ""sharesA"": 1, ""secs_since_round_starts"": 132, ""market"": ""A""}",75.0,25.0,9.0,sxogauy0,vmu7c279,FULL STUDY,110.0,s4,1,40,50.0,-1,,1,sell,0,sell,0.5,0,0,0,block 4 (G second),19.0,12.0,Female,1.0,0.0,1.0,"[4, 'block 4 (G second)']",1,1,1,0.5,3.0,-0.7,0.5,0.35294117647058826,0.5,0.3333333333333333,2,0.75,0.25,Design 2,Design 1,"Have an option between Design #1 and Design #2,",4.0,,
2451,4796,4,Player object (1200),sell,2023-03-10 04:11:18.572037+00:00,"{""priceA"": 45, ""sharesA"": 0, ""secs_since_round_starts"": 147, ""market"": ""A""}",120.0,27.0,10.0,sxogauy0,vmu7c279,FULL STUDY,110.0,s4,1,45,40.0,1,5.0,1,buy,0,sell,0.5,0,0,0,block 4 (G second),19.0,12.0,Female,1.0,0.0,1.0,"[4, 'block 4 (G second)']",1,1,1,0.5,3.0,-0.7,0.5,0.35294117647058826,0.5,0.3333333333333333,2,0.75,0.25,Design 2,Design 1,"Have an option between Design #1 and Design #2,",4.0,,
2452,4797,4,Player object (1200),buy,2023-03-10 04:11:20.745366+00:00,"{""priceA"": 60, ""sharesA"": 1, ""secs_since_round_starts"": 149, ""market"": ""A""}",60.0,28.0,11.0,sxogauy0,vmu7c279,FULL STUDY,110.0,s4,1,60,45.0,-1,,1,sell,0,sell,0.5,0,0,0,block 4 (G second),19.0,12.0,Female,1.0,0.0,1.0,"[4, 'block 4 (G second)']",1,1,1,0.5,3.0,-0.7,0.5,0.35294117647058826,0.5,0.3333333333333333,2,0.75,0.25,Design 2,Design 1,"Have an option between Design #1 and Design #2,",4.0,,
2453,4798,4,Player object (1200),sell,2023-03-10 04:11:30.504305+00:00,"{""priceA"": 65, ""sharesA"": 0, ""secs_since_round_starts"": 159, ""market"": ""A""}",125.0,29.0,12.0,sxogauy0,vmu7c279,FULL STUDY,110.0,s4,1,65,60.0,1,5.0,1,buy,0,sell,0.5,0,0,1,block 4 (G second),19.0,12.0,Female,1.0,0.0,1.0,"[4, 'block 4 (G second)']",1,1,1,0.5,3.0,-0.7,0.5,0.35294117647058826,0.5,0.3333333333333333,2,0.75,0.25,Design 2,Design 1,"Have an option between Design #1 and Design #2,",4.0,,
2454,4799,4,Player object (1200),buy,2023-03-10 04:11:34.054954+00:00,"{""priceA"": 75, ""sharesA"": 1, ""secs_since_round_starts"": 162, ""market"": ""A""}",50.0,30.0,13.0,sxogauy0,vmu7c279,FULL STUDY,110.0,s4,1,75,65.0,-1,,1,sell,0,sell,0.5,0,0,0,block 4 (G second),19.0,12.0,Female,1.0,0.0,1.0,"[4, 'block 4 (G second)']",1,1,1,0.5,3.0,-0.7,0.5,0.35294117647058826,0.5,0.3333333333333333,2,0.75,0.25,Design 2,Design 1,"Have an option between Design #1 and Design #2,",4.0,,
2455,4801,4,Player object (1200),sell,2023-03-10 04:11:47.060261+00:00,"{""priceA"": 45, ""sharesA"": 0, ""secs_since_round_starts"": 175, ""market"": ""A""}",95.0,32.0,14.0,sxogauy0,vmu7c279,FULL STUDY,110.0,s4,1,45,75.0,1,-30.0,1,buy,0,sell,0.5,0,0,0,block 4 (G second),19.0,12.0,Female,1.0,0.0,1.0,"[4, 'block 4 (G second)']",1,1,1,0.5,3.0,-0.7,0.5,0.35294117647058826,0.5,0.3333333333333333,2,0.75,0.25,Design 2,Design 1,"Have an option between Design #1 and Design #2,",4.0,,
2456,4802,4,Player object (1200),buy,2023-03-10 04:11:55.816661+00:00,"{""priceA"": 75, ""sharesA"": 1, ""secs_since_round_starts"": 184, ""market"": ""A""}",20.0,34.0,15.0,sxogauy0,vmu7c279,FULL STUDY,110.0,s4,1,75,45.0,-1,,1,sell,0,sell,0.5,0,0,0,block 4 (G second),19.0,12.0,Female,1.0,0.0,1.0,"[4, 'block 4 (G second)']",1,1,1,0.5,3.0,-0.7,0.5,0.35294117647058826,0.5,0.3333333333333333,2,0.75,0.25,Design 2,Design 1,"Have an option between Design #1 and Design #2,",4.0,,
2457,4803,4,Player object (1200),sell,2023-03-10 04:12:08.394252+00:00,"{""priceA"": 90, ""sharesA"": 0, ""secs_since_round_starts"": 197, ""market"": ""A""}",110.0,36.0,16.0,sxogauy0,vmu7c279,FULL STUDY,110.0,s4,1,90,75.0,1,15.0,1,buy,0,sell,0.5,0,0,0,block 4 (G second),19.0,12.0,Female,1.0,0.0,1.0,"[4, 'block 4 (G second)']",1,1,1,0.5,3.0,-0.7,0.5,0.35294117647058826,0.5,0.3333333333333333,2,0.75,0.25,Design 2,Design 1,"Have an option between Design #1 and Design #2,",4.0,,
2458,4804,4,Player object (1200),buy,2023-03-10 04:12:23.790264+00:00,"{""priceA"": 85, ""sharesA"": 1, ""secs_since_round_starts"": 212, ""market"": ""A""}",25.0,39.0,17.0,sxogauy0,vmu7c279,FULL STUDY,110.0,s4,1,85,90.0,-1,,1,sell,0,sell,0.5,0,0,0,block 4 (G second),19.0,12.0,Female,1.0,0.0,1.0,"[4, 'block 4 (G second)']",1,1,1,0.5,3.0,-0.7,0.5,0.35294117647058826,0.5,0.3333333333333333,2,0.75,0.25,Design 2,Design 1,"Have an option between Design #1 and Design #2,",4.0,,
2459,4805,4,Player object (1200),sell,2023-03-10 04:12:27.952455+00:00,"{""priceA"": 90, ""sharesA"": 0, ""secs_since_round_starts"": 216, ""market"": ""A""}",115.0,40.0,18.0,sxogauy0,vmu7c279,FULL STUDY,110.0,s4,1,90,85.0,1,5.0,1,buy,0,sell,0.5,0,0,0,block 4 (G second),19.0,12.0,Female,1.0,0.0,1.0,"[4, 'block 4 (G second)']",1,1,1,0.5,3.0,-0.7,0.5,0.35294117647058826,0.5,0.3333333333333333,2,0.75,0.25,Design 2,Design 1,"Have an option between Design #1 and Design #2,",4.0,,
2460,4806,4,Player object (1200),buy,2023-03-10 04:12:46.015534+00:00,"{""priceA"": 105, ""sharesA"": 1, ""secs_since_round_starts"": 234, ""market"": ""A""}",10.0,43.0,19.0,sxogauy0,vmu7c279,FULL STUDY,110.0,s4,1,105,90.0,-1,,1,sell,0,sell,0.5,0,0,0,block 4 (G second),19.0,12.0,Female,1.0,0.0,1.0,"[4, 'block 4 (G second)']",1,1,1,0.5,3.0,-0.7,0.5,0.35294117647058826,0.5,0.3333333333333333,2,0.75,0.25,Design 2,Design 1,"Have an option between Design #1 and Design #2,",4.0,,
2461,4807,4,Player object (1200),sell,2023-03-10 04:12:57.687131+00:00,"{""priceA"": 110, ""sharesA"": 0, ""secs_since_round_starts"": 246, ""market"": ""A""}",120.0,45.0,20.0,sxogauy0,vmu7c279,FULL STUDY,110.0,s4,1,110,105.0,1,5.0,1,buy,0,sell,0.5,0,0,0,block 4 (G second),19.0,12.0,Female,1.0,0.0,1.0,"[4, 'block 4 (G second)']",1,1,1,0.5,3.0,-0.7,0.5,0.35294117647058826,0.5,0.3333333333333333,2,0.75,0.25,Design 2,Design 1,"Have an option between Design #1 and Design #2,",4.0,,
2462,4808,4,Player object (1200),buy,2023-03-10 04:13:12.059858+00:00,"{""priceA"": 120, ""sharesA"": 1, ""secs_since_round_starts"": 260, ""market"": ""A""}",,48.0,21.0,sxogauy0,vmu7c279,FULL STUDY,110.0,s4,1,120,110.0,-1,,1,sell,0,sell,0.5,0,0,0,block 4 (G second),19.0,12.0,Female,1.0,0.0,1.0,"[4, 'block 4 (G second)']",1,1,1,0.5,3.0,-0.7,0.5,0.35294117647058826,0.5,0.3333333333333333,2,0.75,0.25,Design 2,Design 1,"Have an option between Design #1 and Design #2,",4.0,,
2463,4809,4,Player object (1200),sell,2023-03-10 04:13:19.183845+00:00,"{""priceA"": 125, ""sharesA"": 0, ""secs_since_round_starts"": 267, ""market"": ""A""}",125.0,49.0,22.0,sxogauy0,vmu7c279,FULL STUDY,110.0,s4,1,125,120.0,1,5.0,1,buy,0,sell,0.5,0,0,1,block 4 (G second),19.0,12.0,Female,1.0,0.0,1.0,"[4, 'block 4 (G second)']",1,1,1,0.5,3.0,-0.7,0.5,0.35294117647058826,0.5,0.3333333333333333,2,0.75,0.25,Design 2,Design 1,"Have an option between Design #1 and Design #2,",4.0,,
2464,4810,4,Player object (1200),buy,2023-03-10 04:13:23.117605+00:00,"{""priceA"": 140, ""sharesA"": 1, ""secs_since_round_starts"": 271, ""market"": ""A""}",-15.0,50.0,23.0,sxogauy0,vmu7c279,FULL STUDY,110.0,s4,1,140,125.0,-1,,1,sell,0,sell,0.5,0,0,0,block 4 (G second),19.0,12.0,Female,1.0,0.0,1.0,"[4, 'block 4 (G second)']",1,1,1,0.5,3.0,-0.7,0.5,0.35294117647058826,0.5,0.3333333333333333,2,0.75,0.25,Design 2,Design 1,"Have an option between Design #1 and Design #2,",4.0,,
2465,4811,4,Player object (1200),sell,2023-03-10 04:13:40.132791+00:00,"{""priceA"": 115, ""sharesA"": 0, ""secs_since_round_starts"": 288, ""market"": ""A""}",100.0,53.0,24.0,sxogauy0,vmu7c279,FULL STUDY,110.0,s4,1,115,140.0,1,-25.0,1,buy,0,sell,0.5,0,1,0,block 4 (G second),19.0,12.0,Female,1.0,0.0,1.0,"[4, 'block 4 (G second)']",1,1,1,0.5,3.0,-0.7,0.5,0.35294117647058826,0.5,0.3333333333333333,2,0.75,0.25,Design 2,Design 1,"Have an option between Design #1 and Design #2,",4.0,,
2466,4814,4,Player object (1200),buy,2023-03-10 04:13:50.724221+00:00,"{""priceA"": 135, ""sharesA"": 1, ""secs_since_round_starts"": 299, ""market"": ""A""}",-35.0,55.0,26.0,sxogauy0,vmu7c279,FULL STUDY,110.0,s4,1,135,130.0,-1,,1,sell,0,sell,0.5,0,0,0,block 4 (G second),19.0,12.0,Female,1.0,0.0,1.0,"[4, 'block 4 (G second)']",1,1,1,0.5,3.0,-0.7,0.5,0.35294117647058826,0.5,0.3333333333333333,2,0.75,0.25,Design 2,Design 1,"Have an option between Design #1 and Design #2,",4.0,,
2467,4815,4,Player object (1200),sell,2023-03-10 04:14:00.280304+00:00,"{""priceA"": 120, ""sharesA"": 0, ""secs_since_round_starts"": 308, ""market"": ""A""}",85.0,56.0,27.0,sxogauy0,vmu7c279,FULL STUDY,110.0,s4,1,120,135.0,1,-15.0,1,buy,0,sell,0.5,0,0,0,block 4 (G second),19.0,12.0,Female,1.0,0.0,1.0,"[4, 'block 4 (G second)']",1,1,1,0.5,3.0,-0.7,0.5,0.35294117647058826,0.5,0.3333333333333333,2,0.75,0.25,Design 2,Design 1,"Have an option between Design #1 and Design #2,",4.0,,
2468,4816,4,Player object (1200),buy,2023-03-10 04:14:01.978292+00:00,"{""priceA"": 135, ""sharesA"": 1, ""secs_since_round_starts"": 310, ""market"": ""A""}",-50.0,57.0,28.0,sxogauy0,vmu7c279,FULL STUDY,110.0,s4,1,135,120.0,-1,,1,sell,0,sell,0.5,0,0,0,block 4 (G second),19.0,12.0,Female,1.0,0.0,1.0,"[4, 'block 4 (G second)']",1,1,1,0.5,3.0,-0.7,0.5,0.35294117647058826,0.5,0.3333333333333333,2,0.75,0.25,Design 2,Design 1,"Have an option between Design #1 and Design #2,",4.0,,
2469,4817,4,Player object (1200),sell,2023-03-10 04:14:21.805313+00:00,"{""priceA"": 160, ""sharesA"": 0, ""secs_since_round_starts"": 330, ""market"": ""A""}",110.0,60.0,29.0,sxogauy0,vmu7c279,FULL STUDY,110.0,s4,1,160,135.0,1,25.0,1,buy,0,sell,0.5,0,0,0,block 4 (G second),19.0,12.0,Female,1.0,0.0,1.0,"[4, 'block 4 (G second)']",1,1,1,0.5,3.0,-0.7,0.5,0.35294117647058826,0.5,0.3333333333333333,2,0.75,0.25,Design 2,Design 1,"Have an option between Design #1 and Design #2,",4.0,,
2470,4821,5,Player object (1320),sell,2023-03-10 04:14:55.123916+00:00,"{""priceA"": 130, ""sharesA"": 0, ""secs_since_round_starts"": 29, ""market"": ""A""}",180.0,6.0,1.0,sxogauy0,vmu7c279,FULL STUDY,170.0,s4,1,130,,1,,1,,0,sell,0.5,0,0,1,block 4 (G second),19.0,12.0,Female,1.0,0.0,1.0,"[5, 'block 4 (G second)']",1,0,1,0.0,3.0,-0.7,0.625,0.11764705882352941,1.0,0.25,4,0.75,0.5,Design 2,Design 1,"Have an option between Design #1 and Design #2,",4.0,,
2471,4822,5,Player object (1320),buy,2023-03-10 04:15:02.067645+00:00,"{""priceA"": 125, ""sharesA"": 1, ""secs_since_round_starts"": 36, ""market"": ""A""}",55.0,7.0,2.0,sxogauy0,vmu7c279,FULL STUDY,170.0,s4,1,125,130.0,-1,,1,sell,0,sell,0.5,0,0,0,block 4 (G second),19.0,12.0,Female,1.0,0.0,1.0,"[5, 'block 4 (G second)']",1,0,1,0.0,3.0,-0.7,0.625,0.11764705882352941,1.0,0.25,4,0.75,0.5,Design 2,Design 1,"Have an option between Design #1 and Design #2,",4.0,,
2472,4823,5,Player object (1320),sell,2023-03-10 04:15:06.940370+00:00,"{""priceA"": 135, ""sharesA"": 0, ""secs_since_round_starts"": 41, ""market"": ""A""}",190.0,8.0,3.0,sxogauy0,vmu7c279,FULL STUDY,170.0,s4,1,135,125.0,1,10.0,1,buy,0,sell,0.5,0,0,0,block 4 (G second),19.0,12.0,Female,1.0,0.0,1.0,"[5, 'block 4 (G second)']",1,0,1,0.0,3.0,-0.7,0.625,0.11764705882352941,1.0,0.25,4,0.75,0.5,Design 2,Design 1,"Have an option between Design #1 and Design #2,",4.0,,
2473,4824,5,Player object (1320),buy,2023-03-10 04:15:12.999165+00:00,"{""priceA"": 120, ""sharesA"": 1, ""secs_since_round_starts"": 47, ""market"": ""A""}",70.0,9.0,4.0,sxogauy0,vmu7c279,FULL STUDY,170.0,s4,1,120,135.0,-1,,1,sell,0,sell,0.5,0,0,0,block 4 (G second),19.0,12.0,Female,1.0,0.0,1.0,"[5, 'block 4 (G second)']",1,0,1,0.0,3.0,-0.7,0.625,0.11764705882352941,1.0,0.25,4,0.75,0.5,Design 2,Design 1,"Have an option between Design #1 and Design #2,",4.0,,
2474,4825,5,Player object (1320),sell,2023-03-10 04:15:17.122723+00:00,"{""priceA"": 135, ""sharesA"": 0, ""secs_since_round_starts"": 51, ""market"": ""A""}",205.0,10.0,5.0,sxogauy0,vmu7c279,FULL STUDY,170.0,s4,1,135,120.0,1,15.0,1,buy,0,sell,0.5,0,0,0,block 4 (G second),19.0,12.0,Female,1.0,0.0,1.0,"[5, 'block 4 (G second)']",1,0,1,0.0,3.0,-0.7,0.625,0.11764705882352941,1.0,0.25,4,0.75,0.5,Design 2,Design 1,"Have an option between Design #1 and Design #2,",4.0,,
2475,4826,5,Player object (1320),buy,2023-03-10 04:15:29.883525+00:00,"{""priceA"": 120, ""sharesA"": 1, ""secs_since_round_starts"": 64, ""market"": ""A""}",85.0,12.0,6.0,sxogauy0,vmu7c279,FULL STUDY,170.0,s4,1,120,135.0,-1,,1,sell,0,sell,0.5,0,0,0,block 4 (G second),19.0,12.0,Female,1.0,0.0,1.0,"[5, 'block 4 (G second)']",1,0,1,0.0,3.0,-0.7,0.625,0.11764705882352941,1.0,0.25,4,0.75,0.5,Design 2,Design 1,"Have an option between Design #1 and Design #2,",4.0,,
2476,4827,5,Player object (1320),sell,2023-03-10 04:15:35.466203+00:00,"{""priceA"": 135, ""sharesA"": 0, ""secs_since_round_starts"": 69, ""market"": ""A""}",220.0,13.0,7.0,sxogauy0,vmu7c279,FULL STUDY,170.0,s4,1,135,120.0,1,15.0,1,buy,0,sell,0.5,0,0,0,block 4 (G second),19.0,12.0,Female,1.0,0.0,1.0,"[5, 'block 4 (G second)']",1,0,1,0.0,3.0,-0.7,0.625,0.11764705882352941,1.0,0.25,4,0.75,0.5,Design 2,Design 1,"Have an option between Design #1 and Design #2,",4.0,,
2477,4828,5,Player object (1320),buy,2023-03-10 04:15:42.157092+00:00,"{""priceA"": 145, ""sharesA"": 1, ""secs_since_round_starts"": 76, ""market"": ""A""}",75.0,15.0,8.0,sxogauy0,vmu7c279,FULL STUDY,170.0,s4,1,145,135.0,-1,,1,sell,0,sell,0.5,0,0,1,block 4 (G second),19.0,12.0,Female,1.0,0.0,1.0,"[5, 'block 4 (G second)']",1,0,1,0.0,3.0,-0.7,0.625,0.11764705882352941,1.0,0.25,4,0.75,0.5,Design 2,Design 1,"Have an option between Design #1 and Design #2,",4.0,,
2478,4831,5,Player object (1320),sell,2023-03-10 04:16:24.229913+00:00,"{""priceA"": 135, ""sharesA"": 0, ""secs_since_round_starts"": 118, ""market"": ""A""}",210.0,22.0,10.0,sxogauy0,vmu7c279,FULL STUDY,170.0,s4,1,135,115.0,1,20.0,1,buy,0,sell,0.5,0,0,1,block 4 (G second),19.0,12.0,Female,1.0,0.0,1.0,"[5, 'block 4 (G second)']",1,0,1,0.0,3.0,-0.7,0.625,0.11764705882352941,1.0,0.25,4,0.75,0.5,Design 2,Design 1,"Have an option between Design #1 and Design #2,",4.0,,
2479,4832,5,Player object (1320),buy,2023-03-10 04:16:38.975183+00:00,"{""priceA"": 150, ""sharesA"": 1, ""secs_since_round_starts"": 133, ""market"": ""A""}",60.0,25.0,11.0,sxogauy0,vmu7c279,FULL STUDY,170.0,s4,1,150,135.0,-1,,1,sell,0,sell,0.5,0,0,0,block 4 (G second),19.0,12.0,Female,1.0,0.0,1.0,"[5, 'block 4 (G second)']",1,0,1,0.0,3.0,-0.7,0.625,0.11764705882352941,1.0,0.25,4,0.75,0.5,Design 2,Design 1,"Have an option between Design #1 and Design #2,",4.0,,
2480,4836,5,Player object (1320),sell,2023-03-10 04:18:13.849488+00:00,"{""priceA"": 130, ""sharesA"": 0, ""secs_since_round_starts"": 227, ""market"": ""A""}",190.0,42.0,13.0,sxogauy0,vmu7c279,FULL STUDY,170.0,s4,1,130,120.0,1,10.0,1,buy,0,sell,0.5,0,0,0,block 4 (G second),19.0,12.0,Female,1.0,0.0,1.0,"[5, 'block 4 (G second)']",1,0,1,0.0,3.0,-0.7,0.625,0.11764705882352941,1.0,0.25,4,0.75,0.5,Design 2,Design 1,"Have an option between Design #1 and Design #2,",4.0,,
2481,4837,5,Player object (1320),buy,2023-03-10 04:18:19.571029+00:00,"{""priceA"": 115, ""sharesA"": 1, ""secs_since_round_starts"": 233, ""market"": ""A""}",75.0,43.0,14.0,sxogauy0,vmu7c279,FULL STUDY,170.0,s4,1,115,130.0,-1,,1,sell,0,sell,0.5,0,0,0,block 4 (G second),19.0,12.0,Female,1.0,0.0,1.0,"[5, 'block 4 (G second)']",1,0,1,0.0,3.0,-0.7,0.625,0.11764705882352941,1.0,0.25,4,0.75,0.5,Design 2,Design 1,"Have an option between Design #1 and Design #2,",4.0,,
2482,4838,5,Player object (1320),sell,2023-03-10 04:18:35.834561+00:00,"{""priceA"": 130, ""sharesA"": 0, ""secs_since_round_starts"": 249, ""market"": ""A""}",205.0,46.0,15.0,sxogauy0,vmu7c279,FULL STUDY,170.0,s4,1,130,115.0,1,15.0,1,buy,0,sell,0.5,0,0,0,block 4 (G second),19.0,12.0,Female,1.0,0.0,1.0,"[5, 'block 4 (G second)']",1,0,1,0.0,3.0,-0.7,0.625,0.11764705882352941,1.0,0.25,4,0.75,0.5,Design 2,Design 1,"Have an option between Design #1 and Design #2,",4.0,,
2483,4839,5,Player object (1320),buy,2023-03-10 04:18:41.264673+00:00,"{""priceA"": 115, ""sharesA"": 1, ""secs_since_round_starts"": 255, ""market"": ""A""}",90.0,47.0,16.0,sxogauy0,vmu7c279,FULL STUDY,170.0,s4,1,115,130.0,-1,,1,sell,0,sell,0.5,0,0,0,block 4 (G second),19.0,12.0,Female,1.0,0.0,1.0,"[5, 'block 4 (G second)']",1,0,1,0.0,3.0,-0.7,0.625,0.11764705882352941,1.0,0.25,4,0.75,0.5,Design 2,Design 1,"Have an option between Design #1 and Design #2,",4.0,,
2484,4842,5,Player object (1320),sell,2023-03-10 04:19:39.149980+00:00,"{""priceA"": 90, ""sharesA"": 0, ""secs_since_round_starts"": 313, ""market"": ""A""}",180.0,57.0,18.0,sxogauy0,vmu7c279,FULL STUDY,170.0,s4,1,90,80.0,1,10.0,1,buy,0,sell,0.5,0,0,0,block 4 (G second),19.0,12.0,Female,1.0,0.0,1.0,"[5, 'block 4 (G second)']",1,0,1,0.0,3.0,-0.7,0.625,0.11764705882352941,1.0,0.25,4,0.75,0.5,Design 2,Design 1,"Have an option between Design #1 and Design #2,",4.0,,
2485,4845,5,Player object (1320),buy,2023-03-10 04:19:47.113523+00:00,"{""priceA"": 105, ""sharesA"": 1, ""secs_since_round_starts"": 321, ""market"": ""A""}",75.0,59.0,20.0,sxogauy0,vmu7c279,FULL STUDY,170.0,s4,1,105,95.0,-1,,1,sell,0,sell,0.5,0,0,1,block 4 (G second),19.0,12.0,Female,1.0,0.0,1.0,"[5, 'block 4 (G second)']",1,0,1,0.0,3.0,-0.7,0.625,0.11764705882352941,1.0,0.25,4,0.75,0.5,Design 2,Design 1,"Have an option between Design #1 and Design #2,",4.0,,
2486,4846,5,Player object (1320),sell,2023-03-10 04:19:56.710852+00:00,"{""priceA"": 95, ""sharesA"": 0, ""secs_since_round_starts"": 330, ""market"": ""A""}",170.0,60.0,21.0,sxogauy0,vmu7c279,FULL STUDY,170.0,s4,1,95,105.0,1,-10.0,1,buy,0,sell,0.5,0,0,0,block 4 (G second),19.0,12.0,Female,1.0,0.0,1.0,"[5, 'block 4 (G second)']",1,0,1,0.0,3.0,-0.7,0.625,0.11764705882352941,1.0,0.25,4,0.75,0.5,Design 2,Design 1,"Have an option between Design #1 and Design #2,",4.0,,
2487,4051,3,Player object (1062),sell,2023-03-09 20:28:43.210378+00:00,"{""priceA"": 125, ""sharesA"": 0, ""secs_since_round_starts"": 50, ""market"": ""A""}",175.0,9.0,1.0,v3ju8jv9,vmu7c279,FULL STUDY,195.0,s4,1,125,,1,,1,,0,sell,0.5,0,0,0,block 1 (G first),22.0,12.0,Male,1.0,1.0,1.0,"[3, 'block 1 (G first)']",1,1,0,0.0,3.0,-0.7,0.5,0.0,,0.0,5,0.5,1.0,Design 1,Design 1,Only trade on Design #1,4.0,,
2488,4053,3,Player object (1062),buy,2023-03-09 20:31:49.904087+00:00,"{""priceA"": 140, ""sharesA"": 1, ""secs_since_round_starts"": 237, ""market"": ""A""}",35.0,42.0,2.0,v3ju8jv9,vmu7c279,FULL STUDY,195.0,s4,1,140,125.0,-1,,1,sell,0,sell,0.5,0,0,0,block 1 (G first),22.0,12.0,Male,1.0,1.0,1.0,"[3, 'block 1 (G first)']",1,1,0,0.0,3.0,-0.7,0.5,0.0,,0.0,5,0.5,1.0,Design 1,Design 1,Only trade on Design #1,4.0,,
2489,4054,3,Player object (1062),sell,2023-03-09 20:32:03.933862+00:00,"{""priceA"": 150, ""sharesA"": 0, ""secs_since_round_starts"": 251, ""market"": ""A""}",185.0,45.0,3.0,v3ju8jv9,vmu7c279,FULL STUDY,195.0,s4,1,150,140.0,1,10.0,1,buy,0,sell,0.5,0,0,0,block 1 (G first),22.0,12.0,Male,1.0,1.0,1.0,"[3, 'block 1 (G first)']",1,1,0,0.0,3.0,-0.7,0.5,0.0,,0.0,5,0.5,1.0,Design 1,Design 1,Only trade on Design #1,4.0,,
2490,4055,3,Player object (1062),buy,2023-03-09 20:33:12.646008+00:00,"{""priceA"": 170, ""sharesA"": 1, ""secs_since_round_starts"": 320, ""market"": ""A""}",15.0,57.0,4.0,v3ju8jv9,vmu7c279,FULL STUDY,195.0,s4,1,170,150.0,-1,,1,sell,0,sell,0.5,0,0,0,block 1 (G first),22.0,12.0,Male,1.0,1.0,1.0,"[3, 'block 1 (G first)']",1,1,0,0.0,3.0,-0.7,0.5,0.0,,0.0,5,0.5,1.0,Design 1,Design 1,Only trade on Design #1,4.0,,
2491,4056,3,Player object (1062),sell,2023-03-09 20:33:27.610167+00:00,"{""priceA"": 180, ""sharesA"": 0, ""secs_since_round_starts"": 335, ""market"": ""A""}",195.0,60.0,5.0,v3ju8jv9,vmu7c279,FULL STUDY,195.0,s4,1,180,170.0,1,10.0,1,buy,0,sell,0.5,0,0,0,block 1 (G first),22.0,12.0,Male,1.0,1.0,1.0,"[3, 'block 1 (G first)']",1,1,0,0.0,3.0,-0.7,0.5,0.0,,0.0,5,0.5,1.0,Design 1,Design 1,Only trade on Design #1,4.0,,
2492,4060,4,Player object (1182),sell,2023-03-09 20:34:12.302900+00:00,"{""priceA"": 140, ""sharesA"": 0, ""secs_since_round_starts"": 39, ""market"": ""A""}",190.0,7.0,1.0,v3ju8jv9,vmu7c279,FULL STUDY,165.0,s4,1,140,,1,,1,,0,sell,0.5,0,0,0,block 1 (G first),22.0,12.0,Male,1.0,1.0,1.0,"[4, 'block 1 (G first)']",0,0,0,0.0,3.0,-0.7,0.6,0.05555555555555555,1.0,0.0,4,0.75,0.5,Design 1,Design 1,Only trade on Design #1,4.0,,
2493,4061,4,Player object (1182),buy,2023-03-09 20:34:15.408914+00:00,"{""priceA"": 130, ""sharesA"": 1, ""secs_since_round_starts"": 42, ""market"": ""A""}",60.0,8.0,2.0,v3ju8jv9,vmu7c279,FULL STUDY,165.0,s4,1,130,140.0,-1,,1,sell,0,sell,0.5,0,0,0,block 1 (G first),22.0,12.0,Male,1.0,1.0,1.0,"[4, 'block 1 (G first)']",0,0,0,0.0,3.0,-0.7,0.6,0.05555555555555555,1.0,0.0,4,0.75,0.5,Design 1,Design 1,Only trade on Design #1,4.0,,
2494,4062,4,Player object (1182),sell,2023-03-09 20:34:19.673341+00:00,"{""priceA"": 140, ""sharesA"": 0, ""secs_since_round_starts"": 46, ""market"": ""A""}",200.0,9.0,3.0,v3ju8jv9,vmu7c279,FULL STUDY,165.0,s4,1,140,130.0,1,10.0,1,buy,0,sell,0.5,0,0,0,block 1 (G first),22.0,12.0,Male,1.0,1.0,1.0,"[4, 'block 1 (G first)']",0,0,0,0.0,3.0,-0.7,0.6,0.05555555555555555,1.0,0.0,4,0.75,0.5,Design 1,Design 1,Only trade on Design #1,4.0,,
2495,4063,4,Player object (1182),buy,2023-03-09 20:34:24.920842+00:00,"{""priceA"": 135, ""sharesA"": 1, ""secs_since_round_starts"": 51, ""market"": ""A""}",65.0,10.0,4.0,v3ju8jv9,vmu7c279,FULL STUDY,165.0,s4,1,135,140.0,-1,,1,sell,0,sell,0.5,0,0,0,block 1 (G first),22.0,12.0,Male,1.0,1.0,1.0,"[4, 'block 1 (G first)']",0,0,0,0.0,3.0,-0.7,0.6,0.05555555555555555,1.0,0.0,4,0.75,0.5,Design 1,Design 1,Only trade on Design #1,4.0,,
2496,4065,4,Player object (1182),sell,2023-03-09 20:37:09.522337+00:00,"{""priceA"": 90, ""sharesA"": 0, ""secs_since_round_starts"": 216, ""market"": ""A""}",155.0,38.0,5.0,v3ju8jv9,vmu7c279,FULL STUDY,165.0,s4,1,90,135.0,1,-45.0,1,buy,0,sell,0.5,0,0,0,block 1 (G first),22.0,12.0,Male,1.0,1.0,1.0,"[4, 'block 1 (G first)']",0,0,0,0.0,3.0,-0.7,0.6,0.05555555555555555,1.0,0.0,4,0.75,0.5,Design 1,Design 1,Only trade on Design #1,4.0,,
2497,4066,4,Player object (1182),buy,2023-03-09 20:37:12.947547+00:00,"{""priceA"": 85, ""sharesA"": 1, ""secs_since_round_starts"": 219, ""market"": ""A""}",70.0,39.0,6.0,v3ju8jv9,vmu7c279,FULL STUDY,165.0,s4,1,85,90.0,-1,,1,sell,0,sell,0.5,0,0,0,block 1 (G first),22.0,12.0,Male,1.0,1.0,1.0,"[4, 'block 1 (G first)']",0,0,0,0.0,3.0,-0.7,0.6,0.05555555555555555,1.0,0.0,4,0.75,0.5,Design 1,Design 1,Only trade on Design #1,4.0,,
2498,4067,4,Player object (1182),sell,2023-03-09 20:37:33.198213+00:00,"{""priceA"": 90, ""sharesA"": 0, ""secs_since_round_starts"": 240, ""market"": ""A""}",160.0,42.0,7.0,v3ju8jv9,vmu7c279,FULL STUDY,165.0,s4,1,90,85.0,1,5.0,1,buy,0,sell,0.5,0,0,0,block 1 (G first),22.0,12.0,Male,1.0,1.0,1.0,"[4, 'block 1 (G first)']",0,0,0,0.0,3.0,-0.7,0.6,0.05555555555555555,1.0,0.0,4,0.75,0.5,Design 1,Design 1,Only trade on Design #1,4.0,,
2499,4068,4,Player object (1182),buy,2023-03-09 20:37:35.994859+00:00,"{""priceA"": 105, ""sharesA"": 1, ""secs_since_round_starts"": 242, ""market"": ""A""}",55.0,43.0,8.0,v3ju8jv9,vmu7c279,FULL STUDY,165.0,s4,1,105,90.0,-1,,1,sell,0,sell,0.5,0,0,0,block 1 (G first),22.0,12.0,Male,1.0,1.0,1.0,"[4, 'block 1 (G first)']",0,0,0,0.0,3.0,-0.7,0.6,0.05555555555555555,1.0,0.0,4,0.75,0.5,Design 1,Design 1,Only trade on Design #1,4.0,,
2500,4069,4,Player object (1182),sell,2023-03-09 20:37:48.276862+00:00,"{""priceA"": 110, ""sharesA"": 0, ""secs_since_round_starts"": 255, ""market"": ""A""}",165.0,45.0,9.0,v3ju8jv9,vmu7c279,FULL STUDY,165.0,s4,1,110,105.0,1,5.0,1,buy,0,sell,0.5,0,0,0,block 1 (G first),22.0,12.0,Male,1.0,1.0,1.0,"[4, 'block 1 (G first)']",0,0,0,0.0,3.0,-0.7,0.6,0.05555555555555555,1.0,0.0,4,0.75,0.5,Design 1,Design 1,Only trade on Design #1,4.0,,
2501,4070,4,Player object (1182),buy,2023-03-09 20:37:51.730723+00:00,"{""priceA"": 100, ""sharesA"": 1, ""secs_since_round_starts"": 258, ""market"": ""A""}",65.0,46.0,10.0,v3ju8jv9,vmu7c279,FULL STUDY,165.0,s4,1,100,110.0,-1,,1,sell,0,sell,0.5,0,0,0,block 1 (G first),22.0,12.0,Male,1.0,1.0,1.0,"[4, 'block 1 (G first)']",0,0,0,0.0,3.0,-0.7,0.6,0.05555555555555555,1.0,0.0,4,0.75,0.5,Design 1,Design 1,Only trade on Design #1,4.0,,
2502,4071,4,Player object (1182),sell,2023-03-09 20:37:58.152649+00:00,"{""priceA"": 110, ""sharesA"": 0, ""secs_since_round_starts"": 265, ""market"": ""A""}",175.0,47.0,11.0,v3ju8jv9,vmu7c279,FULL STUDY,165.0,s4,1,110,100.0,1,10.0,1,buy,0,sell,0.5,0,0,0,block 1 (G first),22.0,12.0,Male,1.0,1.0,1.0,"[4, 'block 1 (G first)']",0,0,0,0.0,3.0,-0.7,0.6,0.05555555555555555,1.0,0.0,4,0.75,0.5,Design 1,Design 1,Only trade on Design #1,4.0,,
2503,4072,4,Player object (1182),buy,2023-03-09 20:38:02.856984+00:00,"{""priceA"": 120, ""sharesA"": 1, ""secs_since_round_starts"": 269, ""market"": ""A""}",55.0,48.0,12.0,v3ju8jv9,vmu7c279,FULL STUDY,165.0,s4,1,120,110.0,-1,,1,sell,0,sell,0.5,0,0,0,block 1 (G first),22.0,12.0,Male,1.0,1.0,1.0,"[4, 'block 1 (G first)']",0,0,0,0.0,3.0,-0.7,0.6,0.05555555555555555,1.0,0.0,4,0.75,0.5,Design 1,Design 1,Only trade on Design #1,4.0,,
2504,4073,4,Player object (1182),sell,2023-03-09 20:38:08.526725+00:00,"{""priceA"": 125, ""sharesA"": 0, ""secs_since_round_starts"": 275, ""market"": ""A""}",180.0,49.0,13.0,v3ju8jv9,vmu7c279,FULL STUDY,165.0,s4,1,125,120.0,1,5.0,1,buy,0,sell,0.5,0,0,1,block 1 (G first),22.0,12.0,Male,1.0,1.0,1.0,"[4, 'block 1 (G first)']",0,0,0,0.0,3.0,-0.7,0.6,0.05555555555555555,1.0,0.0,4,0.75,0.5,Design 1,Design 1,Only trade on Design #1,4.0,,
2505,4074,4,Player object (1182),buy,2023-03-09 20:38:16.317167+00:00,"{""priceA"": 140, ""sharesA"": 1, ""secs_since_round_starts"": 283, ""market"": ""A""}",40.0,50.0,14.0,v3ju8jv9,vmu7c279,FULL STUDY,165.0,s4,1,140,125.0,-1,,1,sell,0,sell,0.5,0,0,0,block 1 (G first),22.0,12.0,Male,1.0,1.0,1.0,"[4, 'block 1 (G first)']",0,0,0,0.0,3.0,-0.7,0.6,0.05555555555555555,1.0,0.0,4,0.75,0.5,Design 1,Design 1,Only trade on Design #1,4.0,,
2506,4075,4,Player object (1182),sell,2023-03-09 20:38:47.772659+00:00,"{""priceA"": 120, ""sharesA"": 0, ""secs_since_round_starts"": 314, ""market"": ""A""}",160.0,56.0,15.0,v3ju8jv9,vmu7c279,FULL STUDY,165.0,s4,1,120,140.0,1,-20.0,1,buy,0,sell,0.5,0,0,0,block 1 (G first),22.0,12.0,Male,1.0,1.0,1.0,"[4, 'block 1 (G first)']",0,0,0,0.0,3.0,-0.7,0.6,0.05555555555555555,1.0,0.0,4,0.75,0.5,Design 1,Design 1,Only trade on Design #1,4.0,,
2507,4076,4,Player object (1182),buy,2023-03-09 20:39:05.117369+00:00,"{""priceA"": 155, ""sharesA"": 1, ""secs_since_round_starts"": 332, ""market"": ""A""}",5.0,59.0,16.0,v3ju8jv9,vmu7c279,FULL STUDY,165.0,s4,1,155,120.0,-1,,1,sell,0,sell,0.5,0,0,1,block 1 (G first),22.0,12.0,Male,1.0,1.0,1.0,"[4, 'block 1 (G first)']",0,0,0,0.0,3.0,-0.7,0.6,0.05555555555555555,1.0,0.0,4,0.75,0.5,Design 1,Design 1,Only trade on Design #1,4.0,,
2508,4080,5,Player object (1302),sell,2023-03-09 20:39:45.764624+00:00,"{""priceA"": 130, ""sharesA"": 0, ""secs_since_round_starts"": 29, ""market"": ""A""}",180.0,6.0,1.0,v3ju8jv9,vmu7c279,FULL STUDY,165.0,s4,1,130,,1,,1,,0,sell,0.5,0,0,1,block 1 (G first),22.0,12.0,Male,1.0,1.0,1.0,"[5, 'block 1 (G first)']",0,1,0,0.0,3.0,-0.7,0.6,0.3,1.0,0.3333333333333333,4,0.75,0.5,Design 1,Design 1,Only trade on Design #1,4.0,,
2509,4081,5,Player object (1302),buy,2023-03-09 20:39:49.600455+00:00,"{""priceA"": 125, ""sharesA"": 1, ""secs_since_round_starts"": 33, ""market"": ""A""}",55.0,7.0,2.0,v3ju8jv9,vmu7c279,FULL STUDY,165.0,s4,1,125,130.0,-1,,1,sell,0,sell,0.5,0,0,0,block 1 (G first),22.0,12.0,Male,1.0,1.0,1.0,"[5, 'block 1 (G first)']",0,1,0,0.0,3.0,-0.7,0.6,0.3,1.0,0.3333333333333333,4,0.75,0.5,Design 1,Design 1,Only trade on Design #1,4.0,,
2510,4082,5,Player object (1302),sell,2023-03-09 20:40:04.687752+00:00,"{""priceA"": 120, ""sharesA"": 0, ""secs_since_round_starts"": 48, ""market"": ""A""}",175.0,9.0,3.0,v3ju8jv9,vmu7c279,FULL STUDY,165.0,s4,1,120,125.0,1,-5.0,1,buy,0,sell,0.5,0,0,0,block 1 (G first),22.0,12.0,Male,1.0,1.0,1.0,"[5, 'block 1 (G first)']",0,1,0,0.0,3.0,-0.7,0.6,0.3,1.0,0.3333333333333333,4,0.75,0.5,Design 1,Design 1,Only trade on Design #1,4.0,,
2511,4083,5,Player object (1302),buy,2023-03-09 20:40:08.532678+00:00,"{""priceA"": 135, ""sharesA"": 1, ""secs_since_round_starts"": 52, ""market"": ""A""}",40.0,10.0,4.0,v3ju8jv9,vmu7c279,FULL STUDY,165.0,s4,1,135,120.0,-1,,1,sell,0,sell,0.5,0,0,0,block 1 (G first),22.0,12.0,Male,1.0,1.0,1.0,"[5, 'block 1 (G first)']",0,1,0,0.0,3.0,-0.7,0.6,0.3,1.0,0.3333333333333333,4,0.75,0.5,Design 1,Design 1,Only trade on Design #1,4.0,,
2512,4084,5,Player object (1302),sell,2023-03-09 20:40:15.440732+00:00,"{""priceA"": 130, ""sharesA"": 0, ""secs_since_round_starts"": 59, ""market"": ""A""}",170.0,11.0,5.0,v3ju8jv9,vmu7c279,FULL STUDY,165.0,s4,1,130,135.0,1,-5.0,1,buy,0,sell,0.5,0,0,0,block 1 (G first),22.0,12.0,Male,1.0,1.0,1.0,"[5, 'block 1 (G first)']",0,1,0,0.0,3.0,-0.7,0.6,0.3,1.0,0.3333333333333333,4,0.75,0.5,Design 1,Design 1,Only trade on Design #1,4.0,,
2513,4085,5,Player object (1302),buy,2023-03-09 20:40:40.553850+00:00,"{""priceA"": 140, ""sharesA"": 1, ""secs_since_round_starts"": 84, ""market"": ""A""}",30.0,16.0,6.0,v3ju8jv9,vmu7c279,FULL STUDY,165.0,s4,1,140,130.0,-1,,1,sell,0,sell,0.5,0,0,0,block 1 (G first),22.0,12.0,Male,1.0,1.0,1.0,"[5, 'block 1 (G first)']",0,1,0,0.0,3.0,-0.7,0.6,0.3,1.0,0.3333333333333333,4,0.75,0.5,Design 1,Design 1,Only trade on Design #1,4.0,,
2514,4086,5,Player object (1302),sell,2023-03-09 20:41:08.324812+00:00,"{""priceA"": 120, ""sharesA"": 0, ""secs_since_round_starts"": 111, ""market"": ""A""}",150.0,21.0,7.0,v3ju8jv9,vmu7c279,FULL STUDY,165.0,s4,1,120,140.0,1,-20.0,1,buy,0,sell,0.5,0,0,0,block 1 (G first),22.0,12.0,Male,1.0,1.0,1.0,"[5, 'block 1 (G first)']",0,1,0,0.0,3.0,-0.7,0.6,0.3,1.0,0.3333333333333333,4,0.75,0.5,Design 1,Design 1,Only trade on Design #1,4.0,,
2515,4087,5,Player object (1302),buy,2023-03-09 20:41:14.260018+00:00,"{""priceA"": 135, ""sharesA"": 1, ""secs_since_round_starts"": 117, ""market"": ""A""}",15.0,22.0,8.0,v3ju8jv9,vmu7c279,FULL STUDY,165.0,s4,1,135,120.0,-1,,1,sell,0,sell,0.5,0,0,1,block 1 (G first),22.0,12.0,Male,1.0,1.0,1.0,"[5, 'block 1 (G first)']",0,1,0,0.0,3.0,-0.7,0.6,0.3,1.0,0.3333333333333333,4,0.75,0.5,Design 1,Design 1,Only trade on Design #1,4.0,,
2516,4088,5,Player object (1302),sell,2023-03-09 20:41:19.022527+00:00,"{""priceA"": 150, ""sharesA"": 0, ""secs_since_round_starts"": 122, ""market"": ""A""}",165.0,23.0,9.0,v3ju8jv9,vmu7c279,FULL STUDY,165.0,s4,1,150,135.0,1,15.0,1,buy,0,sell,0.5,0,0,0,block 1 (G first),22.0,12.0,Male,1.0,1.0,1.0,"[5, 'block 1 (G first)']",0,1,0,0.0,3.0,-0.7,0.6,0.3,1.0,0.3333333333333333,4,0.75,0.5,Design 1,Design 1,Only trade on Design #1,4.0,,
2517,4089,5,Player object (1302),buy,2023-03-09 20:41:45.134866+00:00,"{""priceA"": 140, ""sharesA"": 1, ""secs_since_round_starts"": 148, ""market"": ""A""}",25.0,28.0,10.0,v3ju8jv9,vmu7c279,FULL STUDY,165.0,s4,1,140,150.0,-1,,1,sell,0,sell,0.5,0,0,0,block 1 (G first),22.0,12.0,Male,1.0,1.0,1.0,"[5, 'block 1 (G first)']",0,1,0,0.0,3.0,-0.7,0.6,0.3,1.0,0.3333333333333333,4,0.75,0.5,Design 1,Design 1,Only trade on Design #1,4.0,,
2518,4091,5,Player object (1302),sell,2023-03-09 20:42:09.028169+00:00,"{""priceA"": 140, ""sharesA"": 0, ""secs_since_round_starts"": 172, ""market"": ""A""}",165.0,32.0,11.0,v3ju8jv9,vmu7c279,FULL STUDY,165.0,s4,1,140,140.0,1,0.0,1,buy,0,sell,0.5,0,0,0,block 1 (G first),22.0,12.0,Male,1.0,1.0,1.0,"[5, 'block 1 (G first)']",0,1,0,0.0,3.0,-0.7,0.6,0.3,1.0,0.3333333333333333,4,0.75,0.5,Design 1,Design 1,Only trade on Design #1,4.0,,
2519,4092,5,Player object (1302),buy,2023-03-09 20:42:13.316762+00:00,"{""priceA"": 125, ""sharesA"": 1, ""secs_since_round_starts"": 176, ""market"": ""A""}",40.0,33.0,12.0,v3ju8jv9,vmu7c279,FULL STUDY,165.0,s4,1,125,140.0,-1,,1,sell,0,sell,0.5,0,0,0,block 1 (G first),22.0,12.0,Male,1.0,1.0,1.0,"[5, 'block 1 (G first)']",0,1,0,0.0,3.0,-0.7,0.6,0.3,1.0,0.3333333333333333,4,0.75,0.5,Design 1,Design 1,Only trade on Design #1,4.0,,
2520,4093,5,Player object (1302),sell,2023-03-09 20:42:19.197522+00:00,"{""priceA"": 140, ""sharesA"": 0, ""secs_since_round_starts"": 182, ""market"": ""A""}",180.0,34.0,13.0,v3ju8jv9,vmu7c279,FULL STUDY,165.0,s4,1,140,125.0,1,15.0,1,buy,0,sell,0.5,0,0,0,block 1 (G first),22.0,12.0,Male,1.0,1.0,1.0,"[5, 'block 1 (G first)']",0,1,0,0.0,3.0,-0.7,0.6,0.3,1.0,0.3333333333333333,4,0.75,0.5,Design 1,Design 1,Only trade on Design #1,4.0,,
2521,4094,5,Player object (1302),buy,2023-03-09 20:42:23.375775+00:00,"{""priceA"": 125, ""sharesA"": 1, ""secs_since_round_starts"": 187, ""market"": ""A""}",55.0,35.0,14.0,v3ju8jv9,vmu7c279,FULL STUDY,165.0,s4,1,125,140.0,-1,,1,sell,0,sell,0.5,0,0,0,block 1 (G first),22.0,12.0,Male,1.0,1.0,1.0,"[5, 'block 1 (G first)']",0,1,0,0.0,3.0,-0.7,0.6,0.3,1.0,0.3333333333333333,4,0.75,0.5,Design 1,Design 1,Only trade on Design #1,4.0,,
2522,4095,5,Player object (1302),sell,2023-03-09 20:42:28.501844+00:00,"{""priceA"": 140, ""sharesA"": 0, ""secs_since_round_starts"": 192, ""market"": ""A""}",195.0,36.0,15.0,v3ju8jv9,vmu7c279,FULL STUDY,165.0,s4,1,140,125.0,1,15.0,1,buy,0,sell,0.5,0,0,0,block 1 (G first),22.0,12.0,Male,1.0,1.0,1.0,"[5, 'block 1 (G first)']",0,1,0,0.0,3.0,-0.7,0.6,0.3,1.0,0.3333333333333333,4,0.75,0.5,Design 1,Design 1,Only trade on Design #1,4.0,,
2523,4096,5,Player object (1302),buy,2023-03-09 20:42:47.150048+00:00,"{""priceA"": 135, ""sharesA"": 1, ""secs_since_round_starts"": 210, ""market"": ""A""}",60.0,39.0,16.0,v3ju8jv9,vmu7c279,FULL STUDY,165.0,s4,1,135,140.0,-1,,1,sell,0,sell,0.5,0,0,0,block 1 (G first),22.0,12.0,Male,1.0,1.0,1.0,"[5, 'block 1 (G first)']",0,1,0,0.0,3.0,-0.7,0.6,0.3,1.0,0.3333333333333333,4,0.75,0.5,Design 1,Design 1,Only trade on Design #1,4.0,,
2524,4099,5,Player object (1302),sell,2023-03-09 20:43:10.684787+00:00,"{""priceA"": 115, ""sharesA"": 0, ""secs_since_round_starts"": 234, ""market"": ""A""}",175.0,43.0,18.0,v3ju8jv9,vmu7c279,FULL STUDY,165.0,s4,1,115,120.0,1,-5.0,1,buy,0,sell,0.5,0,0,0,block 1 (G first),22.0,12.0,Male,1.0,1.0,1.0,"[5, 'block 1 (G first)']",0,1,0,0.0,3.0,-0.7,0.6,0.3,1.0,0.3333333333333333,4,0.75,0.5,Design 1,Design 1,Only trade on Design #1,4.0,,
2525,4100,5,Player object (1302),buy,2023-03-09 20:43:13.225402+00:00,"{""priceA"": 125, ""sharesA"": 1, ""secs_since_round_starts"": 236, ""market"": ""A""}",50.0,44.0,19.0,v3ju8jv9,vmu7c279,FULL STUDY,165.0,s4,1,125,115.0,-1,,1,sell,0,sell,0.5,0,0,0,block 1 (G first),22.0,12.0,Male,1.0,1.0,1.0,"[5, 'block 1 (G first)']",0,1,0,0.0,3.0,-0.7,0.6,0.3,1.0,0.3333333333333333,4,0.75,0.5,Design 1,Design 1,Only trade on Design #1,4.0,,
2526,4101,5,Player object (1302),sell,2023-03-09 20:43:24.864886+00:00,"{""priceA"": 130, ""sharesA"": 0, ""secs_since_round_starts"": 248, ""market"": ""A""}",180.0,46.0,20.0,v3ju8jv9,vmu7c279,FULL STUDY,165.0,s4,1,130,125.0,1,5.0,1,buy,0,sell,0.5,0,0,0,block 1 (G first),22.0,12.0,Male,1.0,1.0,1.0,"[5, 'block 1 (G first)']",0,1,0,0.0,3.0,-0.7,0.6,0.3,1.0,0.3333333333333333,4,0.75,0.5,Design 1,Design 1,Only trade on Design #1,4.0,,
2527,4102,5,Player object (1302),buy,2023-03-09 20:43:30.329191+00:00,"{""priceA"": 115, ""sharesA"": 1, ""secs_since_round_starts"": 254, ""market"": ""A""}",65.0,47.0,21.0,v3ju8jv9,vmu7c279,FULL STUDY,165.0,s4,1,115,130.0,-1,,1,sell,0,sell,0.5,0,0,0,block 1 (G first),22.0,12.0,Male,1.0,1.0,1.0,"[5, 'block 1 (G first)']",0,1,0,0.0,3.0,-0.7,0.6,0.3,1.0,0.3333333333333333,4,0.75,0.5,Design 1,Design 1,Only trade on Design #1,4.0,,
2528,4103,5,Player object (1302),sell,2023-03-09 20:43:43.788560+00:00,"{""priceA"": 100, ""sharesA"": 0, ""secs_since_round_starts"": 267, ""market"": ""A""}",165.0,49.0,22.0,v3ju8jv9,vmu7c279,FULL STUDY,165.0,s4,1,100,115.0,1,-15.0,1,buy,0,sell,0.5,0,1,0,block 1 (G first),22.0,12.0,Male,1.0,1.0,1.0,"[5, 'block 1 (G first)']",0,1,0,0.0,3.0,-0.7,0.6,0.3,1.0,0.3333333333333333,4,0.75,0.5,Design 1,Design 1,Only trade on Design #1,4.0,,
2529,4104,5,Player object (1302),buy,2023-03-09 20:43:48.366193+00:00,"{""priceA"": 105, ""sharesA"": 1, ""secs_since_round_starts"": 272, ""market"": ""A""}",60.0,50.0,23.0,v3ju8jv9,vmu7c279,FULL STUDY,165.0,s4,1,105,100.0,-1,,1,sell,0,sell,0.5,0,0,0,block 1 (G first),22.0,12.0,Male,1.0,1.0,1.0,"[5, 'block 1 (G first)']",0,1,0,0.0,3.0,-0.7,0.6,0.3,1.0,0.3333333333333333,4,0.75,0.5,Design 1,Design 1,Only trade on Design #1,4.0,,
2530,4107,5,Player object (1302),sell,2023-03-09 20:44:13.788324+00:00,"{""priceA"": 90, ""sharesA"": 0, ""secs_since_round_starts"": 297, ""market"": ""A""}",150.0,55.0,25.0,v3ju8jv9,vmu7c279,FULL STUDY,165.0,s4,1,90,115.0,1,-25.0,1,buy,0,sell,0.5,0,0,0,block 1 (G first),22.0,12.0,Male,1.0,1.0,1.0,"[5, 'block 1 (G first)']",0,1,0,0.0,3.0,-0.7,0.6,0.3,1.0,0.3333333333333333,4,0.75,0.5,Design 1,Design 1,Only trade on Design #1,4.0,,
2531,4108,5,Player object (1302),buy,2023-03-09 20:44:24.155172+00:00,"{""priceA"": 90, ""sharesA"": 1, ""secs_since_round_starts"": 307, ""market"": ""A""}",60.0,57.0,26.0,v3ju8jv9,vmu7c279,FULL STUDY,165.0,s4,1,90,90.0,-1,,1,sell,0,sell,0.5,0,0,0,block 1 (G first),22.0,12.0,Male,1.0,1.0,1.0,"[5, 'block 1 (G first)']",0,1,0,0.0,3.0,-0.7,0.6,0.3,1.0,0.3333333333333333,4,0.75,0.5,Design 1,Design 1,Only trade on Design #1,4.0,,
2532,4109,5,Player object (1302),sell,2023-03-09 20:44:37.563634+00:00,"{""priceA"": 105, ""sharesA"": 0, ""secs_since_round_starts"": 321, ""market"": ""A""}",165.0,59.0,27.0,v3ju8jv9,vmu7c279,FULL STUDY,165.0,s4,1,105,90.0,1,15.0,1,buy,0,sell,0.5,0,0,1,block 1 (G first),22.0,12.0,Male,1.0,1.0,1.0,"[5, 'block 1 (G first)']",0,1,0,0.0,3.0,-0.7,0.6,0.3,1.0,0.3333333333333333,4,0.75,0.5,Design 1,Design 1,Only trade on Design #1,4.0,,
2533,4110,5,Player object (1302),buy,2023-03-09 20:44:41.618593+00:00,"{""priceA"": 95, ""sharesA"": 1, ""secs_since_round_starts"": 325, ""market"": ""A""}",70.0,60.0,28.0,v3ju8jv9,vmu7c279,FULL STUDY,165.0,s4,1,95,105.0,-1,,1,sell,0,sell,0.5,0,0,0,block 1 (G first),22.0,12.0,Male,1.0,1.0,1.0,"[5, 'block 1 (G first)']",0,1,0,0.0,3.0,-0.7,0.6,0.3,1.0,0.3333333333333333,4,0.75,0.5,Design 1,Design 1,Only trade on Design #1,4.0,,
2534,5425,2,Player object (1535),sell,2023-03-10 14:19:42.778453+00:00,"{""priceA"": 85, ""sharesA"": 0, ""secs_since_round_starts"": 37, ""market"": ""A""}",135.0,8.0,1.0,vha118yy,t7od4xlw,FULL STUDY,170.0,s3,1,85,,1,,1,,0,sell,0.4422758127435268,16,1,0,block 2 (G first),23.0,12.0,Male,0.0,0.0,0.0,"[2, 'block 2 (G first)']",1,1,0,0.5,5.0,-0.5,0.5,0.09523809523809523,1.0,0.25,4,1.0,0.75,Design 1,Design 2,"Have an option between Design #1 and Design #2,",3.0,2.0,3.0
2535,5426,2,Player object (1535),buy,2023-03-10 14:20:01.336033+00:00,"{""priceA"": 80, ""sharesA"": 1, ""secs_since_round_starts"": 55, ""market"": ""A""}",55.0,12.0,2.0,vha118yy,t7od4xlw,FULL STUDY,170.0,s3,1,80,85.0,-1,,1,sell,0,sell,0.502087716794639,16,0,0,block 2 (G first),23.0,12.0,Male,0.0,0.0,0.0,"[2, 'block 2 (G first)']",1,1,0,0.5,5.0,-0.5,0.5,0.09523809523809523,1.0,0.25,4,1.0,0.75,Design 1,Design 2,"Have an option between Design #1 and Design #2,",3.0,2.0,3.0
2536,5427,2,Player object (1535),sell,2023-03-10 14:20:16.337433+00:00,"{""priceA"": 105, ""sharesA"": 0, ""secs_since_round_starts"": 70, ""market"": ""A""}",160.0,14.0,3.0,vha118yy,t7od4xlw,FULL STUDY,170.0,s3,1,105,80.0,1,25.0,1,buy,0,sell,0.5600744319669811,16,0,1,block 2 (G first),23.0,12.0,Male,0.0,0.0,0.0,"[2, 'block 2 (G first)']",1,1,0,0.5,5.0,-0.5,0.5,0.09523809523809523,1.0,0.25,4,1.0,0.75,Design 1,Design 2,"Have an option between Design #1 and Design #2,",3.0,2.0,3.0
2537,5428,2,Player object (1535),buy,2023-03-10 14:21:02.928370+00:00,"{""priceA"": 150, ""sharesA"": 1, ""secs_since_round_starts"": 117, ""market"": ""A""}",10.0,23.0,4.0,vha118yy,t7od4xlw,FULL STUDY,170.0,s3,1,150,105.0,-1,,1,sell,0,sell,0.5825581483921976,16,0,1,block 2 (G first),23.0,12.0,Male,0.0,0.0,0.0,"[2, 'block 2 (G first)']",1,1,0,0.5,5.0,-0.5,0.5,0.09523809523809523,1.0,0.25,4,1.0,0.75,Design 1,Design 2,"Have an option between Design #1 and Design #2,",3.0,2.0,3.0
2538,5430,2,Player object (1535),sell,2023-03-10 14:21:53.396320+00:00,"{""priceA"": 135, ""sharesA"": 0, ""secs_since_round_starts"": 167, ""market"": ""A""}",145.0,32.0,5.0,vha118yy,t7od4xlw,FULL STUDY,170.0,s3,1,135,150.0,1,-15.0,1,buy,0,sell,0.5488776546772527,16,0,1,block 2 (G first),23.0,12.0,Male,0.0,0.0,0.0,"[2, 'block 2 (G first)']",1,1,0,0.5,5.0,-0.5,0.5,0.09523809523809523,1.0,0.25,4,1.0,0.75,Design 1,Design 2,"Have an option between Design #1 and Design #2,",3.0,2.0,3.0
2539,5431,2,Player object (1535),buy,2023-03-10 14:22:03.017025+00:00,"{""priceA"": 125, ""sharesA"": 1, ""secs_since_round_starts"": 177, ""market"": ""A""}",20.0,34.0,6.0,vha118yy,t7od4xlw,FULL STUDY,170.0,s3,1,125,135.0,-1,,1,sell,0,sell,0.4644502626891607,16,0,0,block 2 (G first),23.0,12.0,Male,0.0,0.0,0.0,"[2, 'block 2 (G first)']",1,1,0,0.5,5.0,-0.5,0.5,0.09523809523809523,1.0,0.25,4,1.0,0.75,Design 1,Design 2,"Have an option between Design #1 and Design #2,",3.0,2.0,3.0
2540,5432,2,Player object (1535),sell,2023-03-10 14:22:09.367024+00:00,"{""priceA"": 140, ""sharesA"": 0, ""secs_since_round_starts"": 183, ""market"": ""A""}",160.0,35.0,7.0,vha118yy,t7od4xlw,FULL STUDY,170.0,s3,1,140,125.0,1,15.0,1,buy,0,sell,0.5101876173062244,16,0,0,block 2 (G first),23.0,12.0,Male,0.0,0.0,0.0,"[2, 'block 2 (G first)']",1,1,0,0.5,5.0,-0.5,0.5,0.09523809523809523,1.0,0.25,4,1.0,0.75,Design 1,Design 2,"Have an option between Design #1 and Design #2,",3.0,2.0,3.0
2541,5433,2,Player object (1535),buy,2023-03-10 14:22:23.880461+00:00,"{""priceA"": 140, ""sharesA"": 1, ""secs_since_round_starts"": 198, ""market"": ""A""}",20.0,38.0,8.0,vha118yy,t7od4xlw,FULL STUDY,170.0,s3,1,140,140.0,-1,,1,sell,0,sell,0.4611129934091434,16,0,0,block 2 (G first),23.0,12.0,Male,0.0,0.0,0.0,"[2, 'block 2 (G first)']",1,1,0,0.5,5.0,-0.5,0.5,0.09523809523809523,1.0,0.25,4,1.0,0.75,Design 1,Design 2,"Have an option between Design #1 and Design #2,",3.0,2.0,3.0
2542,5434,2,Player object (1535),sell,2023-03-10 14:23:06.745091+00:00,"{""priceA"": 155, ""sharesA"": 0, ""secs_since_round_starts"": 241, ""market"": ""A""}",175.0,46.0,9.0,vha118yy,t7od4xlw,FULL STUDY,170.0,s3,1,155,140.0,1,15.0,1,buy,0,sell,0.5495494947508355,16,0,1,block 2 (G first),23.0,12.0,Male,0.0,0.0,0.0,"[2, 'block 2 (G first)']",1,1,0,0.5,5.0,-0.5,0.5,0.09523809523809523,1.0,0.25,4,1.0,0.75,Design 1,Design 2,"Have an option between Design #1 and Design #2,",3.0,2.0,3.0
2543,5436,2,Player object (1535),buy,2023-03-10 14:23:37.238959+00:00,"{""priceA"": 140, ""sharesA"": 1, ""secs_since_round_starts"": 271, ""market"": ""A""}",35.0,51.0,10.0,vha118yy,t7od4xlw,FULL STUDY,170.0,s3,1,140,155.0,-1,,1,sell,0,sell,0.4693918893964308,16,0,0,block 2 (G first),23.0,12.0,Male,0.0,0.0,0.0,"[2, 'block 2 (G first)']",1,1,0,0.5,5.0,-0.5,0.5,0.09523809523809523,1.0,0.25,4,1.0,0.75,Design 1,Design 2,"Have an option between Design #1 and Design #2,",3.0,2.0,3.0
2544,5439,2,Player object (1535),sell,2023-03-10 14:23:59.457481+00:00,"{""priceA"": 145, ""sharesA"": 0, ""secs_since_round_starts"": 293, ""market"": ""A""}",180.0,54.0,11.0,vha118yy,t7od4xlw,FULL STUDY,170.0,s3,1,145,140.0,1,5.0,1,buy,0,sell,0.5320134037503595,16,0,0,block 2 (G first),23.0,12.0,Male,0.0,0.0,0.0,"[2, 'block 2 (G first)']",1,1,0,0.5,5.0,-0.5,0.5,0.09523809523809523,1.0,0.25,4,1.0,0.75,Design 1,Design 2,"Have an option between Design #1 and Design #2,",3.0,2.0,3.0
2545,5440,2,Player object (1535),buy,2023-03-10 14:24:03.278430+00:00,"{""priceA"": 135, ""sharesA"": 1, ""secs_since_round_starts"": 297, ""market"": ""A""}",45.0,55.0,12.0,vha118yy,t7od4xlw,FULL STUDY,170.0,s3,1,135,145.0,-1,,1,sell,0,sell,0.4873282494519479,16,0,0,block 2 (G first),23.0,12.0,Male,0.0,0.0,0.0,"[2, 'block 2 (G first)']",1,1,0,0.5,5.0,-0.5,0.5,0.09523809523809523,1.0,0.25,4,1.0,0.75,Design 1,Design 2,"Have an option between Design #1 and Design #2,",3.0,2.0,3.0
2546,5449,3,Player object (1715),sell,2023-03-10 14:25:14.564571+00:00,"{""priceA"": 100, ""sharesA"": 0, ""secs_since_round_starts"": 37, ""market"": ""A""}",150.0,8.0,1.0,vha118yy,t7od4xlw,FULL STUDY,230.0,s3,1,100,,1,,1,,0,sell,0.5057155770500936,19,0,0,block 2 (G first),23.0,12.0,Male,0.0,0.0,0.0,"[3, 'block 2 (G first)']",1,0,0,0.5,5.0,-0.5,0.6363636363636364,0.058823529411764705,1.0,0.0,4,1.0,0.75,Design 1,Design 2,"Have an option between Design #1 and Design #2,",3.0,2.0,3.0
2547,5451,3,Player object (1715),buy,2023-03-10 14:25:23.139387+00:00,"{""priceA"": 95, ""sharesA"": 1, ""secs_since_round_starts"": 45, ""market"": ""A""}",55.0,10.0,2.0,vha118yy,t7od4xlw,FULL STUDY,230.0,s3,1,95,100.0,-1,,1,sell,0,sell,0.4922087569005138,19,0,0,block 2 (G first),23.0,12.0,Male,0.0,0.0,0.0,"[3, 'block 2 (G first)']",1,0,0,0.5,5.0,-0.5,0.6363636363636364,0.058823529411764705,1.0,0.0,4,1.0,0.75,Design 1,Design 2,"Have an option between Design #1 and Design #2,",3.0,2.0,3.0
2548,5453,3,Player object (1715),sell,2023-03-10 14:25:40.843270+00:00,"{""priceA"": 130, ""sharesA"": 0, ""secs_since_round_starts"": 63, ""market"": ""A""}",185.0,13.0,3.0,vha118yy,t7od4xlw,FULL STUDY,230.0,s3,1,130,95.0,1,35.0,1,buy,0,sell,0.5729625045047859,19,0,1,block 2 (G first),23.0,12.0,Male,0.0,0.0,0.0,"[3, 'block 2 (G first)']",1,0,0,0.5,5.0,-0.5,0.6363636363636364,0.058823529411764705,1.0,0.0,4,1.0,0.75,Design 1,Design 2,"Have an option between Design #1 and Design #2,",3.0,2.0,3.0
2549,5456,3,Player object (1715),buy,2023-03-10 14:25:50.944350+00:00,"{""priceA"": 110, ""sharesA"": 1, ""secs_since_round_starts"": 73, ""market"": ""A""}",75.0,15.0,4.0,vha118yy,t7od4xlw,FULL STUDY,230.0,s3,1,110,130.0,-1,,1,sell,0,sell,0.4763410641166328,19,0,0,block 2 (G first),23.0,12.0,Male,0.0,0.0,0.0,"[3, 'block 2 (G first)']",1,0,0,0.5,5.0,-0.5,0.6363636363636364,0.058823529411764705,1.0,0.0,4,1.0,0.75,Design 1,Design 2,"Have an option between Design #1 and Design #2,",3.0,2.0,3.0
2550,5460,3,Player object (1715),sell,2023-03-10 14:26:14.088990+00:00,"{""priceA"": 120, ""sharesA"": 0, ""secs_since_round_starts"": 96, ""market"": ""A""}",195.0,19.0,5.0,vha118yy,t7od4xlw,FULL STUDY,230.0,s3,1,120,110.0,1,10.0,1,buy,0,sell,0.5586446427659006,19,0,1,block 2 (G first),23.0,12.0,Male,0.0,0.0,0.0,"[3, 'block 2 (G first)']",1,0,0,0.5,5.0,-0.5,0.6363636363636364,0.058823529411764705,1.0,0.0,4,1.0,0.75,Design 1,Design 2,"Have an option between Design #1 and Design #2,",3.0,2.0,3.0
2551,5463,3,Player object (1715),buy,2023-03-10 14:26:23.618568+00:00,"{""priceA"": 100, ""sharesA"": 1, ""secs_since_round_starts"": 106, ""market"": ""A""}",95.0,21.0,6.0,vha118yy,t7od4xlw,FULL STUDY,230.0,s3,1,100,120.0,-1,,1,sell,0,sell,0.4692484881524699,19,0,0,block 2 (G first),23.0,12.0,Male,0.0,0.0,0.0,"[3, 'block 2 (G first)']",1,0,0,0.5,5.0,-0.5,0.6363636363636364,0.058823529411764705,1.0,0.0,4,1.0,0.75,Design 1,Design 2,"Have an option between Design #1 and Design #2,",3.0,2.0,3.0
2552,5471,3,Player object (1715),sell,2023-03-10 14:26:42.562674+00:00,"{""priceA"": 115, ""sharesA"": 0, ""secs_since_round_starts"": 125, ""market"": ""A""}",210.0,24.0,7.0,vha118yy,t7od4xlw,FULL STUDY,230.0,s3,1,115,100.0,1,15.0,1,buy,0,sell,0.5319650978870379,19,0,0,block 2 (G first),23.0,12.0,Male,0.0,0.0,0.0,"[3, 'block 2 (G first)']",1,0,0,0.5,5.0,-0.5,0.6363636363636364,0.058823529411764705,1.0,0.0,4,1.0,0.75,Design 1,Design 2,"Have an option between Design #1 and Design #2,",3.0,2.0,3.0
2553,5476,3,Player object (1715),buy,2023-03-10 14:26:58.467247+00:00,"{""priceA"": 105, ""sharesA"": 1, ""secs_since_round_starts"": 141, ""market"": ""A""}",105.0,27.0,8.0,vha118yy,t7od4xlw,FULL STUDY,230.0,s3,1,105,115.0,-1,,1,sell,0,sell,0.4832330156747784,19,0,0,block 2 (G first),23.0,12.0,Male,0.0,0.0,0.0,"[3, 'block 2 (G first)']",1,0,0,0.5,5.0,-0.5,0.6363636363636364,0.058823529411764705,1.0,0.0,4,1.0,0.75,Design 1,Design 2,"Have an option between Design #1 and Design #2,",3.0,2.0,3.0
2554,5478,3,Player object (1715),sell,2023-03-10 14:27:15.358180+00:00,"{""priceA"": 120, ""sharesA"": 0, ""secs_since_round_starts"": 157, ""market"": ""A""}",225.0,30.0,9.0,vha118yy,t7od4xlw,FULL STUDY,230.0,s3,1,120,105.0,1,15.0,1,buy,0,sell,0.570054331362491,19,0,1,block 2 (G first),23.0,12.0,Male,0.0,0.0,0.0,"[3, 'block 2 (G first)']",1,0,0,0.5,5.0,-0.5,0.6363636363636364,0.058823529411764705,1.0,0.0,4,1.0,0.75,Design 1,Design 2,"Have an option between Design #1 and Design #2,",3.0,2.0,3.0
2555,5480,3,Player object (1715),buy,2023-03-10 14:27:24.274463+00:00,"{""priceA"": 110, ""sharesA"": 1, ""secs_since_round_starts"": 166, ""market"": ""A""}",115.0,32.0,10.0,vha118yy,t7od4xlw,FULL STUDY,230.0,s3,1,110,120.0,-1,,1,sell,0,sell,0.4748947710808772,19,0,0,block 2 (G first),23.0,12.0,Male,0.0,0.0,0.0,"[3, 'block 2 (G first)']",1,0,0,0.5,5.0,-0.5,0.6363636363636364,0.058823529411764705,1.0,0.0,4,1.0,0.75,Design 1,Design 2,"Have an option between Design #1 and Design #2,",3.0,2.0,3.0
2556,5491,3,Player object (1715),sell,2023-03-10 14:28:07.034672+00:00,"{""priceA"": 115, ""sharesA"": 0, ""secs_since_round_starts"": 209, ""market"": ""A""}",230.0,39.0,11.0,vha118yy,t7od4xlw,FULL STUDY,230.0,s3,1,115,110.0,1,5.0,1,buy,0,sell,0.5221490272476892,19,0,0,block 2 (G first),23.0,12.0,Male,0.0,0.0,0.0,"[3, 'block 2 (G first)']",1,0,0,0.5,5.0,-0.5,0.6363636363636364,0.058823529411764705,1.0,0.0,4,1.0,0.75,Design 1,Design 2,"Have an option between Design #1 and Design #2,",3.0,2.0,3.0
2557,5493,3,Player object (1715),buy,2023-03-10 14:28:12.503489+00:00,"{""priceA"": 100, ""sharesA"": 1, ""secs_since_round_starts"": 215, ""market"": ""A""}",130.0,40.0,12.0,vha118yy,t7od4xlw,FULL STUDY,230.0,s3,1,100,115.0,-1,,1,sell,0,sell,0.4804175727303482,19,0,0,block 2 (G first),23.0,12.0,Male,0.0,0.0,0.0,"[3, 'block 2 (G first)']",1,0,0,0.5,5.0,-0.5,0.6363636363636364,0.058823529411764705,1.0,0.0,4,1.0,0.75,Design 1,Design 2,"Have an option between Design #1 and Design #2,",3.0,2.0,3.0
2558,5495,3,Player object (1715),sell,2023-03-10 14:28:24.866962+00:00,"{""priceA"": 105, ""sharesA"": 0, ""secs_since_round_starts"": 227, ""market"": ""A""}",235.0,42.0,13.0,vha118yy,t7od4xlw,FULL STUDY,230.0,s3,1,105,100.0,1,5.0,1,buy,0,sell,0.5010477910686952,19,0,0,block 2 (G first),23.0,12.0,Male,0.0,0.0,0.0,"[3, 'block 2 (G first)']",1,0,0,0.5,5.0,-0.5,0.6363636363636364,0.058823529411764705,1.0,0.0,4,1.0,0.75,Design 1,Design 2,"Have an option between Design #1 and Design #2,",3.0,2.0,3.0
2559,5505,3,Player object (1715),buy,2023-03-10 14:28:58.075330+00:00,"{""priceA"": 125, ""sharesA"": 1, ""secs_since_round_starts"": 260, ""market"": ""A""}",110.0,48.0,14.0,vha118yy,t7od4xlw,FULL STUDY,230.0,s3,1,125,105.0,-1,,1,sell,0,sell,0.4599698795591006,19,0,0,block 2 (G first),23.0,12.0,Male,0.0,0.0,0.0,"[3, 'block 2 (G first)']",1,0,0,0.5,5.0,-0.5,0.6363636363636364,0.058823529411764705,1.0,0.0,4,1.0,0.75,Design 1,Design 2,"Have an option between Design #1 and Design #2,",3.0,2.0,3.0
2560,5510,3,Player object (1715),sell,2023-03-10 14:29:13.634636+00:00,"{""priceA"": 120, ""sharesA"": 0, ""secs_since_round_starts"": 276, ""market"": ""A""}",230.0,51.0,15.0,vha118yy,t7od4xlw,FULL STUDY,230.0,s3,1,120,125.0,1,-5.0,1,buy,0,sell,0.4588602748157505,19,0,0,block 2 (G first),23.0,12.0,Male,0.0,0.0,0.0,"[3, 'block 2 (G first)']",1,0,0,0.5,5.0,-0.5,0.6363636363636364,0.058823529411764705,1.0,0.0,4,1.0,0.75,Design 1,Design 2,"Have an option between Design #1 and Design #2,",3.0,2.0,3.0
2561,5516,3,Player object (1715),buy,2023-03-10 14:29:23.550409+00:00,"{""priceA"": 115, ""sharesA"": 1, ""secs_since_round_starts"": 286, ""market"": ""A""}",115.0,52.0,16.0,vha118yy,t7od4xlw,FULL STUDY,230.0,s3,1,115,120.0,-1,,1,sell,0,sell,0.4367228334197354,19,0,0,block 2 (G first),23.0,12.0,Male,0.0,0.0,0.0,"[3, 'block 2 (G first)']",1,0,0,0.5,5.0,-0.5,0.6363636363636364,0.058823529411764705,1.0,0.0,4,1.0,0.75,Design 1,Design 2,"Have an option between Design #1 and Design #2,",3.0,2.0,3.0
2562,5517,3,Player object (1715),sell,2023-03-10 14:29:28.220099+00:00,"{""priceA"": 130, ""sharesA"": 0, ""secs_since_round_starts"": 290, ""market"": ""A""}",245.0,53.0,17.0,vha118yy,t7od4xlw,FULL STUDY,230.0,s3,1,130,115.0,1,15.0,1,buy,0,sell,0.4905868559773416,19,0,0,block 2 (G first),23.0,12.0,Male,0.0,0.0,0.0,"[3, 'block 2 (G first)']",1,0,0,0.5,5.0,-0.5,0.6363636363636364,0.058823529411764705,1.0,0.0,4,1.0,0.75,Design 1,Design 2,"Have an option between Design #1 and Design #2,",3.0,2.0,3.0
2563,5518,3,Player object (1715),buy,2023-03-10 14:29:51.576468+00:00,"{""priceA"": 130, ""sharesA"": 1, ""secs_since_round_starts"": 314, ""market"": ""A""}",115.0,57.0,18.0,vha118yy,t7od4xlw,FULL STUDY,230.0,s3,1,130,130.0,-1,,1,sell,0,sell,0.46726452652799,19,0,0,block 2 (G first),23.0,12.0,Male,0.0,0.0,0.0,"[3, 'block 2 (G first)']",1,0,0,0.5,5.0,-0.5,0.6363636363636364,0.058823529411764705,1.0,0.0,4,1.0,0.75,Design 1,Design 2,"Have an option between Design #1 and Design #2,",3.0,2.0,3.0
2564,5530,4,Player object (1895),sell,2023-03-10 14:31:10.726026+00:00,"{""priceA"": 90, ""sharesA"": 0, ""secs_since_round_starts"": 55, ""market"": ""A""}",140.0,12.0,1.0,vha118yy,t7od4xlw,FULL STUDY,195.0,s3,1,90,,1,,1,,0,sell,0.5210961257750505,14,0,0,block 2 (G first),23.0,12.0,Male,0.0,0.0,0.0,"[4, 'block 2 (G first)']",0,1,0,0.5,5.0,-0.5,0.42857142857142855,0.03333333333333333,,0.0,4,0.5,0.75,Design 1,Design 2,"Have an option between Design #1 and Design #2,",3.0,2.0,3.0
2565,5533,4,Player object (1895),buy,2023-03-10 14:31:19.084481+00:00,"{""priceA"": 75, ""sharesA"": 1, ""secs_since_round_starts"": 63, ""market"": ""A""}",65.0,13.0,2.0,vha118yy,t7od4xlw,FULL STUDY,195.0,s3,1,75,90.0,-1,,1,sell,0,sell,0.479681559969247,14,0,0,block 2 (G first),23.0,12.0,Male,0.0,0.0,0.0,"[4, 'block 2 (G first)']",0,1,0,0.5,5.0,-0.5,0.42857142857142855,0.03333333333333333,,0.0,4,0.5,0.75,Design 1,Design 2,"Have an option between Design #1 and Design #2,",3.0,2.0,3.0
2566,5535,4,Player object (1895),sell,2023-03-10 14:31:22.252397+00:00,"{""priceA"": 90, ""sharesA"": 0, ""secs_since_round_starts"": 66, ""market"": ""A""}",155.0,14.0,3.0,vha118yy,t7od4xlw,FULL STUDY,195.0,s3,1,90,75.0,1,15.0,1,buy,0,sell,0.5208618681016636,14,0,0,block 2 (G first),23.0,12.0,Male,0.0,0.0,0.0,"[4, 'block 2 (G first)']",0,1,0,0.5,5.0,-0.5,0.42857142857142855,0.03333333333333333,,0.0,4,0.5,0.75,Design 1,Design 2,"Have an option between Design #1 and Design #2,",3.0,2.0,3.0
2567,5538,4,Player object (1895),buy,2023-03-10 14:31:28.312393+00:00,"{""priceA"": 95, ""sharesA"": 1, ""secs_since_round_starts"": 72, ""market"": ""A""}",60.0,15.0,4.0,vha118yy,t7od4xlw,FULL STUDY,195.0,s3,1,95,90.0,-1,,1,sell,0,sell,0.5493972040799432,14,0,0,block 2 (G first),23.0,12.0,Male,0.0,0.0,0.0,"[4, 'block 2 (G first)']",0,1,0,0.5,5.0,-0.5,0.42857142857142855,0.03333333333333333,,0.0,4,0.5,0.75,Design 1,Design 2,"Have an option between Design #1 and Design #2,",3.0,2.0,3.0
2568,5573,4,Player object (1895),sell,2023-03-10 14:33:01.659280+00:00,"{""priceA"": 95, ""sharesA"": 0, ""secs_since_round_starts"": 166, ""market"": ""A""}",155.0,32.0,6.0,vha118yy,t7od4xlw,FULL STUDY,195.0,s3,1,95,65.0,1,30.0,1,buy,0,sell,0.5179404569050043,14,0,0,block 2 (G first),23.0,12.0,Male,0.0,0.0,0.0,"[4, 'block 2 (G first)']",0,1,0,0.5,5.0,-0.5,0.42857142857142855,0.03333333333333333,,0.0,4,0.5,0.75,Design 1,Design 2,"Have an option between Design #1 and Design #2,",3.0,2.0,3.0
2569,5577,4,Player object (1895),buy,2023-03-10 14:33:25.932382+00:00,"{""priceA"": 70, ""sharesA"": 1, ""secs_since_round_starts"": 190, ""market"": ""A""}",85.0,37.0,7.0,vha118yy,t7od4xlw,FULL STUDY,195.0,s3,1,70,95.0,-1,,1,sell,0,sell,0.4570673777008929,14,0,0,block 2 (G first),23.0,12.0,Male,0.0,0.0,0.0,"[4, 'block 2 (G first)']",0,1,0,0.5,5.0,-0.5,0.42857142857142855,0.03333333333333333,,0.0,4,0.5,0.75,Design 1,Design 2,"Have an option between Design #1 and Design #2,",3.0,2.0,3.0
2570,5583,4,Player object (1895),sell,2023-03-10 14:33:53.965175+00:00,"{""priceA"": 95, ""sharesA"": 0, ""secs_since_round_starts"": 218, ""market"": ""A""}",180.0,42.0,8.0,vha118yy,t7od4xlw,FULL STUDY,195.0,s3,1,95,70.0,1,25.0,1,buy,0,sell,0.5388552795609507,14,0,0,block 2 (G first),23.0,12.0,Male,0.0,0.0,0.0,"[4, 'block 2 (G first)']",0,1,0,0.5,5.0,-0.5,0.42857142857142855,0.03333333333333333,,0.0,4,0.5,0.75,Design 1,Design 2,"Have an option between Design #1 and Design #2,",3.0,2.0,3.0
2571,5589,4,Player object (1895),buy,2023-03-10 14:34:22.774862+00:00,"{""priceA"": 85, ""sharesA"": 1, ""secs_since_round_starts"": 247, ""market"": ""A""}",95.0,47.0,9.0,vha118yy,t7od4xlw,FULL STUDY,195.0,s3,1,85,95.0,-1,,1,sell,0,sell,0.4501495476988393,14,1,0,block 2 (G first),23.0,12.0,Male,0.0,0.0,0.0,"[4, 'block 2 (G first)']",0,1,0,0.5,5.0,-0.5,0.42857142857142855,0.03333333333333333,,0.0,4,0.5,0.75,Design 1,Design 2,"Have an option between Design #1 and Design #2,",3.0,2.0,3.0
2572,5590,4,Player object (1895),sell,2023-03-10 14:34:27.032637+00:00,"{""priceA"": 100, ""sharesA"": 0, ""secs_since_round_starts"": 251, ""market"": ""A""}",195.0,48.0,10.0,vha118yy,t7od4xlw,FULL STUDY,195.0,s3,1,100,85.0,1,15.0,1,buy,0,sell,0.500105737602651,14,0,0,block 2 (G first),23.0,12.0,Male,0.0,0.0,0.0,"[4, 'block 2 (G first)']",0,1,0,0.5,5.0,-0.5,0.42857142857142855,0.03333333333333333,,0.0,4,0.5,0.75,Design 1,Design 2,"Have an option between Design #1 and Design #2,",3.0,2.0,3.0
2573,5599,4,Player object (1895),buy,2023-03-10 14:34:55.424578+00:00,"{""priceA"": 75, ""sharesA"": 1, ""secs_since_round_starts"": 280, ""market"": ""A""}",120.0,53.0,11.0,vha118yy,t7od4xlw,FULL STUDY,195.0,s3,1,75,100.0,-1,,1,sell,0,sell,0.4439854633835125,14,1,0,block 2 (G first),23.0,12.0,Male,0.0,0.0,0.0,"[4, 'block 2 (G first)']",0,1,0,0.5,5.0,-0.5,0.42857142857142855,0.03333333333333333,,0.0,4,0.5,0.75,Design 1,Design 2,"Have an option between Design #1 and Design #2,",3.0,2.0,3.0
2574,5618,5,Player object (2075),sell,2023-03-10 14:36:07.293587+00:00,"{""priceA"": 100, ""sharesA"": 0, ""secs_since_round_starts"": 27, ""market"": ""A""}",150.0,7.0,1.0,vha118yy,t7od4xlw,FULL STUDY,250.0,s3,1,100,,1,,1,,0,sell,0.5733994727268583,17,0,0,block 2 (G first),23.0,12.0,Male,0.0,0.0,0.0,"[5, 'block 2 (G first)']",0,0,0,0.5,5.0,-0.5,0.38461538461538464,0.0,1.0,0.0,4,0.5,0.75,Design 1,Design 2,"Have an option between Design #1 and Design #2,",3.0,2.0,3.0
2575,5624,5,Player object (2075),buy,2023-03-10 14:36:25.040389+00:00,"{""priceA"": 75, ""sharesA"": 1, ""secs_since_round_starts"": 45, ""market"": ""A""}",75.0,10.0,2.0,vha118yy,t7od4xlw,FULL STUDY,250.0,s3,1,75,100.0,-1,,1,sell,0,sell,0.4488309348307913,17,1,0,block 2 (G first),23.0,12.0,Male,0.0,0.0,0.0,"[5, 'block 2 (G first)']",0,0,0,0.5,5.0,-0.5,0.38461538461538464,0.0,1.0,0.0,4,0.5,0.75,Design 1,Design 2,"Have an option between Design #1 and Design #2,",3.0,2.0,3.0
2576,5626,5,Player object (2075),sell,2023-03-10 14:36:33.848399+00:00,"{""priceA"": 85, ""sharesA"": 0, ""secs_since_round_starts"": 54, ""market"": ""A""}",160.0,11.0,3.0,vha118yy,t7od4xlw,FULL STUDY,250.0,s3,1,85,75.0,1,10.0,1,buy,0,sell,0.4991731929932316,17,0,0,block 2 (G first),23.0,12.0,Male,0.0,0.0,0.0,"[5, 'block 2 (G first)']",0,0,0,0.5,5.0,-0.5,0.38461538461538464,0.0,1.0,0.0,4,0.5,0.75,Design 1,Design 2,"Have an option between Design #1 and Design #2,",3.0,2.0,3.0
2577,5628,5,Player object (2075),buy,2023-03-10 14:37:09.000464+00:00,"{""priceA"": 70, ""sharesA"": 1, ""secs_since_round_starts"": 89, ""market"": ""A""}",90.0,18.0,4.0,vha118yy,t7od4xlw,FULL STUDY,250.0,s3,1,70,85.0,-1,,1,sell,0,sell,0.42621223683237,17,1,0,block 2 (G first),23.0,12.0,Male,0.0,0.0,0.0,"[5, 'block 2 (G first)']",0,0,0,0.5,5.0,-0.5,0.38461538461538464,0.0,1.0,0.0,4,0.5,0.75,Design 1,Design 2,"Have an option between Design #1 and Design #2,",3.0,2.0,3.0
2578,5629,5,Player object (2075),sell,2023-03-10 14:37:23.492430+00:00,"{""priceA"": 95, ""sharesA"": 0, ""secs_since_round_starts"": 104, ""market"": ""A""}",185.0,20.0,5.0,vha118yy,t7od4xlw,FULL STUDY,250.0,s3,1,95,70.0,1,25.0,1,buy,0,sell,0.5232479875730728,17,0,0,block 2 (G first),23.0,12.0,Male,0.0,0.0,0.0,"[5, 'block 2 (G first)']",0,0,0,0.5,5.0,-0.5,0.38461538461538464,0.0,1.0,0.0,4,0.5,0.75,Design 1,Design 2,"Have an option between Design #1 and Design #2,",3.0,2.0,3.0
2579,5639,5,Player object (2075),buy,2023-03-10 14:38:15.218072+00:00,"{""priceA"": 70, ""sharesA"": 1, ""secs_since_round_starts"": 155, ""market"": ""A""}",115.0,30.0,6.0,vha118yy,t7od4xlw,FULL STUDY,250.0,s3,1,70,95.0,-1,,1,sell,0,sell,0.4174526841611717,17,0,0,block 2 (G first),23.0,12.0,Male,0.0,0.0,0.0,"[5, 'block 2 (G first)']",0,0,0,0.5,5.0,-0.5,0.38461538461538464,0.0,1.0,0.0,4,0.5,0.75,Design 1,Design 2,"Have an option between Design #1 and Design #2,",3.0,2.0,3.0
2580,5643,5,Player object (2075),sell,2023-03-10 14:38:27.673364+00:00,"{""priceA"": 95, ""sharesA"": 0, ""secs_since_round_starts"": 168, ""market"": ""A""}",210.0,32.0,7.0,vha118yy,t7od4xlw,FULL STUDY,250.0,s3,1,95,70.0,1,25.0,1,buy,0,sell,0.5188715333997952,17,0,0,block 2 (G first),23.0,12.0,Male,0.0,0.0,0.0,"[5, 'block 2 (G first)']",0,0,0,0.5,5.0,-0.5,0.38461538461538464,0.0,1.0,0.0,4,0.5,0.75,Design 1,Design 2,"Have an option between Design #1 and Design #2,",3.0,2.0,3.0
2581,5646,5,Player object (2075),buy,2023-03-10 14:39:03.188020+00:00,"{""priceA"": 70, ""sharesA"": 1, ""secs_since_round_starts"": 203, ""market"": ""A""}",140.0,39.0,8.0,vha118yy,t7od4xlw,FULL STUDY,250.0,s3,1,70,95.0,-1,,1,sell,0,sell,0.4317803147869401,17,0,0,block 2 (G first),23.0,12.0,Male,0.0,0.0,0.0,"[5, 'block 2 (G first)']",0,0,0,0.5,5.0,-0.5,0.38461538461538464,0.0,1.0,0.0,4,0.5,0.75,Design 1,Design 2,"Have an option between Design #1 and Design #2,",3.0,2.0,3.0
2582,5648,5,Player object (2075),sell,2023-03-10 14:39:19.948468+00:00,"{""priceA"": 100, ""sharesA"": 0, ""secs_since_round_starts"": 220, ""market"": ""A""}",240.0,42.0,9.0,vha118yy,t7od4xlw,FULL STUDY,250.0,s3,1,100,70.0,1,30.0,1,buy,0,sell,0.5529358605422235,17,0,1,block 2 (G first),23.0,12.0,Male,0.0,0.0,0.0,"[5, 'block 2 (G first)']",0,0,0,0.5,5.0,-0.5,0.38461538461538464,0.0,1.0,0.0,4,0.5,0.75,Design 1,Design 2,"Have an option between Design #1 and Design #2,",3.0,2.0,3.0
2583,5653,5,Player object (2075),buy,2023-03-10 14:39:56.515751+00:00,"{""priceA"": 75, ""sharesA"": 1, ""secs_since_round_starts"": 257, ""market"": ""A""}",165.0,48.0,10.0,vha118yy,t7od4xlw,FULL STUDY,250.0,s3,1,75,100.0,-1,,1,sell,0,sell,0.4393932183506925,17,1,0,block 2 (G first),23.0,12.0,Male,0.0,0.0,0.0,"[5, 'block 2 (G first)']",0,0,0,0.5,5.0,-0.5,0.38461538461538464,0.0,1.0,0.0,4,0.5,0.75,Design 1,Design 2,"Have an option between Design #1 and Design #2,",3.0,2.0,3.0
2584,5655,5,Player object (2075),sell,2023-03-10 14:40:27.100434+00:00,"{""priceA"": 95, ""sharesA"": 0, ""secs_since_round_starts"": 287, ""market"": ""A""}",260.0,54.0,11.0,vha118yy,t7od4xlw,FULL STUDY,250.0,s3,1,95,75.0,1,20.0,1,buy,0,sell,0.5299980248683189,17,0,0,block 2 (G first),23.0,12.0,Male,0.0,0.0,0.0,"[5, 'block 2 (G first)']",0,0,0,0.5,5.0,-0.5,0.38461538461538464,0.0,1.0,0.0,4,0.5,0.75,Design 1,Design 2,"Have an option between Design #1 and Design #2,",3.0,2.0,3.0
2585,5658,5,Player object (2075),buy,2023-03-10 14:40:47.644457+00:00,"{""priceA"": 75, ""sharesA"": 1, ""secs_since_round_starts"": 308, ""market"": ""A""}",185.0,58.0,12.0,vha118yy,t7od4xlw,FULL STUDY,250.0,s3,1,75,95.0,-1,,1,sell,0,sell,0.4529558772574278,17,0,0,block 2 (G first),23.0,12.0,Male,0.0,0.0,0.0,"[5, 'block 2 (G first)']",0,0,0,0.5,5.0,-0.5,0.38461538461538464,0.0,1.0,0.0,4,0.5,0.75,Design 1,Design 2,"Have an option between Design #1 and Design #2,",3.0,2.0,3.0
2586,4510,2,Player object (953),sell,2023-03-10 01:10:01.381351+00:00,"{""priceA"": 125, ""sharesA"": 0, ""secs_since_round_starts"": 99, ""market"": ""A""}",175.0,18.0,1.0,vjy9du3z,vmu7c279,FULL STUDY,200.0,s3,1,125,,1,,1,,0,sell,0.5678304910935957,16,0,0,block 3 (G second),22.0,12.0,Male,1.0,0.0,0.0,"[2, 'block 3 (G second)']",0,0,1,0.5,10.0,0.0,0.17647058823529413,0.058823529411764705,0.0,0.0,2,0.5,0.25,Design 2,Design 2,"Have an option between Design #1 and Design #2,",5.0,4.0,5.0
2587,4511,2,Player object (953),buy,2023-03-10 01:10:41.059010+00:00,"{""priceA"": 145, ""sharesA"": 1, ""secs_since_round_starts"": 138, ""market"": ""A""}",30.0,25.0,2.0,vjy9du3z,vmu7c279,FULL STUDY,200.0,s3,1,145,125.0,-1,,1,sell,0,sell,0.5294358264188312,16,0,0,block 3 (G second),22.0,12.0,Male,1.0,0.0,0.0,"[2, 'block 3 (G second)']",0,0,1,0.5,10.0,0.0,0.17647058823529413,0.058823529411764705,0.0,0.0,2,0.5,0.25,Design 2,Design 2,"Have an option between Design #1 and Design #2,",5.0,4.0,5.0
2588,4515,2,Player object (953),sell,2023-03-10 01:11:41.217616+00:00,"{""priceA"": 130, ""sharesA"": 0, ""secs_since_round_starts"": 199, ""market"": ""A""}",160.0,33.0,4.0,vjy9du3z,vmu7c279,FULL STUDY,200.0,s3,1,130,120.0,1,10.0,1,buy,0,sell,0.499206602391208,16,0,0,block 3 (G second),22.0,12.0,Male,1.0,0.0,0.0,"[2, 'block 3 (G second)']",0,0,1,0.5,10.0,0.0,0.17647058823529413,0.058823529411764705,0.0,0.0,2,0.5,0.25,Design 2,Design 2,"Have an option between Design #1 and Design #2,",5.0,4.0,5.0
2589,4516,2,Player object (953),buy,2023-03-10 01:11:45.097222+00:00,"{""priceA"": 125, ""sharesA"": 1, ""secs_since_round_starts"": 202, ""market"": ""A""}",35.0,34.0,5.0,vjy9du3z,vmu7c279,FULL STUDY,200.0,s3,1,125,130.0,-1,,1,sell,0,sell,0.4644502626891607,16,0,0,block 3 (G second),22.0,12.0,Male,1.0,0.0,0.0,"[2, 'block 3 (G second)']",0,0,1,0.5,10.0,0.0,0.17647058823529413,0.058823529411764705,0.0,0.0,2,0.5,0.25,Design 2,Design 2,"Have an option between Design #1 and Design #2,",5.0,4.0,5.0
2590,4517,2,Player object (953),sell,2023-03-10 01:11:59.476292+00:00,"{""priceA"": 150, ""sharesA"": 0, ""secs_since_round_starts"": 217, ""market"": ""A""}",185.0,36.0,6.0,vjy9du3z,vmu7c279,FULL STUDY,200.0,s3,1,150,125.0,1,25.0,1,buy,0,sell,0.542045663089369,16,0,0,block 3 (G second),22.0,12.0,Male,1.0,0.0,0.0,"[2, 'block 3 (G second)']",0,0,1,0.5,10.0,0.0,0.17647058823529413,0.058823529411764705,0.0,0.0,2,0.5,0.25,Design 2,Design 2,"Have an option between Design #1 and Design #2,",5.0,4.0,5.0
2591,4518,2,Player object (953),buy,2023-03-10 01:12:12.988956+00:00,"{""priceA"": 125, ""sharesA"": 1, ""secs_since_round_starts"": 230, ""market"": ""A""}",60.0,39.0,7.0,vjy9du3z,vmu7c279,FULL STUDY,200.0,s3,1,125,150.0,-1,,1,sell,0,sell,0.4382592777609274,16,1,0,block 3 (G second),22.0,12.0,Male,1.0,0.0,0.0,"[2, 'block 3 (G second)']",0,0,1,0.5,10.0,0.0,0.17647058823529413,0.058823529411764705,0.0,0.0,2,0.5,0.25,Design 2,Design 2,"Have an option between Design #1 and Design #2,",5.0,4.0,5.0
2592,4521,2,Player object (953),sell,2023-03-10 01:12:46.524080+00:00,"{""priceA"": 140, ""sharesA"": 0, ""secs_since_round_starts"": 264, ""market"": ""A""}",200.0,45.0,9.0,vjy9du3z,vmu7c279,FULL STUDY,200.0,s3,1,140,140.0,1,0.0,1,buy,0,sell,0.5210834711709403,16,0,0,block 3 (G second),22.0,12.0,Male,1.0,0.0,0.0,"[2, 'block 3 (G second)']",0,0,1,0.5,10.0,0.0,0.17647058823529413,0.058823529411764705,0.0,0.0,2,0.5,0.25,Design 2,Design 2,"Have an option between Design #1 and Design #2,",5.0,4.0,5.0
2593,4522,2,Player object (953),buy,2023-03-10 01:13:24.839663+00:00,"{""priceA"": 125, ""sharesA"": 1, ""secs_since_round_starts"": 302, ""market"": ""A""}",75.0,52.0,10.0,vjy9du3z,vmu7c279,FULL STUDY,200.0,s3,1,125,140.0,-1,,1,sell,0,sell,0.4439176376077041,16,1,0,block 3 (G second),22.0,12.0,Male,1.0,0.0,0.0,"[2, 'block 3 (G second)']",0,0,1,0.5,10.0,0.0,0.17647058823529413,0.058823529411764705,0.0,0.0,2,0.5,0.25,Design 2,Design 2,"Have an option between Design #1 and Design #2,",5.0,4.0,5.0
2594,4553,4,Player object (1193),sell,2023-03-10 01:25:37.460249+00:00,"{""priceA"": 70, ""sharesA"": 0, ""secs_since_round_starts"": 44, ""market"": ""A""}",120.0,9.0,1.0,vjy9du3z,vmu7c279,FULL STUDY,175.0,s3,1,70,,1,,1,,0,sell,0.5440818519127735,14,0,1,block 3 (G second),22.0,12.0,Male,1.0,0.0,0.0,"[4, 'block 3 (G second)']",1,0,1,0.5,10.0,0.0,0.5,0.03225806451612903,1.0,0.125,2,1.0,0.25,Design 2,Design 2,"Have an option between Design #1 and Design #2,",5.0,4.0,5.0
2595,4554,4,Player object (1193),buy,2023-03-10 01:25:55.940588+00:00,"{""priceA"": 75, ""sharesA"": 1, ""secs_since_round_starts"": 62, ""market"": ""A""}",45.0,13.0,2.0,vjy9du3z,vmu7c279,FULL STUDY,175.0,s3,1,75,70.0,-1,,1,sell,0,sell,0.479681559969247,14,0,0,block 3 (G second),22.0,12.0,Male,1.0,0.0,0.0,"[4, 'block 3 (G second)']",1,0,1,0.5,10.0,0.0,0.5,0.03225806451612903,1.0,0.125,2,1.0,0.25,Design 2,Design 2,"Have an option between Design #1 and Design #2,",5.0,4.0,5.0
2596,4555,4,Player object (1193),sell,2023-03-10 01:26:15.439396+00:00,"{""priceA"": 90, ""sharesA"": 0, ""secs_since_round_starts"": 82, ""market"": ""A""}",135.0,16.0,3.0,vjy9du3z,vmu7c279,FULL STUDY,175.0,s3,1,90,75.0,1,15.0,1,buy,0,sell,0.4995738325599586,14,0,0,block 3 (G second),22.0,12.0,Male,1.0,0.0,0.0,"[4, 'block 3 (G second)']",1,0,1,0.5,10.0,0.0,0.5,0.03225806451612903,1.0,0.125,2,1.0,0.25,Design 2,Design 2,"Have an option between Design #1 and Design #2,",5.0,4.0,5.0
2597,4556,4,Player object (1193),buy,2023-03-10 01:26:18.153727+00:00,"{""priceA"": 85, ""sharesA"": 1, ""secs_since_round_starts"": 85, ""market"": ""A""}",50.0,17.0,4.0,vjy9du3z,vmu7c279,FULL STUDY,175.0,s3,1,85,90.0,-1,,1,sell,0,sell,0.4647046911342559,14,0,0,block 3 (G second),22.0,12.0,Male,1.0,0.0,0.0,"[4, 'block 3 (G second)']",1,0,1,0.5,10.0,0.0,0.5,0.03225806451612903,1.0,0.125,2,1.0,0.25,Design 2,Design 2,"Have an option between Design #1 and Design #2,",5.0,4.0,5.0
2598,4557,4,Player object (1193),sell,2023-03-10 01:27:26.866880+00:00,"{""priceA"": 90, ""sharesA"": 0, ""secs_since_round_starts"": 153, ""market"": ""A""}",140.0,29.0,5.0,vjy9du3z,vmu7c279,FULL STUDY,175.0,s3,1,90,85.0,1,5.0,1,buy,0,sell,0.5712793841154561,14,0,0,block 3 (G second),22.0,12.0,Male,1.0,0.0,0.0,"[4, 'block 3 (G second)']",1,0,1,0.5,10.0,0.0,0.5,0.03225806451612903,1.0,0.125,2,1.0,0.25,Design 2,Design 2,"Have an option between Design #1 and Design #2,",5.0,4.0,5.0
2599,4559,4,Player object (1193),buy,2023-03-10 01:27:45.425231+00:00,"{""priceA"": 100, ""sharesA"": 1, ""secs_since_round_starts"": 172, ""market"": ""A""}",40.0,33.0,6.0,vjy9du3z,vmu7c279,FULL STUDY,175.0,s3,1,100,90.0,-1,,1,sell,0,sell,0.5473882863317556,14,0,0,block 3 (G second),22.0,12.0,Male,1.0,0.0,0.0,"[4, 'block 3 (G second)']",1,0,1,0.5,10.0,0.0,0.5,0.03225806451612903,1.0,0.125,2,1.0,0.25,Design 2,Design 2,"Have an option between Design #1 and Design #2,",5.0,4.0,5.0
2600,4560,4,Player object (1193),sell,2023-03-10 01:28:46.137665+00:00,"{""priceA"": 115, ""sharesA"": 0, ""secs_since_round_starts"": 233, ""market"": ""A""}",155.0,44.0,7.0,vjy9du3z,vmu7c279,FULL STUDY,175.0,s3,1,115,100.0,1,15.0,1,buy,0,sell,0.5772497941838325,14,0,0,block 3 (G second),22.0,12.0,Male,1.0,0.0,0.0,"[4, 'block 3 (G second)']",1,0,1,0.5,10.0,0.0,0.5,0.03225806451612903,1.0,0.125,2,1.0,0.25,Design 2,Design 2,"Have an option between Design #1 and Design #2,",5.0,4.0,5.0
2601,4561,4,Player object (1193),buy,2023-03-10 01:29:04.449305+00:00,"{""priceA"": 85, ""sharesA"": 1, ""secs_since_round_starts"": 251, ""market"": ""A""}",70.0,47.0,8.0,vjy9du3z,vmu7c279,FULL STUDY,175.0,s3,1,85,115.0,-1,,1,sell,0,sell,0.4501495476988393,14,1,0,block 3 (G second),22.0,12.0,Male,1.0,0.0,0.0,"[4, 'block 3 (G second)']",1,0,1,0.5,10.0,0.0,0.5,0.03225806451612903,1.0,0.125,2,1.0,0.25,Design 2,Design 2,"Have an option between Design #1 and Design #2,",5.0,4.0,5.0
2602,4562,4,Player object (1193),sell,2023-03-10 01:29:20.238916+00:00,"{""priceA"": 120, ""sharesA"": 0, ""secs_since_round_starts"": 267, ""market"": ""A""}",190.0,50.0,9.0,vjy9du3z,vmu7c279,FULL STUDY,175.0,s3,1,120,85.0,1,35.0,1,buy,0,sell,0.5591364702939366,14,0,1,block 3 (G second),22.0,12.0,Male,1.0,0.0,0.0,"[4, 'block 3 (G second)']",1,0,1,0.5,10.0,0.0,0.5,0.03225806451612903,1.0,0.125,2,1.0,0.25,Design 2,Design 2,"Have an option between Design #1 and Design #2,",5.0,4.0,5.0
2603,4563,4,Player object (1193),buy,2023-03-10 01:29:30.995172+00:00,"{""priceA"": 90, ""sharesA"": 1, ""secs_since_round_starts"": 278, ""market"": ""A""}",100.0,52.0,10.0,vjy9du3z,vmu7c279,FULL STUDY,175.0,s3,1,90,120.0,-1,,1,sell,0,sell,0.4694909620846048,14,0,0,block 3 (G second),22.0,12.0,Male,1.0,0.0,0.0,"[4, 'block 3 (G second)']",1,0,1,0.5,10.0,0.0,0.5,0.03225806451612903,1.0,0.125,2,1.0,0.25,Design 2,Design 2,"Have an option between Design #1 and Design #2,",5.0,4.0,5.0
2604,4568,5,Player object (1313),sell,2023-03-10 01:32:22.514987+00:00,"{""priceA"": 105, ""sharesA"": 0, ""secs_since_round_starts"": 117, ""market"": ""A""}",155.0,21.0,1.0,vjy9du3z,vmu7c279,FULL STUDY,245.0,s3,1,105,,1,,1,,0,sell,0.5510362930796925,17,0,1,block 3 (G second),22.0,12.0,Male,1.0,0.0,0.0,"[5, 'block 3 (G second)']",1,1,1,1.0,10.0,0.0,0.5384615384615384,0.0,0.75,0.0,5,0.25,1.0,Design 2,Design 2,"Have an option between Design #1 and Design #2,",5.0,4.0,5.0
2605,4569,5,Player object (1313),buy,2023-03-10 01:32:27.508236+00:00,"{""priceA"": 90, ""sharesA"": 1, ""secs_since_round_starts"": 122, ""market"": ""A""}",65.0,22.0,2.0,vjy9du3z,vmu7c279,FULL STUDY,245.0,s3,1,90,105.0,-1,,1,sell,0,sell,0.5007328859118227,17,0,0,block 3 (G second),22.0,12.0,Male,1.0,0.0,0.0,"[5, 'block 3 (G second)']",1,1,1,1.0,10.0,0.0,0.5384615384615384,0.0,0.75,0.0,5,0.25,1.0,Design 2,Design 2,"Have an option between Design #1 and Design #2,",5.0,4.0,5.0
2606,4570,5,Player object (1313),sell,2023-03-10 01:32:44.200451+00:00,"{""priceA"": 115, ""sharesA"": 0, ""secs_since_round_starts"": 138, ""market"": ""A""}",180.0,25.0,3.0,vjy9du3z,vmu7c279,FULL STUDY,245.0,s3,1,115,90.0,1,25.0,1,buy,0,sell,0.5757035170695836,17,0,1,block 3 (G second),22.0,12.0,Male,1.0,0.0,0.0,"[5, 'block 3 (G second)']",1,1,1,1.0,10.0,0.0,0.5384615384615384,0.0,0.75,0.0,5,0.25,1.0,Design 2,Design 2,"Have an option between Design #1 and Design #2,",5.0,4.0,5.0
2607,4571,5,Player object (1313),buy,2023-03-10 01:33:02.197522+00:00,"{""priceA"": 85, ""sharesA"": 1, ""secs_since_round_starts"": 156, ""market"": ""A""}",95.0,28.0,4.0,vjy9du3z,vmu7c279,FULL STUDY,245.0,s3,1,85,115.0,-1,,1,sell,0,sell,0.4496194529460131,17,1,0,block 3 (G second),22.0,12.0,Male,1.0,0.0,0.0,"[5, 'block 3 (G second)']",1,1,1,1.0,10.0,0.0,0.5384615384615384,0.0,0.75,0.0,5,0.25,1.0,Design 2,Design 2,"Have an option between Design #1 and Design #2,",5.0,4.0,5.0
2608,4573,5,Player object (1313),sell,2023-03-10 01:33:25.532756+00:00,"{""priceA"": 110, ""sharesA"": 0, ""secs_since_round_starts"": 180, ""market"": ""A""}",205.0,33.0,5.0,vjy9du3z,vmu7c279,FULL STUDY,245.0,s3,1,110,85.0,1,25.0,1,buy,0,sell,0.5480287979668599,17,0,1,block 3 (G second),22.0,12.0,Male,1.0,0.0,0.0,"[5, 'block 3 (G second)']",1,1,1,1.0,10.0,0.0,0.5384615384615384,0.0,0.75,0.0,5,0.25,1.0,Design 2,Design 2,"Have an option between Design #1 and Design #2,",5.0,4.0,5.0
2609,4574,5,Player object (1313),buy,2023-03-10 01:33:47.410963+00:00,"{""priceA"": 95, ""sharesA"": 1, ""secs_since_round_starts"": 202, ""market"": ""A""}",110.0,37.0,6.0,vjy9du3z,vmu7c279,FULL STUDY,245.0,s3,1,95,110.0,-1,,1,sell,0,sell,0.4805886028013266,17,0,0,block 3 (G second),22.0,12.0,Male,1.0,0.0,0.0,"[5, 'block 3 (G second)']",1,1,1,1.0,10.0,0.0,0.5384615384615384,0.0,0.75,0.0,5,0.25,1.0,Design 2,Design 2,"Have an option between Design #1 and Design #2,",5.0,4.0,5.0
2610,4575,5,Player object (1313),sell,2023-03-10 01:34:20.349859+00:00,"{""priceA"": 110, ""sharesA"": 0, ""secs_since_round_starts"": 235, ""market"": ""A""}",220.0,43.0,7.0,vjy9du3z,vmu7c279,FULL STUDY,245.0,s3,1,110,95.0,1,15.0,1,buy,0,sell,0.571300234525265,17,0,0,block 3 (G second),22.0,12.0,Male,1.0,0.0,0.0,"[5, 'block 3 (G second)']",1,1,1,1.0,10.0,0.0,0.5384615384615384,0.0,0.75,0.0,5,0.25,1.0,Design 2,Design 2,"Have an option between Design #1 and Design #2,",5.0,4.0,5.0
2611,4576,5,Player object (1313),buy,2023-03-10 01:34:47.992371+00:00,"{""priceA"": 75, ""sharesA"": 1, ""secs_since_round_starts"": 262, ""market"": ""A""}",145.0,48.0,8.0,vjy9du3z,vmu7c279,FULL STUDY,245.0,s3,1,75,110.0,-1,,1,sell,0,sell,0.4393932183506925,17,1,0,block 3 (G second),22.0,12.0,Male,1.0,0.0,0.0,"[5, 'block 3 (G second)']",1,1,1,1.0,10.0,0.0,0.5384615384615384,0.0,0.75,0.0,5,0.25,1.0,Design 2,Design 2,"Have an option between Design #1 and Design #2,",5.0,4.0,5.0
2612,4577,5,Player object (1313),sell,2023-03-10 01:35:12.485976+00:00,"{""priceA"": 95, ""sharesA"": 0, ""secs_since_round_starts"": 287, ""market"": ""A""}",240.0,52.0,9.0,vjy9du3z,vmu7c279,FULL STUDY,245.0,s3,1,95,75.0,1,20.0,1,buy,0,sell,0.5397855680881701,17,0,0,block 3 (G second),22.0,12.0,Male,1.0,0.0,0.0,"[5, 'block 3 (G second)']",1,1,1,1.0,10.0,0.0,0.5384615384615384,0.0,0.75,0.0,5,0.25,1.0,Design 2,Design 2,"Have an option between Design #1 and Design #2,",5.0,4.0,5.0
2613,4578,5,Player object (1313),buy,2023-03-10 01:35:15.302791+00:00,"{""priceA"": 85, ""sharesA"": 1, ""secs_since_round_starts"": 290, ""market"": ""A""}",155.0,53.0,10.0,vjy9du3z,vmu7c279,FULL STUDY,245.0,s3,1,85,95.0,-1,,1,sell,0,sell,0.4927925471404216,17,0,0,block 3 (G second),22.0,12.0,Male,1.0,0.0,0.0,"[5, 'block 3 (G second)']",1,1,1,1.0,10.0,0.0,0.5384615384615384,0.0,0.75,0.0,5,0.25,1.0,Design 2,Design 2,"Have an option between Design #1 and Design #2,",5.0,4.0,5.0
2614,4580,5,Player object (1313),sell,2023-03-10 01:35:26.081650+00:00,"{""priceA"": 95, ""sharesA"": 0, ""secs_since_round_starts"": 300, ""market"": ""A""}",250.0,54.0,11.0,vjy9du3z,vmu7c279,FULL STUDY,245.0,s3,1,95,85.0,1,10.0,1,buy,0,sell,0.5299980248683189,17,0,0,block 3 (G second),22.0,12.0,Male,1.0,0.0,0.0,"[5, 'block 3 (G second)']",1,1,1,1.0,10.0,0.0,0.5384615384615384,0.0,0.75,0.0,5,0.25,1.0,Design 2,Design 2,"Have an option between Design #1 and Design #2,",5.0,4.0,5.0
2615,4581,5,Player object (1313),buy,2023-03-10 01:35:30.561654+00:00,"{""priceA"": 80, ""sharesA"": 1, ""secs_since_round_starts"": 305, ""market"": ""A""}",170.0,55.0,12.0,vjy9du3z,vmu7c279,FULL STUDY,245.0,s3,1,80,95.0,-1,,1,sell,0,sell,0.4859141076178286,17,0,0,block 3 (G second),22.0,12.0,Male,1.0,0.0,0.0,"[5, 'block 3 (G second)']",1,1,1,1.0,10.0,0.0,0.5384615384615384,0.0,0.75,0.0,5,0.25,1.0,Design 2,Design 2,"Have an option between Design #1 and Design #2,",5.0,4.0,5.0
2616,4582,5,Player object (1313),sell,2023-03-10 01:35:36.199628+00:00,"{""priceA"": 95, ""sharesA"": 0, ""secs_since_round_starts"": 310, ""market"": ""A""}",265.0,56.0,13.0,vjy9du3z,vmu7c279,FULL STUDY,245.0,s3,1,95,80.0,1,15.0,1,buy,0,sell,0.5252108989343294,17,0,0,block 3 (G second),22.0,12.0,Male,1.0,0.0,0.0,"[5, 'block 3 (G second)']",1,1,1,1.0,10.0,0.0,0.5384615384615384,0.0,0.75,0.0,5,0.25,1.0,Design 2,Design 2,"Have an option between Design #1 and Design #2,",5.0,4.0,5.0
2617,4583,5,Player object (1313),buy,2023-03-10 01:35:40.681575+00:00,"{""priceA"": 85, ""sharesA"": 1, ""secs_since_round_starts"": 315, ""market"": ""A""}",180.0,57.0,14.0,vjy9du3z,vmu7c279,FULL STUDY,245.0,s3,1,85,95.0,-1,,1,sell,0,sell,0.4825596920859898,17,0,0,block 3 (G second),22.0,12.0,Male,1.0,0.0,0.0,"[5, 'block 3 (G second)']",1,1,1,1.0,10.0,0.0,0.5384615384615384,0.0,0.75,0.0,5,0.25,1.0,Design 2,Design 2,"Have an option between Design #1 and Design #2,",5.0,4.0,5.0
2618,3574,2,Player object (934),sell,2023-03-09 05:00:51.485587+00:00,"{""priceA"": 120, ""sharesA"": 0, ""secs_since_round_starts"": 84, ""market"": ""A""}",170.0,15.0,1.0,vrwqe4da,vmu7c279,FULL STUDY,185.0,s2,1,120,,1,,1,,0,sell,0.5761373211134116,16,0,0,block 4 (G second),20.0,12.0,Female,1.0,0.0,1.0,"[2, 'block 4 (G second)']",0,1,1,0.5,5.0,-0.5,0.2727272727272727,0.0,0.0,0.0,4,1.0,0.5,Design 2,Design 2,"Have an option between Design #1 and Design #2,",5.0,,
2619,3575,2,Player object (934),buy,2023-03-09 05:02:09.619803+00:00,"{""priceA"": 115, ""sharesA"": 1, ""secs_since_round_starts"": 163, ""market"": ""A""}",55.0,29.0,2.0,vrwqe4da,vmu7c279,FULL STUDY,185.0,s2,1,115,120.0,-1,,1,sell,0,sell,0.41991811093665,16,0,0,block 4 (G second),20.0,12.0,Female,1.0,0.0,1.0,"[2, 'block 4 (G second)']",0,1,1,0.5,5.0,-0.5,0.2727272727272727,0.0,0.0,0.0,4,1.0,0.5,Design 2,Design 2,"Have an option between Design #1 and Design #2,",5.0,,
2620,3577,2,Player object (934),sell,2023-03-09 05:02:33.771448+00:00,"{""priceA"": 130, ""sharesA"": 0, ""secs_since_round_starts"": 187, ""market"": ""A""}",185.0,33.0,3.0,vrwqe4da,vmu7c279,FULL STUDY,185.0,s2,1,130,115.0,1,15.0,1,buy,0,sell,0.499206602391208,16,0,0,block 4 (G second),20.0,12.0,Female,1.0,0.0,1.0,"[2, 'block 4 (G second)']",0,1,1,0.5,5.0,-0.5,0.2727272727272727,0.0,0.0,0.0,4,1.0,0.5,Design 2,Design 2,"Have an option between Design #1 and Design #2,",5.0,,
2621,3578,2,Player object (934),buy,2023-03-09 05:03:05.405575+00:00,"{""priceA"": 125, ""sharesA"": 1, ""secs_since_round_starts"": 218, ""market"": ""A""}",60.0,39.0,4.0,vrwqe4da,vmu7c279,FULL STUDY,185.0,s2,1,125,130.0,-1,,1,sell,0,sell,0.4382592777609274,16,1,0,block 4 (G second),20.0,12.0,Female,1.0,0.0,1.0,"[2, 'block 4 (G second)']",0,1,1,0.5,5.0,-0.5,0.2727272727272727,0.0,0.0,0.0,4,1.0,0.5,Design 2,Design 2,"Have an option between Design #1 and Design #2,",5.0,,
2622,3579,2,Player object (934),sell,2023-03-09 05:03:18.759318+00:00,"{""priceA"": 135, ""sharesA"": 0, ""secs_since_round_starts"": 232, ""market"": ""A""}",195.0,41.0,5.0,vrwqe4da,vmu7c279,FULL STUDY,185.0,s2,1,135,125.0,1,10.0,1,buy,0,sell,0.4592429496222846,16,0,0,block 4 (G second),20.0,12.0,Female,1.0,0.0,1.0,"[2, 'block 4 (G second)']",0,1,1,0.5,5.0,-0.5,0.2727272727272727,0.0,0.0,0.0,4,1.0,0.5,Design 2,Design 2,"Have an option between Design #1 and Design #2,",5.0,,
2623,3580,2,Player object (934),buy,2023-03-09 05:04:23.003097+00:00,"{""priceA"": 135, ""sharesA"": 1, ""secs_since_round_starts"": 296, ""market"": ""A""}",60.0,53.0,6.0,vrwqe4da,vmu7c279,FULL STUDY,185.0,s2,1,135,135.0,-1,,1,sell,0,sell,0.4956940487416096,16,0,0,block 4 (G second),20.0,12.0,Female,1.0,0.0,1.0,"[2, 'block 4 (G second)']",0,1,1,0.5,5.0,-0.5,0.2727272727272727,0.0,0.0,0.0,4,1.0,0.5,Design 2,Design 2,"Have an option between Design #1 and Design #2,",5.0,,
2624,3589,3,Player object (1054),sell,2023-03-09 05:08:59.300370+00:00,"{""priceA"": 120, ""sharesA"": 0, ""secs_since_round_starts"": 230, ""market"": ""A""}",170.0,43.0,1.0,vrwqe4da,vmu7c279,FULL STUDY,170.0,s2,1,120,,1,,1,,0,sell,0.5357259670782416,19,0,0,block 4 (G second),20.0,12.0,Female,1.0,0.0,1.0,"[3, 'block 4 (G second)']",0,0,1,0.5,5.0,-0.5,0.041666666666666664,0.0,0.0,0.0,4,1.0,0.75,Design 2,Design 2,"Have an option between Design #1 and Design #2,",5.0,,
2625,3599,4,Player object (1174),sell,2023-03-09 05:13:42.785129+00:00,"{""priceA"": 95, ""sharesA"": 0, ""secs_since_round_starts"": 183, ""market"": ""A""}",145.0,32.0,1.0,vrwqe4da,vmu7c279,FULL STUDY,145.0,s2,1,95,,1,,1,,0,sell,0.5179404569050043,14,0,0,block 4 (G second),20.0,12.0,Female,1.0,0.0,1.0,"[4, 'block 4 (G second)']",1,1,1,0.5,5.0,-0.5,0.0,0.030303030303030304,,0.0,2,1.0,0.5,Design 2,Design 2,"Have an option between Design #1 and Design #2,",5.0,,
2626,3604,4,Player object (1174),buy,2023-03-09 05:15:34.719091+00:00,"{""priceA"": 75, ""sharesA"": 1, ""secs_since_round_starts"": 295, ""market"": ""A""}",70.0,53.0,2.0,vrwqe4da,vmu7c279,FULL STUDY,145.0,s2,1,75,95.0,-1,,1,sell,0,sell,0.4439854633835125,14,1,0,block 4 (G second),20.0,12.0,Female,1.0,0.0,1.0,"[4, 'block 4 (G second)']",1,1,1,0.5,5.0,-0.5,0.0,0.030303030303030304,,0.0,2,1.0,0.5,Design 2,Design 2,"Have an option between Design #1 and Design #2,",5.0,,
2627,3610,5,Player object (1294),sell,2023-03-09 05:18:30.773607+00:00,"{""priceA"": 105, ""sharesA"": 0, ""secs_since_round_starts"": 130, ""market"": ""A""}",155.0,24.0,1.0,vrwqe4da,vmu7c279,FULL STUDY,215.0,s2,1,105,,1,,1,,0,sell,0.5594334008058068,17,0,0,block 4 (G second),20.0,12.0,Female,1.0,0.0,1.0,"[5, 'block 4 (G second)']",1,0,1,0.5,5.0,-0.5,0.3076923076923077,0.0,0.3333333333333333,0.0,2,1.0,0.75,Design 2,Design 2,"Have an option between Design #1 and Design #2,",5.0,,
2628,3612,5,Player object (1294),buy,2023-03-09 05:18:51.961738+00:00,"{""priceA"": 85, ""sharesA"": 1, ""secs_since_round_starts"": 152, ""market"": ""A""}",70.0,28.0,2.0,vrwqe4da,vmu7c279,FULL STUDY,215.0,s2,1,85,105.0,-1,,1,sell,0,sell,0.4496194529460131,17,1,0,block 4 (G second),20.0,12.0,Female,1.0,0.0,1.0,"[5, 'block 4 (G second)']",1,0,1,0.5,5.0,-0.5,0.3076923076923077,0.0,0.3333333333333333,0.0,2,1.0,0.75,Design 2,Design 2,"Have an option between Design #1 and Design #2,",5.0,,
2629,3614,5,Player object (1294),sell,2023-03-09 05:19:20.918455+00:00,"{""priceA"": 110, ""sharesA"": 0, ""secs_since_round_starts"": 181, ""market"": ""A""}",180.0,33.0,3.0,vrwqe4da,vmu7c279,FULL STUDY,215.0,s2,1,110,85.0,1,25.0,1,buy,0,sell,0.5480287979668599,17,0,1,block 4 (G second),20.0,12.0,Female,1.0,0.0,1.0,"[5, 'block 4 (G second)']",1,0,1,0.5,5.0,-0.5,0.3076923076923077,0.0,0.3333333333333333,0.0,2,1.0,0.75,Design 2,Design 2,"Have an option between Design #1 and Design #2,",5.0,,
2630,3615,5,Player object (1294),buy,2023-03-09 05:19:48.627237+00:00,"{""priceA"": 80, ""sharesA"": 1, ""secs_since_round_starts"": 208, ""market"": ""A""}",100.0,38.0,4.0,vrwqe4da,vmu7c279,FULL STUDY,215.0,s2,1,80,110.0,-1,,1,sell,0,sell,0.4515999245786187,17,1,0,block 4 (G second),20.0,12.0,Female,1.0,0.0,1.0,"[5, 'block 4 (G second)']",1,0,1,0.5,5.0,-0.5,0.3076923076923077,0.0,0.3333333333333333,0.0,2,1.0,0.75,Design 2,Design 2,"Have an option between Design #1 and Design #2,",5.0,,
2631,3617,5,Player object (1294),sell,2023-03-09 05:20:21.010006+00:00,"{""priceA"": 105, ""sharesA"": 0, ""secs_since_round_starts"": 241, ""market"": ""A""}",205.0,44.0,5.0,vrwqe4da,vmu7c279,FULL STUDY,215.0,s2,1,105,80.0,1,25.0,1,buy,0,sell,0.515125859635568,17,0,0,block 4 (G second),20.0,12.0,Female,1.0,0.0,1.0,"[5, 'block 4 (G second)']",1,0,1,0.5,5.0,-0.5,0.3076923076923077,0.0,0.3333333333333333,0.0,2,1.0,0.75,Design 2,Design 2,"Have an option between Design #1 and Design #2,",5.0,,
2632,3618,5,Player object (1294),buy,2023-03-09 05:20:42.387409+00:00,"{""priceA"": 75, ""sharesA"": 1, ""secs_since_round_starts"": 262, ""market"": ""A""}",130.0,48.0,6.0,vrwqe4da,vmu7c279,FULL STUDY,215.0,s2,1,75,105.0,-1,,1,sell,0,sell,0.4393932183506925,17,1,0,block 4 (G second),20.0,12.0,Female,1.0,0.0,1.0,"[5, 'block 4 (G second)']",1,0,1,0.5,5.0,-0.5,0.3076923076923077,0.0,0.3333333333333333,0.0,2,1.0,0.75,Design 2,Design 2,"Have an option between Design #1 and Design #2,",5.0,,
2633,3619,5,Player object (1294),sell,2023-03-09 05:21:19.535189+00:00,"{""priceA"": 95, ""sharesA"": 0, ""secs_since_round_starts"": 299, ""market"": ""A""}",225.0,54.0,7.0,vrwqe4da,vmu7c279,FULL STUDY,215.0,s2,1,95,75.0,1,20.0,1,buy,0,sell,0.5299980248683189,17,0,0,block 4 (G second),20.0,12.0,Female,1.0,0.0,1.0,"[5, 'block 4 (G second)']",1,0,1,0.5,5.0,-0.5,0.3076923076923077,0.0,0.3333333333333333,0.0,2,1.0,0.75,Design 2,Design 2,"Have an option between Design #1 and Design #2,",5.0,,
2634,3622,5,Player object (1294),buy,2023-03-09 05:21:38.452626+00:00,"{""priceA"": 75, ""sharesA"": 1, ""secs_since_round_starts"": 318, ""market"": ""A""}",150.0,58.0,8.0,vrwqe4da,vmu7c279,FULL STUDY,215.0,s2,1,75,95.0,-1,,1,sell,0,sell,0.4529558772574278,17,0,0,block 4 (G second),20.0,12.0,Female,1.0,0.0,1.0,"[5, 'block 4 (G second)']",1,0,1,0.5,5.0,-0.5,0.3076923076923077,0.0,0.3333333333333333,0.0,2,1.0,0.75,Design 2,Design 2,"Have an option between Design #1 and Design #2,",5.0,,
2635,4298,2,Player object (946),sell,2023-03-09 22:44:03.788337+00:00,"{""priceA"": 110, ""sharesA"": 0, ""secs_since_round_starts"": 54, ""market"": ""A""}",160.0,6.0,1.0,wpwzt9j0,vmu7c279,FULL STUDY,225.0,s2,1,110,,1,,1,,0,sell,0.5028735207100592,16,0,0,block 2 (G first),22.0,12.0,Male,1.0,1.0,1.0,"[2, 'block 2 (G first)']",1,1,0,1.0,7.0,-0.30000000000000004,0.24,0.125,0.0,0.0,5,0.75,1.0,Design 2,Design 2,"Have an option between Design #1 and Design #2,",3.0,,
2636,4300,2,Player object (946),buy,2023-03-09 22:44:23.761457+00:00,"{""priceA"": 75, ""sharesA"": 1, ""secs_since_round_starts"": 74, ""market"": ""A""}",85.0,10.0,2.0,wpwzt9j0,vmu7c279,FULL STUDY,225.0,s2,1,75,110.0,-1,,1,sell,0,sell,0.4825575314143953,16,0,0,block 2 (G first),22.0,12.0,Male,1.0,1.0,1.0,"[2, 'block 2 (G first)']",1,1,0,1.0,7.0,-0.30000000000000004,0.24,0.125,0.0,0.0,5,0.75,1.0,Design 2,Design 2,"Have an option between Design #1 and Design #2,",3.0,,
2637,4302,2,Player object (946),sell,2023-03-09 22:44:56.531086+00:00,"{""priceA"": 105, ""sharesA"": 0, ""secs_since_round_starts"": 106, ""market"": ""A""}",190.0,16.0,3.0,wpwzt9j0,vmu7c279,FULL STUDY,225.0,s2,1,105,75.0,1,30.0,1,buy,0,sell,0.5185790363913291,16,0,0,block 2 (G first),22.0,12.0,Male,1.0,1.0,1.0,"[2, 'block 2 (G first)']",1,1,0,1.0,7.0,-0.30000000000000004,0.24,0.125,0.0,0.0,5,0.75,1.0,Design 2,Design 2,"Have an option between Design #1 and Design #2,",3.0,,
2638,4304,2,Player object (946),buy,2023-03-09 22:45:02.445880+00:00,"{""priceA"": 110, ""sharesA"": 1, ""secs_since_round_starts"": 112, ""market"": ""A""}",80.0,17.0,4.0,wpwzt9j0,vmu7c279,FULL STUDY,225.0,s2,1,110,105.0,-1,,1,sell,0,sell,0.5478276073026133,16,0,0,block 2 (G first),22.0,12.0,Male,1.0,1.0,1.0,"[2, 'block 2 (G first)']",1,1,0,1.0,7.0,-0.30000000000000004,0.24,0.125,0.0,0.0,5,0.75,1.0,Design 2,Design 2,"Have an option between Design #1 and Design #2,",3.0,,
2639,4307,2,Player object (946),sell,2023-03-09 22:45:45.664625+00:00,"{""priceA"": 145, ""sharesA"": 0, ""secs_since_round_starts"": 156, ""market"": ""A""}",225.0,25.0,5.0,wpwzt9j0,vmu7c279,FULL STUDY,225.0,s2,1,145,110.0,1,35.0,1,buy,0,sell,0.5294358264188312,16,0,0,block 2 (G first),22.0,12.0,Male,1.0,1.0,1.0,"[2, 'block 2 (G first)']",1,1,0,1.0,7.0,-0.30000000000000004,0.24,0.125,0.0,0.0,5,0.75,1.0,Design 2,Design 2,"Have an option between Design #1 and Design #2,",3.0,,
2640,4309,2,Player object (946),buy,2023-03-09 22:46:14.899206+00:00,"{""priceA"": 125, ""sharesA"": 1, ""secs_since_round_starts"": 185, ""market"": ""A""}",100.0,30.0,6.0,wpwzt9j0,vmu7c279,FULL STUDY,225.0,s2,1,125,145.0,-1,,1,sell,0,sell,0.4785999259850118,16,0,0,block 2 (G first),22.0,12.0,Male,1.0,1.0,1.0,"[2, 'block 2 (G first)']",1,1,0,1.0,7.0,-0.30000000000000004,0.24,0.125,0.0,0.0,5,0.75,1.0,Design 2,Design 2,"Have an option between Design #1 and Design #2,",3.0,,
2641,4313,2,Player object (946),sell,2023-03-09 22:46:37.966705+00:00,"{""priceA"": 130, ""sharesA"": 0, ""secs_since_round_starts"": 208, ""market"": ""A""}",230.0,33.0,7.0,wpwzt9j0,vmu7c279,FULL STUDY,225.0,s2,1,130,125.0,1,5.0,1,buy,0,sell,0.499206602391208,16,0,0,block 2 (G first),22.0,12.0,Male,1.0,1.0,1.0,"[2, 'block 2 (G first)']",1,1,0,1.0,7.0,-0.30000000000000004,0.24,0.125,0.0,0.0,5,0.75,1.0,Design 2,Design 2,"Have an option between Design #1 and Design #2,",3.0,,
2642,4315,2,Player object (946),buy,2023-03-09 22:46:48.914352+00:00,"{""priceA"": 140, ""sharesA"": 1, ""secs_since_round_starts"": 219, ""market"": ""A""}",90.0,35.0,8.0,wpwzt9j0,vmu7c279,FULL STUDY,225.0,s2,1,140,130.0,-1,,1,sell,0,sell,0.5101876173062244,16,0,0,block 2 (G first),22.0,12.0,Male,1.0,1.0,1.0,"[2, 'block 2 (G first)']",1,1,0,1.0,7.0,-0.30000000000000004,0.24,0.125,0.0,0.0,5,0.75,1.0,Design 2,Design 2,"Have an option between Design #1 and Design #2,",3.0,,
2643,4319,2,Player object (946),sell,2023-03-09 22:47:01.262160+00:00,"{""priceA"": 145, ""sharesA"": 0, ""secs_since_round_starts"": 231, ""market"": ""A""}",235.0,37.0,9.0,wpwzt9j0,vmu7c279,FULL STUDY,225.0,s2,1,145,140.0,1,5.0,1,buy,0,sell,0.494384744736363,16,0,0,block 2 (G first),22.0,12.0,Male,1.0,1.0,1.0,"[2, 'block 2 (G first)']",1,1,0,1.0,7.0,-0.30000000000000004,0.24,0.125,0.0,0.0,5,0.75,1.0,Design 2,Design 2,"Have an option between Design #1 and Design #2,",3.0,,
2644,4321,2,Player object (946),buy,2023-03-09 22:47:16.311001+00:00,"{""priceA"": 140, ""sharesA"": 1, ""secs_since_round_starts"": 246, ""market"": ""A""}",95.0,40.0,10.0,wpwzt9j0,vmu7c279,FULL STUDY,225.0,s2,1,140,145.0,-1,,1,sell,0,sell,0.4916787423410894,16,0,0,block 2 (G first),22.0,12.0,Male,1.0,1.0,1.0,"[2, 'block 2 (G first)']",1,1,0,1.0,7.0,-0.30000000000000004,0.24,0.125,0.0,0.0,5,0.75,1.0,Design 2,Design 2,"Have an option between Design #1 and Design #2,",3.0,,
2645,4323,2,Player object (946),sell,2023-03-09 22:47:27.574144+00:00,"{""priceA"": 130, ""sharesA"": 0, ""secs_since_round_starts"": 257, ""market"": ""A""}",225.0,42.0,11.0,wpwzt9j0,vmu7c279,FULL STUDY,225.0,s2,1,130,140.0,1,-10.0,1,buy,0,sell,0.4369837361437204,16,0,0,block 2 (G first),22.0,12.0,Male,1.0,1.0,1.0,"[2, 'block 2 (G first)']",1,1,0,1.0,7.0,-0.30000000000000004,0.24,0.125,0.0,0.0,5,0.75,1.0,Design 2,Design 2,"Have an option between Design #1 and Design #2,",3.0,,
2646,4324,2,Player object (946),buy,2023-03-09 22:47:38.905525+00:00,"{""priceA"": 130, ""sharesA"": 1, ""secs_since_round_starts"": 269, ""market"": ""A""}",95.0,44.0,12.0,wpwzt9j0,vmu7c279,FULL STUDY,225.0,s2,1,130,130.0,-1,,1,sell,0,sell,0.4799987600827208,16,0,0,block 2 (G first),22.0,12.0,Male,1.0,1.0,1.0,"[2, 'block 2 (G first)']",1,1,0,1.0,7.0,-0.30000000000000004,0.24,0.125,0.0,0.0,5,0.75,1.0,Design 2,Design 2,"Have an option between Design #1 and Design #2,",3.0,,
2647,4326,2,Player object (946),sell,2023-03-09 22:47:55.992371+00:00,"{""priceA"": 140, ""sharesA"": 0, ""secs_since_round_starts"": 286, ""market"": ""A""}",235.0,47.0,13.0,wpwzt9j0,vmu7c279,FULL STUDY,225.0,s2,1,140,130.0,1,10.0,1,buy,0,sell,0.4996814899229063,16,0,0,block 2 (G first),22.0,12.0,Male,1.0,1.0,1.0,"[2, 'block 2 (G first)']",1,1,0,1.0,7.0,-0.30000000000000004,0.24,0.125,0.0,0.0,5,0.75,1.0,Design 2,Design 2,"Have an option between Design #1 and Design #2,",3.0,,
2648,4328,2,Player object (946),buy,2023-03-09 22:48:00.400725+00:00,"{""priceA"": 155, ""sharesA"": 1, ""secs_since_round_starts"": 290, ""market"": ""A""}",80.0,48.0,14.0,wpwzt9j0,vmu7c279,FULL STUDY,225.0,s2,1,155,140.0,-1,,1,sell,0,sell,0.5347792584548927,16,0,0,block 2 (G first),22.0,12.0,Male,1.0,1.0,1.0,"[2, 'block 2 (G first)']",1,1,0,1.0,7.0,-0.30000000000000004,0.24,0.125,0.0,0.0,5,0.75,1.0,Design 2,Design 2,"Have an option between Design #1 and Design #2,",3.0,,
2649,4329,2,Player object (946),sell,2023-03-09 22:48:12.282458+00:00,"{""priceA"": 155, ""sharesA"": 0, ""secs_since_round_starts"": 302, ""market"": ""A""}",235.0,50.0,15.0,wpwzt9j0,vmu7c279,FULL STUDY,225.0,s2,1,155,155.0,1,0.0,1,buy,0,sell,0.5063294801170398,16,0,0,block 2 (G first),22.0,12.0,Male,1.0,1.0,1.0,"[2, 'block 2 (G first)']",1,1,0,1.0,7.0,-0.30000000000000004,0.24,0.125,0.0,0.0,5,0.75,1.0,Design 2,Design 2,"Have an option between Design #1 and Design #2,",3.0,,
2650,4333,2,Player object (946),buy,2023-03-09 22:48:28.116445+00:00,"{""priceA"": 135, ""sharesA"": 1, ""secs_since_round_starts"": 318, ""market"": ""A""}",100.0,53.0,16.0,wpwzt9j0,vmu7c279,FULL STUDY,225.0,s2,1,135,155.0,-1,,1,sell,0,sell,0.4956940487416096,16,0,0,block 2 (G first),22.0,12.0,Male,1.0,1.0,1.0,"[2, 'block 2 (G first)']",1,1,0,1.0,7.0,-0.30000000000000004,0.24,0.125,0.0,0.0,5,0.75,1.0,Design 2,Design 2,"Have an option between Design #1 and Design #2,",3.0,,
2651,4349,3,Player object (1066),sell,2023-03-09 22:52:08.030649+00:00,"{""priceA"": 90, ""sharesA"": 0, ""secs_since_round_starts"": 33, ""market"": ""A""}",140.0,7.0,1.0,wpwzt9j0,vmu7c279,FULL STUDY,225.0,s2,1,90,,1,,1,,0,sell,0.4580966810292103,19,0,0,block 2 (G first),22.0,12.0,Male,1.0,1.0,1.0,"[3, 'block 2 (G first)']",1,0,0,1.0,7.0,-0.30000000000000004,0.3684210526315789,0.2222222222222222,0.6666666666666666,0.0,5,0.75,0.75,Design 2,Design 2,"Have an option between Design #1 and Design #2,",3.0,,
2652,4350,3,Player object (1066),buy,2023-03-09 22:52:12.614884+00:00,"{""priceA"": 100, ""sharesA"": 1, ""secs_since_round_starts"": 37, ""market"": ""A""}",40.0,8.0,2.0,wpwzt9j0,vmu7c279,FULL STUDY,225.0,s2,1,100,90.0,-1,,1,sell,0,sell,0.5057155770500936,19,0,0,block 2 (G first),22.0,12.0,Male,1.0,1.0,1.0,"[3, 'block 2 (G first)']",1,0,0,1.0,7.0,-0.30000000000000004,0.3684210526315789,0.2222222222222222,0.6666666666666666,0.0,5,0.75,0.75,Design 2,Design 2,"Have an option between Design #1 and Design #2,",3.0,,
2653,4353,3,Player object (1066),sell,2023-03-09 22:52:46.052211+00:00,"{""priceA"": 125, ""sharesA"": 0, ""secs_since_round_starts"": 71, ""market"": ""A""}",165.0,14.0,3.0,wpwzt9j0,vmu7c279,FULL STUDY,225.0,s2,1,125,100.0,1,25.0,1,buy,0,sell,0.5163117828594225,19,0,0,block 2 (G first),22.0,12.0,Male,1.0,1.0,1.0,"[3, 'block 2 (G first)']",1,0,0,1.0,7.0,-0.30000000000000004,0.3684210526315789,0.2222222222222222,0.6666666666666666,0.0,5,0.75,0.75,Design 2,Design 2,"Have an option between Design #1 and Design #2,",3.0,,
2654,4354,3,Player object (1066),buy,2023-03-09 22:53:03.123028+00:00,"{""priceA"": 105, ""sharesA"": 1, ""secs_since_round_starts"": 88, ""market"": ""A""}",60.0,17.0,4.0,wpwzt9j0,vmu7c279,FULL STUDY,225.0,s2,1,105,125.0,-1,,1,sell,0,sell,0.4990675303551922,19,0,0,block 2 (G first),22.0,12.0,Male,1.0,1.0,1.0,"[3, 'block 2 (G first)']",1,0,0,1.0,7.0,-0.30000000000000004,0.3684210526315789,0.2222222222222222,0.6666666666666666,0.0,5,0.75,0.75,Design 2,Design 2,"Have an option between Design #1 and Design #2,",3.0,,
2655,4358,3,Player object (1066),sell,2023-03-09 22:53:13.989843+00:00,"{""priceA"": 120, ""sharesA"": 0, ""secs_since_round_starts"": 99, ""market"": ""A""}",180.0,19.0,5.0,wpwzt9j0,vmu7c279,FULL STUDY,225.0,s2,1,120,105.0,1,15.0,1,buy,0,sell,0.5586446427659006,19,0,1,block 2 (G first),22.0,12.0,Male,1.0,1.0,1.0,"[3, 'block 2 (G first)']",1,0,0,1.0,7.0,-0.30000000000000004,0.3684210526315789,0.2222222222222222,0.6666666666666666,0.0,5,0.75,0.75,Design 2,Design 2,"Have an option between Design #1 and Design #2,",3.0,,
2656,4360,3,Player object (1066),buy,2023-03-09 22:53:31.008443+00:00,"{""priceA"": 85, ""sharesA"": 1, ""secs_since_round_starts"": 116, ""market"": ""A""}",95.0,22.0,6.0,wpwzt9j0,vmu7c279,FULL STUDY,225.0,s2,1,85,120.0,-1,,1,sell,0,sell,0.443819468959905,19,1,0,block 2 (G first),22.0,12.0,Male,1.0,1.0,1.0,"[3, 'block 2 (G first)']",1,0,0,1.0,7.0,-0.30000000000000004,0.3684210526315789,0.2222222222222222,0.6666666666666666,0.0,5,0.75,0.75,Design 2,Design 2,"Have an option between Design #1 and Design #2,",3.0,,
2657,4361,3,Player object (1066),sell,2023-03-09 22:53:47.408358+00:00,"{""priceA"": 110, ""sharesA"": 0, ""secs_since_round_starts"": 132, ""market"": ""A""}",205.0,25.0,7.0,wpwzt9j0,vmu7c279,FULL STUDY,225.0,s2,1,110,85.0,1,25.0,1,buy,0,sell,0.4872943409941583,19,0,0,block 2 (G first),22.0,12.0,Male,1.0,1.0,1.0,"[3, 'block 2 (G first)']",1,0,0,1.0,7.0,-0.30000000000000004,0.3684210526315789,0.2222222222222222,0.6666666666666666,0.0,5,0.75,0.75,Design 2,Design 2,"Have an option between Design #1 and Design #2,",3.0,,
2658,4363,3,Player object (1066),buy,2023-03-09 22:54:03.122511+00:00,"{""priceA"": 110, ""sharesA"": 1, ""secs_since_round_starts"": 148, ""market"": ""A""}",95.0,28.0,8.0,wpwzt9j0,vmu7c279,FULL STUDY,225.0,s2,1,110,110.0,-1,,1,sell,0,sell,0.5233413838959273,19,0,0,block 2 (G first),22.0,12.0,Male,1.0,1.0,1.0,"[3, 'block 2 (G first)']",1,0,0,1.0,7.0,-0.30000000000000004,0.3684210526315789,0.2222222222222222,0.6666666666666666,0.0,5,0.75,0.75,Design 2,Design 2,"Have an option between Design #1 and Design #2,",3.0,,
2659,4364,3,Player object (1066),sell,2023-03-09 22:54:14.744341+00:00,"{""priceA"": 120, ""sharesA"": 0, ""secs_since_round_starts"": 159, ""market"": ""A""}",215.0,30.0,9.0,wpwzt9j0,vmu7c279,FULL STUDY,225.0,s2,1,120,110.0,1,10.0,1,buy,0,sell,0.570054331362491,19,0,1,block 2 (G first),22.0,12.0,Male,1.0,1.0,1.0,"[3, 'block 2 (G first)']",1,0,0,1.0,7.0,-0.30000000000000004,0.3684210526315789,0.2222222222222222,0.6666666666666666,0.0,5,0.75,0.75,Design 2,Design 2,"Have an option between Design #1 and Design #2,",3.0,,
2660,4367,3,Player object (1066),buy,2023-03-09 22:54:32.591174+00:00,"{""priceA"": 100, ""sharesA"": 1, ""secs_since_round_starts"": 177, ""market"": ""A""}",115.0,33.0,10.0,wpwzt9j0,vmu7c279,FULL STUDY,225.0,s2,1,100,120.0,-1,,1,sell,0,sell,0.4476889957041811,19,1,0,block 2 (G first),22.0,12.0,Male,1.0,1.0,1.0,"[3, 'block 2 (G first)']",1,0,0,1.0,7.0,-0.30000000000000004,0.3684210526315789,0.2222222222222222,0.6666666666666666,0.0,5,0.75,0.75,Design 2,Design 2,"Have an option between Design #1 and Design #2,",3.0,,
2661,4368,3,Player object (1066),sell,2023-03-09 22:54:46.127122+00:00,"{""priceA"": 105, ""sharesA"": 0, ""secs_since_round_starts"": 191, ""market"": ""A""}",220.0,35.0,11.0,wpwzt9j0,vmu7c279,FULL STUDY,225.0,s2,1,105,100.0,1,5.0,1,buy,0,sell,0.463867449269012,19,0,0,block 2 (G first),22.0,12.0,Male,1.0,1.0,1.0,"[3, 'block 2 (G first)']",1,0,0,1.0,7.0,-0.30000000000000004,0.3684210526315789,0.2222222222222222,0.6666666666666666,0.0,5,0.75,0.75,Design 2,Design 2,"Have an option between Design #1 and Design #2,",3.0,,
2662,4370,3,Player object (1066),buy,2023-03-09 22:54:54.186292+00:00,"{""priceA"": 95, ""sharesA"": 1, ""secs_since_round_starts"": 199, ""market"": ""A""}",125.0,37.0,12.0,wpwzt9j0,vmu7c279,FULL STUDY,225.0,s2,1,95,105.0,-1,,1,sell,0,sell,0.4240076400585448,19,1,0,block 2 (G first),22.0,12.0,Male,1.0,1.0,1.0,"[3, 'block 2 (G first)']",1,0,0,1.0,7.0,-0.30000000000000004,0.3684210526315789,0.2222222222222222,0.6666666666666666,0.0,5,0.75,0.75,Design 2,Design 2,"Have an option between Design #1 and Design #2,",3.0,,
2663,4374,3,Player object (1066),sell,2023-03-09 22:55:14.021380+00:00,"{""priceA"": 100, ""sharesA"": 0, ""secs_since_round_starts"": 219, ""market"": ""A""}",225.0,40.0,13.0,wpwzt9j0,vmu7c279,FULL STUDY,225.0,s2,1,100,95.0,1,5.0,1,buy,0,sell,0.4804175727303482,19,0,0,block 2 (G first),22.0,12.0,Male,1.0,1.0,1.0,"[3, 'block 2 (G first)']",1,0,0,1.0,7.0,-0.30000000000000004,0.3684210526315789,0.2222222222222222,0.6666666666666666,0.0,5,0.75,0.75,Design 2,Design 2,"Have an option between Design #1 and Design #2,",3.0,,
2664,4376,3,Player object (1066),buy,2023-03-09 22:55:22.649501+00:00,"{""priceA"": 105, ""sharesA"": 1, ""secs_since_round_starts"": 227, ""market"": ""A""}",120.0,42.0,14.0,wpwzt9j0,vmu7c279,FULL STUDY,225.0,s2,1,105,100.0,-1,,1,sell,0,sell,0.5010477910686952,19,0,0,block 2 (G first),22.0,12.0,Male,1.0,1.0,1.0,"[3, 'block 2 (G first)']",1,0,0,1.0,7.0,-0.30000000000000004,0.3684210526315789,0.2222222222222222,0.6666666666666666,0.0,5,0.75,0.75,Design 2,Design 2,"Have an option between Design #1 and Design #2,",3.0,,
2665,4378,3,Player object (1066),sell,2023-03-09 22:55:29.461848+00:00,"{""priceA"": 120, ""sharesA"": 0, ""secs_since_round_starts"": 234, ""market"": ""A""}",240.0,43.0,15.0,wpwzt9j0,vmu7c279,FULL STUDY,225.0,s2,1,120,105.0,1,15.0,1,buy,0,sell,0.5357259670782416,19,0,0,block 2 (G first),22.0,12.0,Male,1.0,1.0,1.0,"[3, 'block 2 (G first)']",1,0,0,1.0,7.0,-0.30000000000000004,0.3684210526315789,0.2222222222222222,0.6666666666666666,0.0,5,0.75,0.75,Design 2,Design 2,"Have an option between Design #1 and Design #2,",3.0,,
2666,4381,3,Player object (1066),buy,2023-03-09 22:55:46.011494+00:00,"{""priceA"": 135, ""sharesA"": 1, ""secs_since_round_starts"": 251, ""market"": ""A""}",105.0,46.0,17.0,wpwzt9j0,vmu7c279,FULL STUDY,225.0,s2,1,135,125.0,-1,,1,sell,0,sell,0.5396981283875847,19,0,0,block 2 (G first),22.0,12.0,Male,1.0,1.0,1.0,"[3, 'block 2 (G first)']",1,0,0,1.0,7.0,-0.30000000000000004,0.3684210526315789,0.2222222222222222,0.6666666666666666,0.0,5,0.75,0.75,Design 2,Design 2,"Have an option between Design #1 and Design #2,",3.0,,
2667,4382,3,Player object (1066),sell,2023-03-09 22:56:12.461072+00:00,"{""priceA"": 120, ""sharesA"": 0, ""secs_since_round_starts"": 277, ""market"": ""A""}",225.0,51.0,18.0,wpwzt9j0,vmu7c279,FULL STUDY,225.0,s2,1,120,135.0,1,-15.0,1,buy,0,sell,0.4588602748157505,19,0,0,block 2 (G first),22.0,12.0,Male,1.0,1.0,1.0,"[3, 'block 2 (G first)']",1,0,0,1.0,7.0,-0.30000000000000004,0.3684210526315789,0.2222222222222222,0.6666666666666666,0.0,5,0.75,0.75,Design 2,Design 2,"Have an option between Design #1 and Design #2,",3.0,,
2668,4383,3,Player object (1066),buy,2023-03-09 22:56:50.303330+00:00,"{""priceA"": 115, ""sharesA"": 1, ""secs_since_round_starts"": 315, ""market"": ""A""}",110.0,58.0,19.0,wpwzt9j0,vmu7c279,FULL STUDY,225.0,s2,1,115,120.0,-1,,1,sell,0,sell,0.442461876115205,19,1,0,block 2 (G first),22.0,12.0,Male,1.0,1.0,1.0,"[3, 'block 2 (G first)']",1,0,0,1.0,7.0,-0.30000000000000004,0.3684210526315789,0.2222222222222222,0.6666666666666666,0.0,5,0.75,0.75,Design 2,Design 2,"Have an option between Design #1 and Design #2,",3.0,,
2669,4391,4,Player object (1186),sell,2023-03-09 22:58:08.997766+00:00,"{""priceA"": 95, ""sharesA"": 0, ""secs_since_round_starts"": 59, ""market"": ""A""}",145.0,11.0,2.0,wpwzt9j0,vmu7c279,FULL STUDY,205.0,s2,1,95,45.0,1,50.0,1,,0,sell,0.5796571916404338,14,0,0,block 2 (G first),22.0,12.0,Male,1.0,1.0,1.0,"[4, 'block 2 (G first)']",0,1,0,0.5,7.0,-0.30000000000000004,0.3076923076923077,0.2857142857142857,0.5,0.0,5,0.25,0.75,Design 2,Design 2,"Have an option between Design #1 and Design #2,",3.0,,
2670,4393,4,Player object (1186),buy,2023-03-09 22:58:22.284109+00:00,"{""priceA"": 90, ""sharesA"": 1, ""secs_since_round_starts"": 73, ""market"": ""A""}",55.0,14.0,3.0,wpwzt9j0,vmu7c279,FULL STUDY,205.0,s2,1,90,95.0,-1,,1,sell,0,sell,0.5208618681016636,14,0,0,block 2 (G first),22.0,12.0,Male,1.0,1.0,1.0,"[4, 'block 2 (G first)']",0,1,0,0.5,7.0,-0.30000000000000004,0.3076923076923077,0.2857142857142857,0.5,0.0,5,0.25,0.75,Design 2,Design 2,"Have an option between Design #1 and Design #2,",3.0,,
2671,4394,4,Player object (1186),sell,2023-03-09 22:58:34.680289+00:00,"{""priceA"": 90, ""sharesA"": 0, ""secs_since_round_starts"": 85, ""market"": ""A""}",145.0,16.0,4.0,wpwzt9j0,vmu7c279,FULL STUDY,205.0,s2,1,90,90.0,1,0.0,1,buy,0,sell,0.4995738325599586,14,0,0,block 2 (G first),22.0,12.0,Male,1.0,1.0,1.0,"[4, 'block 2 (G first)']",0,1,0,0.5,7.0,-0.30000000000000004,0.3076923076923077,0.2857142857142857,0.5,0.0,5,0.25,0.75,Design 2,Design 2,"Have an option between Design #1 and Design #2,",3.0,,
2672,4395,4,Player object (1186),buy,2023-03-09 22:58:50.026484+00:00,"{""priceA"": 85, ""sharesA"": 1, ""secs_since_round_starts"": 100, ""market"": ""A""}",60.0,19.0,5.0,wpwzt9j0,vmu7c279,FULL STUDY,205.0,s2,1,85,90.0,-1,,1,sell,0,sell,0.4934202415852731,14,0,0,block 2 (G first),22.0,12.0,Male,1.0,1.0,1.0,"[4, 'block 2 (G first)']",0,1,0,0.5,7.0,-0.30000000000000004,0.3076923076923077,0.2857142857142857,0.5,0.0,5,0.25,0.75,Design 2,Design 2,"Have an option between Design #1 and Design #2,",3.0,,
2673,4396,4,Player object (1186),sell,2023-03-09 22:58:57.417177+00:00,"{""priceA"": 70, ""sharesA"": 0, ""secs_since_round_starts"": 108, ""market"": ""A""}",130.0,20.0,6.0,wpwzt9j0,vmu7c279,FULL STUDY,205.0,s2,1,70,85.0,1,-15.0,1,buy,0,sell,0.4604462199730844,14,0,0,block 2 (G first),22.0,12.0,Male,1.0,1.0,1.0,"[4, 'block 2 (G first)']",0,1,0,0.5,7.0,-0.30000000000000004,0.3076923076923077,0.2857142857142857,0.5,0.0,5,0.25,0.75,Design 2,Design 2,"Have an option between Design #1 and Design #2,",3.0,,
2674,4397,4,Player object (1186),buy,2023-03-09 22:59:03.733890+00:00,"{""priceA"": 65, ""sharesA"": 1, ""secs_since_round_starts"": 114, ""market"": ""A""}",65.0,21.0,7.0,wpwzt9j0,vmu7c279,FULL STUDY,205.0,s2,1,65,70.0,-1,,1,sell,0,sell,0.4378043684469758,14,0,0,block 2 (G first),22.0,12.0,Male,1.0,1.0,1.0,"[4, 'block 2 (G first)']",0,1,0,0.5,7.0,-0.30000000000000004,0.3076923076923077,0.2857142857142857,0.5,0.0,5,0.25,0.75,Design 2,Design 2,"Have an option between Design #1 and Design #2,",3.0,,
2675,4402,4,Player object (1186),sell,2023-03-09 22:59:46.755808+00:00,"{""priceA"": 90, ""sharesA"": 0, ""secs_since_round_starts"": 157, ""market"": ""A""}",155.0,29.0,8.0,wpwzt9j0,vmu7c279,FULL STUDY,205.0,s2,1,90,65.0,1,25.0,1,buy,0,sell,0.5712793841154561,14,0,0,block 2 (G first),22.0,12.0,Male,1.0,1.0,1.0,"[4, 'block 2 (G first)']",0,1,0,0.5,7.0,-0.30000000000000004,0.3076923076923077,0.2857142857142857,0.5,0.0,5,0.25,0.75,Design 2,Design 2,"Have an option between Design #1 and Design #2,",3.0,,
2676,4404,4,Player object (1186),buy,2023-03-09 23:00:05.376183+00:00,"{""priceA"": 95, ""sharesA"": 1, ""secs_since_round_starts"": 176, ""market"": ""A""}",60.0,32.0,9.0,wpwzt9j0,vmu7c279,FULL STUDY,205.0,s2,1,95,90.0,-1,,1,sell,0,sell,0.5179404569050043,14,0,0,block 2 (G first),22.0,12.0,Male,1.0,1.0,1.0,"[4, 'block 2 (G first)']",0,1,0,0.5,7.0,-0.30000000000000004,0.3076923076923077,0.2857142857142857,0.5,0.0,5,0.25,0.75,Design 2,Design 2,"Have an option between Design #1 and Design #2,",3.0,,
2677,4405,4,Player object (1186),sell,2023-03-09 23:00:15.111654+00:00,"{""priceA"": 95, ""sharesA"": 0, ""secs_since_round_starts"": 185, ""market"": ""A""}",155.0,34.0,10.0,wpwzt9j0,vmu7c279,FULL STUDY,205.0,s2,1,95,95.0,1,0.0,1,buy,0,sell,0.4981543075921684,14,0,0,block 2 (G first),22.0,12.0,Male,1.0,1.0,1.0,"[4, 'block 2 (G first)']",0,1,0,0.5,7.0,-0.30000000000000004,0.3076923076923077,0.2857142857142857,0.5,0.0,5,0.25,0.75,Design 2,Design 2,"Have an option between Design #1 and Design #2,",3.0,,
2678,4406,4,Player object (1186),buy,2023-03-09 23:00:20.347274+00:00,"{""priceA"": 100, ""sharesA"": 1, ""secs_since_round_starts"": 191, ""market"": ""A""}",55.0,35.0,11.0,wpwzt9j0,vmu7c279,FULL STUDY,205.0,s2,1,100,95.0,-1,,1,sell,0,sell,0.5337204628349665,14,0,0,block 2 (G first),22.0,12.0,Male,1.0,1.0,1.0,"[4, 'block 2 (G first)']",0,1,0,0.5,7.0,-0.30000000000000004,0.3076923076923077,0.2857142857142857,0.5,0.0,5,0.25,0.75,Design 2,Design 2,"Have an option between Design #1 and Design #2,",3.0,,
2679,4407,4,Player object (1186),sell,2023-03-09 23:00:27.178623+00:00,"{""priceA"": 85, ""sharesA"": 0, ""secs_since_round_starts"": 197, ""market"": ""A""}",140.0,36.0,12.0,wpwzt9j0,vmu7c279,FULL STUDY,205.0,s2,1,85,100.0,1,-15.0,1,buy,0,sell,0.4885269486642424,14,0,0,block 2 (G first),22.0,12.0,Male,1.0,1.0,1.0,"[4, 'block 2 (G first)']",0,1,0,0.5,7.0,-0.30000000000000004,0.3076923076923077,0.2857142857142857,0.5,0.0,5,0.25,0.75,Design 2,Design 2,"Have an option between Design #1 and Design #2,",3.0,,
2680,4408,4,Player object (1186),buy,2023-03-09 23:00:37.327660+00:00,"{""priceA"": 65, ""sharesA"": 1, ""secs_since_round_starts"": 208, ""market"": ""A""}",75.0,38.0,13.0,wpwzt9j0,vmu7c279,FULL STUDY,205.0,s2,1,65,85.0,-1,,1,sell,0,sell,0.4355009867455686,14,1,0,block 2 (G first),22.0,12.0,Male,1.0,1.0,1.0,"[4, 'block 2 (G first)']",0,1,0,0.5,7.0,-0.30000000000000004,0.3076923076923077,0.2857142857142857,0.5,0.0,5,0.25,0.75,Design 2,Design 2,"Have an option between Design #1 and Design #2,",3.0,,
2681,4410,4,Player object (1186),sell,2023-03-09 23:00:48.807155+00:00,"{""priceA"": 75, ""sharesA"": 0, ""secs_since_round_starts"": 219, ""market"": ""A""}",150.0,40.0,14.0,wpwzt9j0,vmu7c279,FULL STUDY,205.0,s2,1,75,65.0,1,10.0,1,buy,0,sell,0.4578892350765483,14,0,0,block 2 (G first),22.0,12.0,Male,1.0,1.0,1.0,"[4, 'block 2 (G first)']",0,1,0,0.5,7.0,-0.30000000000000004,0.3076923076923077,0.2857142857142857,0.5,0.0,5,0.25,0.75,Design 2,Design 2,"Have an option between Design #1 and Design #2,",3.0,,
2682,4411,4,Player object (1186),buy,2023-03-09 23:00:52.949173+00:00,"{""priceA"": 80, ""sharesA"": 1, ""secs_since_round_starts"": 223, ""market"": ""A""}",70.0,41.0,15.0,wpwzt9j0,vmu7c279,FULL STUDY,205.0,s2,1,80,75.0,-1,,1,sell,0,sell,0.5055693706451859,14,0,0,block 2 (G first),22.0,12.0,Male,1.0,1.0,1.0,"[4, 'block 2 (G first)']",0,1,0,0.5,7.0,-0.30000000000000004,0.3076923076923077,0.2857142857142857,0.5,0.0,5,0.25,0.75,Design 2,Design 2,"Have an option between Design #1 and Design #2,",3.0,,
2683,4414,4,Player object (1186),sell,2023-03-09 23:01:05.202657+00:00,"{""priceA"": 100, ""sharesA"": 0, ""secs_since_round_starts"": 235, ""market"": ""A""}",170.0,43.0,16.0,wpwzt9j0,vmu7c279,FULL STUDY,205.0,s2,1,100,80.0,1,20.0,1,buy,0,sell,0.5617190733230237,14,0,1,block 2 (G first),22.0,12.0,Male,1.0,1.0,1.0,"[4, 'block 2 (G first)']",0,1,0,0.5,7.0,-0.30000000000000004,0.3076923076923077,0.2857142857142857,0.5,0.0,5,0.25,0.75,Design 2,Design 2,"Have an option between Design #1 and Design #2,",3.0,,
2684,4417,4,Player object (1186),buy,2023-03-09 23:01:29.897314+00:00,"{""priceA"": 85, ""sharesA"": 1, ""secs_since_round_starts"": 260, ""market"": ""A""}",85.0,47.0,17.0,wpwzt9j0,vmu7c279,FULL STUDY,205.0,s2,1,85,100.0,-1,,1,sell,0,sell,0.4501495476988393,14,1,0,block 2 (G first),22.0,12.0,Male,1.0,1.0,1.0,"[4, 'block 2 (G first)']",0,1,0,0.5,7.0,-0.30000000000000004,0.3076923076923077,0.2857142857142857,0.5,0.0,5,0.25,0.75,Design 2,Design 2,"Have an option between Design #1 and Design #2,",3.0,,
2685,4418,4,Player object (1186),sell,2023-03-09 23:01:44.472364+00:00,"{""priceA"": 120, ""sharesA"": 0, ""secs_since_round_starts"": 275, ""market"": ""A""}",205.0,50.0,18.0,wpwzt9j0,vmu7c279,FULL STUDY,205.0,s2,1,120,85.0,1,35.0,1,buy,0,sell,0.5591364702939366,14,0,1,block 2 (G first),22.0,12.0,Male,1.0,1.0,1.0,"[4, 'block 2 (G first)']",0,1,0,0.5,7.0,-0.30000000000000004,0.3076923076923077,0.2857142857142857,0.5,0.0,5,0.25,0.75,Design 2,Design 2,"Have an option between Design #1 and Design #2,",3.0,,
2686,4420,4,Player object (1186),buy,2023-03-09 23:02:04.340352+00:00,"{""priceA"": 85, ""sharesA"": 1, ""secs_since_round_starts"": 295, ""market"": ""A""}",120.0,54.0,19.0,wpwzt9j0,vmu7c279,FULL STUDY,205.0,s2,1,85,120.0,-1,,1,sell,0,sell,0.4957421237757241,14,0,0,block 2 (G first),22.0,12.0,Male,1.0,1.0,1.0,"[4, 'block 2 (G first)']",0,1,0,0.5,7.0,-0.30000000000000004,0.3076923076923077,0.2857142857142857,0.5,0.0,5,0.25,0.75,Design 2,Design 2,"Have an option between Design #1 and Design #2,",3.0,,
2687,4422,4,Player object (1186),sell,2023-03-09 23:02:11.348362+00:00,"{""priceA"": 70, ""sharesA"": 0, ""secs_since_round_starts"": 302, ""market"": ""A""}",190.0,55.0,20.0,wpwzt9j0,vmu7c279,FULL STUDY,205.0,s2,1,70,85.0,1,-15.0,1,buy,0,sell,0.4620518023886796,14,0,0,block 2 (G first),22.0,12.0,Male,1.0,1.0,1.0,"[4, 'block 2 (G first)']",0,1,0,0.5,7.0,-0.30000000000000004,0.3076923076923077,0.2857142857142857,0.5,0.0,5,0.25,0.75,Design 2,Design 2,"Have an option between Design #1 and Design #2,",3.0,,
2688,4423,4,Player object (1186),buy,2023-03-09 23:02:26.519745+00:00,"{""priceA"": 60, ""sharesA"": 1, ""secs_since_round_starts"": 317, ""market"": ""A""}",130.0,58.0,21.0,wpwzt9j0,vmu7c279,FULL STUDY,205.0,s2,1,60,70.0,-1,,1,sell,0,sell,0.4809250988502129,14,0,0,block 2 (G first),22.0,12.0,Male,1.0,1.0,1.0,"[4, 'block 2 (G first)']",0,1,0,0.5,7.0,-0.30000000000000004,0.3076923076923077,0.2857142857142857,0.5,0.0,5,0.25,0.75,Design 2,Design 2,"Have an option between Design #1 and Design #2,",3.0,,
2689,4431,5,Player object (1306),sell,2023-03-09 23:03:22.752118+00:00,"{""priceA"": 90, ""sharesA"": 0, ""secs_since_round_starts"": 36, ""market"": ""A""}",140.0,8.0,1.0,wpwzt9j0,vmu7c279,FULL STUDY,195.0,s2,1,90,,1,,1,,0,sell,0.5166236645513725,17,0,0,block 2 (G first),22.0,12.0,Male,1.0,1.0,1.0,"[5, 'block 2 (G first)']",0,0,0,1.0,7.0,-0.30000000000000004,0.3076923076923077,0.3333333333333333,0.6666666666666666,0.0,5,0.25,0.5,Design 2,Design 2,"Have an option between Design #1 and Design #2,",3.0,,
2690,4432,5,Player object (1306),buy,2023-03-09 23:03:38.836304+00:00,"{""priceA"": 85, ""sharesA"": 1, ""secs_since_round_starts"": 52, ""market"": ""A""}",55.0,11.0,2.0,wpwzt9j0,vmu7c279,FULL STUDY,195.0,s2,1,85,90.0,-1,,1,sell,0,sell,0.4991731929932316,17,0,0,block 2 (G first),22.0,12.0,Male,1.0,1.0,1.0,"[5, 'block 2 (G first)']",0,0,0,1.0,7.0,-0.30000000000000004,0.3076923076923077,0.3333333333333333,0.6666666666666666,0.0,5,0.25,0.5,Design 2,Design 2,"Have an option between Design #1 and Design #2,",3.0,,
2691,4434,5,Player object (1306),sell,2023-03-09 23:03:50.274366+00:00,"{""priceA"": 85, ""sharesA"": 0, ""secs_since_round_starts"": 64, ""market"": ""A""}",140.0,13.0,3.0,wpwzt9j0,vmu7c279,FULL STUDY,195.0,s2,1,85,85.0,1,0.0,1,buy,0,sell,0.4890232705715233,17,0,0,block 2 (G first),22.0,12.0,Male,1.0,1.0,1.0,"[5, 'block 2 (G first)']",0,0,0,1.0,7.0,-0.30000000000000004,0.3076923076923077,0.3333333333333333,0.6666666666666666,0.0,5,0.25,0.5,Design 2,Design 2,"Have an option between Design #1 and Design #2,",3.0,,
2692,4436,5,Player object (1306),buy,2023-03-09 23:04:01.288324+00:00,"{""priceA"": 90, ""sharesA"": 1, ""secs_since_round_starts"": 75, ""market"": ""A""}",50.0,15.0,4.0,wpwzt9j0,vmu7c279,FULL STUDY,195.0,s2,1,90,85.0,-1,,1,sell,0,sell,0.505231414156075,17,0,0,block 2 (G first),22.0,12.0,Male,1.0,1.0,1.0,"[5, 'block 2 (G first)']",0,0,0,1.0,7.0,-0.30000000000000004,0.3076923076923077,0.3333333333333333,0.6666666666666666,0.0,5,0.25,0.5,Design 2,Design 2,"Have an option between Design #1 and Design #2,",3.0,,
2693,4437,5,Player object (1306),sell,2023-03-09 23:04:09.554913+00:00,"{""priceA"": 85, ""sharesA"": 0, ""secs_since_round_starts"": 83, ""market"": ""A""}",135.0,16.0,5.0,wpwzt9j0,vmu7c279,FULL STUDY,195.0,s2,1,85,90.0,1,-5.0,1,buy,0,sell,0.4686291671454359,17,0,0,block 2 (G first),22.0,12.0,Male,1.0,1.0,1.0,"[5, 'block 2 (G first)']",0,0,0,1.0,7.0,-0.30000000000000004,0.3076923076923077,0.3333333333333333,0.6666666666666666,0.0,5,0.25,0.5,Design 2,Design 2,"Have an option between Design #1 and Design #2,",3.0,,
2694,4439,5,Player object (1306),buy,2023-03-09 23:04:17.683857+00:00,"{""priceA"": 70, ""sharesA"": 1, ""secs_since_round_starts"": 91, ""market"": ""A""}",65.0,18.0,6.0,wpwzt9j0,vmu7c279,FULL STUDY,195.0,s2,1,70,85.0,-1,,1,sell,0,sell,0.42621223683237,17,1,0,block 2 (G first),22.0,12.0,Male,1.0,1.0,1.0,"[5, 'block 2 (G first)']",0,0,0,1.0,7.0,-0.30000000000000004,0.3076923076923077,0.3333333333333333,0.6666666666666666,0.0,5,0.25,0.5,Design 2,Design 2,"Have an option between Design #1 and Design #2,",3.0,,
2695,4440,5,Player object (1306),sell,2023-03-09 23:04:35.644297+00:00,"{""priceA"": 105, ""sharesA"": 0, ""secs_since_round_starts"": 109, ""market"": ""A""}",170.0,21.0,7.0,wpwzt9j0,vmu7c279,FULL STUDY,195.0,s2,1,105,70.0,1,35.0,1,buy,0,sell,0.5510362930796925,17,0,1,block 2 (G first),22.0,12.0,Male,1.0,1.0,1.0,"[5, 'block 2 (G first)']",0,0,0,1.0,7.0,-0.30000000000000004,0.3076923076923077,0.3333333333333333,0.6666666666666666,0.0,5,0.25,0.5,Design 2,Design 2,"Have an option between Design #1 and Design #2,",3.0,,
2696,4443,5,Player object (1306),buy,2023-03-09 23:05:14.108685+00:00,"{""priceA"": 85, ""sharesA"": 1, ""secs_since_round_starts"": 147, ""market"": ""A""}",85.0,28.0,8.0,wpwzt9j0,vmu7c279,FULL STUDY,195.0,s2,1,85,105.0,-1,,1,sell,0,sell,0.4496194529460131,17,1,0,block 2 (G first),22.0,12.0,Male,1.0,1.0,1.0,"[5, 'block 2 (G first)']",0,0,0,1.0,7.0,-0.30000000000000004,0.3076923076923077,0.3333333333333333,0.6666666666666666,0.0,5,0.25,0.5,Design 2,Design 2,"Have an option between Design #1 and Design #2,",3.0,,
2697,4447,5,Player object (1306),sell,2023-03-09 23:05:46.725167+00:00,"{""priceA"": 120, ""sharesA"": 0, ""secs_since_round_starts"": 180, ""market"": ""A""}",205.0,34.0,9.0,wpwzt9j0,vmu7c279,FULL STUDY,195.0,s2,1,120,85.0,1,35.0,1,buy,0,sell,0.5679672812132522,17,0,0,block 2 (G first),22.0,12.0,Male,1.0,1.0,1.0,"[5, 'block 2 (G first)']",0,0,0,1.0,7.0,-0.30000000000000004,0.3076923076923077,0.3333333333333333,0.6666666666666666,0.0,5,0.25,0.5,Design 2,Design 2,"Have an option between Design #1 and Design #2,",3.0,,
2698,4452,5,Player object (1306),buy,2023-03-09 23:06:11.843439+00:00,"{""priceA"": 80, ""sharesA"": 1, ""secs_since_round_starts"": 205, ""market"": ""A""}",125.0,38.0,10.0,wpwzt9j0,vmu7c279,FULL STUDY,195.0,s2,1,80,120.0,-1,,1,sell,0,sell,0.4515999245786187,17,1,0,block 2 (G first),22.0,12.0,Male,1.0,1.0,1.0,"[5, 'block 2 (G first)']",0,0,0,1.0,7.0,-0.30000000000000004,0.3076923076923077,0.3333333333333333,0.6666666666666666,0.0,5,0.25,0.5,Design 2,Design 2,"Have an option between Design #1 and Design #2,",3.0,,
2699,4454,5,Player object (1306),sell,2023-03-09 23:06:32.509896+00:00,"{""priceA"": 100, ""sharesA"": 0, ""secs_since_round_starts"": 226, ""market"": ""A""}",225.0,42.0,11.0,wpwzt9j0,vmu7c279,FULL STUDY,195.0,s2,1,100,80.0,1,20.0,1,buy,0,sell,0.5529358605422235,17,0,1,block 2 (G first),22.0,12.0,Male,1.0,1.0,1.0,"[5, 'block 2 (G first)']",0,0,0,1.0,7.0,-0.30000000000000004,0.3076923076923077,0.3333333333333333,0.6666666666666666,0.0,5,0.25,0.5,Design 2,Design 2,"Have an option between Design #1 and Design #2,",3.0,,
2700,4455,5,Player object (1306),buy,2023-03-09 23:07:05.459420+00:00,"{""priceA"": 75, ""sharesA"": 1, ""secs_since_round_starts"": 259, ""market"": ""A""}",150.0,48.0,12.0,wpwzt9j0,vmu7c279,FULL STUDY,195.0,s2,1,75,100.0,-1,,1,sell,0,sell,0.4393932183506925,17,1,0,block 2 (G first),22.0,12.0,Male,1.0,1.0,1.0,"[5, 'block 2 (G first)']",0,0,0,1.0,7.0,-0.30000000000000004,0.3076923076923077,0.3333333333333333,0.6666666666666666,0.0,5,0.25,0.5,Design 2,Design 2,"Have an option between Design #1 and Design #2,",3.0,,
2701,4458,5,Player object (1306),sell,2023-03-09 23:07:31.915600+00:00,"{""priceA"": 85, ""sharesA"": 0, ""secs_since_round_starts"": 285, ""market"": ""A""}",235.0,53.0,14.0,wpwzt9j0,vmu7c279,FULL STUDY,195.0,s2,1,85,70.0,1,15.0,1,buy,0,sell,0.4927925471404216,17,0,0,block 2 (G first),22.0,12.0,Male,1.0,1.0,1.0,"[5, 'block 2 (G first)']",0,0,0,1.0,7.0,-0.30000000000000004,0.3076923076923077,0.3333333333333333,0.6666666666666666,0.0,5,0.25,0.5,Design 2,Design 2,"Have an option between Design #1 and Design #2,",3.0,,
2702,4459,5,Player object (1306),buy,2023-03-09 23:07:37.757947+00:00,"{""priceA"": 95, ""sharesA"": 1, ""secs_since_round_starts"": 291, ""market"": ""A""}",140.0,54.0,15.0,wpwzt9j0,vmu7c279,FULL STUDY,195.0,s2,1,95,85.0,-1,,1,sell,0,sell,0.5299980248683189,17,0,0,block 2 (G first),22.0,12.0,Male,1.0,1.0,1.0,"[5, 'block 2 (G first)']",0,0,0,1.0,7.0,-0.30000000000000004,0.3076923076923077,0.3333333333333333,0.6666666666666666,0.0,5,0.25,0.5,Design 2,Design 2,"Have an option between Design #1 and Design #2,",3.0,,
2703,4460,5,Player object (1306),sell,2023-03-09 23:07:42.832447+00:00,"{""priceA"": 80, ""sharesA"": 0, ""secs_since_round_starts"": 296, ""market"": ""A""}",220.0,55.0,16.0,wpwzt9j0,vmu7c279,FULL STUDY,195.0,s2,1,80,95.0,1,-15.0,1,buy,0,sell,0.4859141076178286,17,0,0,block 2 (G first),22.0,12.0,Male,1.0,1.0,1.0,"[5, 'block 2 (G first)']",0,0,0,1.0,7.0,-0.30000000000000004,0.3076923076923077,0.3333333333333333,0.6666666666666666,0.0,5,0.25,0.5,Design 2,Design 2,"Have an option between Design #1 and Design #2,",3.0,,
2704,4461,5,Player object (1306),buy,2023-03-09 23:07:51.880892+00:00,"{""priceA"": 95, ""sharesA"": 1, ""secs_since_round_starts"": 305, ""market"": ""A""}",125.0,56.0,17.0,wpwzt9j0,vmu7c279,FULL STUDY,195.0,s2,1,95,80.0,-1,,1,sell,0,sell,0.5252108989343294,17,0,0,block 2 (G first),22.0,12.0,Male,1.0,1.0,1.0,"[5, 'block 2 (G first)']",0,0,0,1.0,7.0,-0.30000000000000004,0.3076923076923077,0.3333333333333333,0.6666666666666666,0.0,5,0.25,0.5,Design 2,Design 2,"Have an option between Design #1 and Design #2,",3.0,,
2705,4462,5,Player object (1306),sell,2023-03-09 23:07:58.050216+00:00,"{""priceA"": 75, ""sharesA"": 0, ""secs_since_round_starts"": 311, ""market"": ""A""}",200.0,58.0,18.0,wpwzt9j0,vmu7c279,FULL STUDY,195.0,s2,1,75,95.0,1,-20.0,1,buy,0,sell,0.4529558772574278,17,0,0,block 2 (G first),22.0,12.0,Male,1.0,1.0,1.0,"[5, 'block 2 (G first)']",0,0,0,1.0,7.0,-0.30000000000000004,0.3076923076923077,0.3333333333333333,0.6666666666666666,0.0,5,0.25,0.5,Design 2,Design 2,"Have an option between Design #1 and Design #2,",3.0,,
2706,4463,5,Player object (1306),buy,2023-03-09 23:08:07.472381+00:00,"{""priceA"": 70, ""sharesA"": 1, ""secs_since_round_starts"": 321, ""market"": ""A""}",130.0,59.0,19.0,wpwzt9j0,vmu7c279,FULL STUDY,195.0,s2,1,70,75.0,-1,,1,sell,0,sell,0.4327023062729965,17,1,0,block 2 (G first),22.0,12.0,Male,1.0,1.0,1.0,"[5, 'block 2 (G first)']",0,0,0,1.0,7.0,-0.30000000000000004,0.3076923076923077,0.3333333333333333,0.6666666666666666,0.0,5,0.25,0.5,Design 2,Design 2,"Have an option between Design #1 and Design #2,",3.0,,
2707,1938,2,Player object (897),sell,2023-03-08 01:45:16.277534+00:00,"{""priceA"": 105, ""sharesA"": 0, ""secs_since_round_starts"": 77, ""market"": ""A""}",155.0,14.0,1.0,wrahuh7u,vmu7c279,FULL STUDY,170.0,s2,1,105,,1,,1,,0,sell,0.5600744319669811,16,0,1,block 2 (G first),20.0,12.0,Female,1.0,0.0,1.0,"[2, 'block 2 (G first)']",1,1,0,0.5,8.0,-0.19999999999999996,0.5,0.04,1.0,0.0,4,1.0,0.25,Design 2,Design 2,"Have an option between Design #1 and Design #2,",4.0,,
2708,1939,2,Player object (897),buy,2023-03-08 01:45:47.504735+00:00,"{""priceA"": 130, ""sharesA"": 1, ""secs_since_round_starts"": 109, ""market"": ""A""}",25.0,19.0,2.0,wrahuh7u,vmu7c279,FULL STUDY,170.0,s2,1,130,105.0,-1,,1,sell,0,sell,0.5813773703663461,16,0,1,block 2 (G first),20.0,12.0,Female,1.0,0.0,1.0,"[2, 'block 2 (G first)']",1,1,0,0.5,8.0,-0.19999999999999996,0.5,0.04,1.0,0.0,4,1.0,0.25,Design 2,Design 2,"Have an option between Design #1 and Design #2,",4.0,,
2709,1940,2,Player object (897),sell,2023-03-08 01:45:55.492668+00:00,"{""priceA"": 130, ""sharesA"": 0, ""secs_since_round_starts"": 117, ""market"": ""A""}",155.0,21.0,3.0,wrahuh7u,vmu7c279,FULL STUDY,170.0,s2,1,130,130.0,1,0.0,1,buy,0,sell,0.5504042050217014,16,0,0,block 2 (G first),20.0,12.0,Female,1.0,0.0,1.0,"[2, 'block 2 (G first)']",1,1,0,0.5,8.0,-0.19999999999999996,0.5,0.04,1.0,0.0,4,1.0,0.25,Design 2,Design 2,"Have an option between Design #1 and Design #2,",4.0,,
2710,1941,2,Player object (897),buy,2023-03-08 01:46:24.439400+00:00,"{""priceA"": 140, ""sharesA"": 1, ""secs_since_round_starts"": 145, ""market"": ""A""}",15.0,26.0,4.0,wrahuh7u,vmu7c279,FULL STUDY,170.0,s2,1,140,130.0,-1,,1,sell,0,sell,0.4855198313469848,16,0,0,block 2 (G first),20.0,12.0,Female,1.0,0.0,1.0,"[2, 'block 2 (G first)']",1,1,0,0.5,8.0,-0.19999999999999996,0.5,0.04,1.0,0.0,4,1.0,0.25,Design 2,Design 2,"Have an option between Design #1 and Design #2,",4.0,,
2711,1943,2,Player object (897),sell,2023-03-08 01:47:15.743885+00:00,"{""priceA"": 140, ""sharesA"": 0, ""secs_since_round_starts"": 197, ""market"": ""A""}",155.0,35.0,5.0,wrahuh7u,vmu7c279,FULL STUDY,170.0,s2,1,140,140.0,1,0.0,1,buy,0,sell,0.5101876173062244,16,0,0,block 2 (G first),20.0,12.0,Female,1.0,0.0,1.0,"[2, 'block 2 (G first)']",1,1,0,0.5,8.0,-0.19999999999999996,0.5,0.04,1.0,0.0,4,1.0,0.25,Design 2,Design 2,"Have an option between Design #1 and Design #2,",4.0,,
2712,1944,2,Player object (897),buy,2023-03-08 01:47:21.092576+00:00,"{""priceA"": 150, ""sharesA"": 1, ""secs_since_round_starts"": 202, ""market"": ""A""}",5.0,36.0,6.0,wrahuh7u,vmu7c279,FULL STUDY,170.0,s2,1,150,140.0,-1,,1,sell,0,sell,0.542045663089369,16,0,0,block 2 (G first),20.0,12.0,Female,1.0,0.0,1.0,"[2, 'block 2 (G first)']",1,1,0,0.5,8.0,-0.19999999999999996,0.5,0.04,1.0,0.0,4,1.0,0.25,Design 2,Design 2,"Have an option between Design #1 and Design #2,",4.0,,
2713,1945,2,Player object (897),sell,2023-03-08 01:47:42.369967+00:00,"{""priceA"": 140, ""sharesA"": 0, ""secs_since_round_starts"": 223, ""market"": ""A""}",145.0,40.0,7.0,wrahuh7u,vmu7c279,FULL STUDY,170.0,s2,1,140,150.0,1,-10.0,1,buy,0,sell,0.4916787423410894,16,0,0,block 2 (G first),20.0,12.0,Female,1.0,0.0,1.0,"[2, 'block 2 (G first)']",1,1,0,0.5,8.0,-0.19999999999999996,0.5,0.04,1.0,0.0,4,1.0,0.25,Design 2,Design 2,"Have an option between Design #1 and Design #2,",4.0,,
2714,1946,2,Player object (897),buy,2023-03-08 01:47:49.011931+00:00,"{""priceA"": 135, ""sharesA"": 1, ""secs_since_round_starts"": 230, ""market"": ""A""}",10.0,41.0,8.0,wrahuh7u,vmu7c279,FULL STUDY,170.0,s2,1,135,140.0,-1,,1,sell,0,sell,0.4592429496222846,16,0,0,block 2 (G first),20.0,12.0,Female,1.0,0.0,1.0,"[2, 'block 2 (G first)']",1,1,0,0.5,8.0,-0.19999999999999996,0.5,0.04,1.0,0.0,4,1.0,0.25,Design 2,Design 2,"Have an option between Design #1 and Design #2,",4.0,,
2715,1947,2,Player object (897),sell,2023-03-08 01:48:09.942015+00:00,"{""priceA"": 140, ""sharesA"": 0, ""secs_since_round_starts"": 251, ""market"": ""A""}",150.0,45.0,9.0,wrahuh7u,vmu7c279,FULL STUDY,170.0,s2,1,140,135.0,1,5.0,1,buy,0,sell,0.5210834711709403,16,0,0,block 2 (G first),20.0,12.0,Female,1.0,0.0,1.0,"[2, 'block 2 (G first)']",1,1,0,0.5,8.0,-0.19999999999999996,0.5,0.04,1.0,0.0,4,1.0,0.25,Design 2,Design 2,"Have an option between Design #1 and Design #2,",4.0,,
2716,1948,2,Player object (897),buy,2023-03-08 01:48:48.648293+00:00,"{""priceA"": 125, ""sharesA"": 1, ""secs_since_round_starts"": 290, ""market"": ""A""}",25.0,52.0,10.0,wrahuh7u,vmu7c279,FULL STUDY,170.0,s2,1,125,140.0,-1,,1,sell,0,sell,0.4439176376077041,16,1,0,block 2 (G first),20.0,12.0,Female,1.0,0.0,1.0,"[2, 'block 2 (G first)']",1,1,0,0.5,8.0,-0.19999999999999996,0.5,0.04,1.0,0.0,4,1.0,0.25,Design 2,Design 2,"Have an option between Design #1 and Design #2,",4.0,,
2717,1949,2,Player object (897),sell,2023-03-08 01:48:59.764771+00:00,"{""priceA"": 145, ""sharesA"": 0, ""secs_since_round_starts"": 301, ""market"": ""A""}",170.0,54.0,11.0,wrahuh7u,vmu7c279,FULL STUDY,170.0,s2,1,145,125.0,1,20.0,1,buy,0,sell,0.5320134037503595,16,0,0,block 2 (G first),20.0,12.0,Female,1.0,0.0,1.0,"[2, 'block 2 (G first)']",1,1,0,0.5,8.0,-0.19999999999999996,0.5,0.04,1.0,0.0,4,1.0,0.25,Design 2,Design 2,"Have an option between Design #1 and Design #2,",4.0,,
2718,1950,2,Player object (897),buy,2023-03-08 01:49:10.869719+00:00,"{""priceA"": 125, ""sharesA"": 1, ""secs_since_round_starts"": 312, ""market"": ""A""}",45.0,56.0,12.0,wrahuh7u,vmu7c279,FULL STUDY,170.0,s2,1,125,145.0,-1,,1,sell,0,sell,0.4562406760637778,16,0,0,block 2 (G first),20.0,12.0,Female,1.0,0.0,1.0,"[2, 'block 2 (G first)']",1,1,0,0.5,8.0,-0.19999999999999996,0.5,0.04,1.0,0.0,4,1.0,0.25,Design 2,Design 2,"Have an option between Design #1 and Design #2,",4.0,,
2719,1951,2,Player object (897),sell,2023-03-08 01:49:32.919387+00:00,"{""priceA"": 125, ""sharesA"": 0, ""secs_since_round_starts"": 334, ""market"": ""A""}",170.0,60.0,13.0,wrahuh7u,vmu7c279,FULL STUDY,170.0,s2,1,125,125.0,1,0.0,1,buy,0,sell,0.5540089061739091,16,0,1,block 2 (G first),20.0,12.0,Female,1.0,0.0,1.0,"[2, 'block 2 (G first)']",1,1,0,0.5,8.0,-0.19999999999999996,0.5,0.04,1.0,0.0,4,1.0,0.25,Design 2,Design 2,"Have an option between Design #1 and Design #2,",4.0,,
2720,1955,3,Player object (1017),sell,2023-03-08 01:50:24.061576+00:00,"{""priceA"": 110, ""sharesA"": 0, ""secs_since_round_starts"": 44, ""market"": ""A""}",160.0,9.0,1.0,wrahuh7u,vmu7c279,FULL STUDY,225.0,s2,1,110,,1,,1,,0,sell,0.5389563723055646,19,0,0,block 2 (G first),20.0,12.0,Female,1.0,0.0,1.0,"[3, 'block 2 (G first)']",1,0,0,0.5,8.0,-0.19999999999999996,0.7,0.0,1.0,0.0,4,1.0,1.0,Design 2,Design 2,"Have an option between Design #1 and Design #2,",4.0,,
2721,1956,3,Player object (1017),buy,2023-03-08 01:50:28.951144+00:00,"{""priceA"": 95, ""sharesA"": 1, ""secs_since_round_starts"": 49, ""market"": ""A""}",65.0,10.0,2.0,wrahuh7u,vmu7c279,FULL STUDY,225.0,s2,1,95,110.0,-1,,1,sell,0,sell,0.4922087569005138,19,0,0,block 2 (G first),20.0,12.0,Female,1.0,0.0,1.0,"[3, 'block 2 (G first)']",1,0,0,0.5,8.0,-0.19999999999999996,0.7,0.0,1.0,0.0,4,1.0,1.0,Design 2,Design 2,"Have an option between Design #1 and Design #2,",4.0,,
2722,1957,3,Player object (1017),sell,2023-03-08 01:50:34.447163+00:00,"{""priceA"": 110, ""sharesA"": 0, ""secs_since_round_starts"": 54, ""market"": ""A""}",175.0,11.0,3.0,wrahuh7u,vmu7c279,FULL STUDY,225.0,s2,1,110,95.0,1,15.0,1,buy,0,sell,0.5295922419004607,19,0,0,block 2 (G first),20.0,12.0,Female,1.0,0.0,1.0,"[3, 'block 2 (G first)']",1,0,0,0.5,8.0,-0.19999999999999996,0.7,0.0,1.0,0.0,4,1.0,1.0,Design 2,Design 2,"Have an option between Design #1 and Design #2,",4.0,,
2723,1958,3,Player object (1017),buy,2023-03-08 01:51:02.457337+00:00,"{""priceA"": 100, ""sharesA"": 1, ""secs_since_round_starts"": 82, ""market"": ""A""}",75.0,16.0,4.0,wrahuh7u,vmu7c279,FULL STUDY,225.0,s2,1,100,110.0,-1,,1,sell,0,sell,0.4486815727575955,19,1,0,block 2 (G first),20.0,12.0,Female,1.0,0.0,1.0,"[3, 'block 2 (G first)']",1,0,0,0.5,8.0,-0.19999999999999996,0.7,0.0,1.0,0.0,4,1.0,1.0,Design 2,Design 2,"Have an option between Design #1 and Design #2,",4.0,,
2724,1959,3,Player object (1017),sell,2023-03-08 01:51:20.090036+00:00,"{""priceA"": 120, ""sharesA"": 0, ""secs_since_round_starts"": 100, ""market"": ""A""}",195.0,19.0,5.0,wrahuh7u,vmu7c279,FULL STUDY,225.0,s2,1,120,100.0,1,20.0,1,buy,0,sell,0.5586446427659006,19,0,1,block 2 (G first),20.0,12.0,Female,1.0,0.0,1.0,"[3, 'block 2 (G first)']",1,0,0,0.5,8.0,-0.19999999999999996,0.7,0.0,1.0,0.0,4,1.0,1.0,Design 2,Design 2,"Have an option between Design #1 and Design #2,",4.0,,
2725,1960,3,Player object (1017),buy,2023-03-08 01:51:29.490772+00:00,"{""priceA"": 100, ""sharesA"": 1, ""secs_since_round_starts"": 109, ""market"": ""A""}",95.0,21.0,6.0,wrahuh7u,vmu7c279,FULL STUDY,225.0,s2,1,100,120.0,-1,,1,sell,0,sell,0.4692484881524699,19,0,0,block 2 (G first),20.0,12.0,Female,1.0,0.0,1.0,"[3, 'block 2 (G first)']",1,0,0,0.5,8.0,-0.19999999999999996,0.7,0.0,1.0,0.0,4,1.0,1.0,Design 2,Design 2,"Have an option between Design #1 and Design #2,",4.0,,
2726,1961,3,Player object (1017),sell,2023-03-08 01:51:45.792502+00:00,"{""priceA"": 115, ""sharesA"": 0, ""secs_since_round_starts"": 126, ""market"": ""A""}",210.0,24.0,7.0,wrahuh7u,vmu7c279,FULL STUDY,225.0,s2,1,115,100.0,1,15.0,1,buy,0,sell,0.5319650978870379,19,0,0,block 2 (G first),20.0,12.0,Female,1.0,0.0,1.0,"[3, 'block 2 (G first)']",1,0,0,0.5,8.0,-0.19999999999999996,0.7,0.0,1.0,0.0,4,1.0,1.0,Design 2,Design 2,"Have an option between Design #1 and Design #2,",4.0,,
2727,1963,3,Player object (1017),buy,2023-03-08 01:52:30.692620+00:00,"{""priceA"": 110, ""sharesA"": 1, ""secs_since_round_starts"": 170, ""market"": ""A""}",100.0,32.0,8.0,wrahuh7u,vmu7c279,FULL STUDY,225.0,s2,1,110,115.0,-1,,1,sell,0,sell,0.4748947710808772,19,0,0,block 2 (G first),20.0,12.0,Female,1.0,0.0,1.0,"[3, 'block 2 (G first)']",1,0,0,0.5,8.0,-0.19999999999999996,0.7,0.0,1.0,0.0,4,1.0,1.0,Design 2,Design 2,"Have an option between Design #1 and Design #2,",4.0,,
2728,1964,3,Player object (1017),sell,2023-03-08 01:53:07.241368+00:00,"{""priceA"": 115, ""sharesA"": 0, ""secs_since_round_starts"": 207, ""market"": ""A""}",215.0,39.0,9.0,wrahuh7u,vmu7c279,FULL STUDY,225.0,s2,1,115,110.0,1,5.0,1,buy,0,sell,0.5221490272476892,19,0,0,block 2 (G first),20.0,12.0,Female,1.0,0.0,1.0,"[3, 'block 2 (G first)']",1,0,0,0.5,8.0,-0.19999999999999996,0.7,0.0,1.0,0.0,4,1.0,1.0,Design 2,Design 2,"Have an option between Design #1 and Design #2,",4.0,,
2729,1965,3,Player object (1017),buy,2023-03-08 01:53:13.026307+00:00,"{""priceA"": 100, ""sharesA"": 1, ""secs_since_round_starts"": 213, ""market"": ""A""}",115.0,40.0,10.0,wrahuh7u,vmu7c279,FULL STUDY,225.0,s2,1,100,115.0,-1,,1,sell,0,sell,0.4804175727303482,19,0,0,block 2 (G first),20.0,12.0,Female,1.0,0.0,1.0,"[3, 'block 2 (G first)']",1,0,0,0.5,8.0,-0.19999999999999996,0.7,0.0,1.0,0.0,4,1.0,1.0,Design 2,Design 2,"Have an option between Design #1 and Design #2,",4.0,,
2730,1966,3,Player object (1017),sell,2023-03-08 01:53:30.788001+00:00,"{""priceA"": 120, ""sharesA"": 0, ""secs_since_round_starts"": 230, ""market"": ""A""}",235.0,43.0,11.0,wrahuh7u,vmu7c279,FULL STUDY,225.0,s2,1,120,100.0,1,20.0,1,buy,0,sell,0.5357259670782416,19,0,0,block 2 (G first),20.0,12.0,Female,1.0,0.0,1.0,"[3, 'block 2 (G first)']",1,0,0,0.5,8.0,-0.19999999999999996,0.7,0.0,1.0,0.0,4,1.0,1.0,Design 2,Design 2,"Have an option between Design #1 and Design #2,",4.0,,
2731,1967,3,Player object (1017),buy,2023-03-08 01:53:58.322322+00:00,"{""priceA"": 125, ""sharesA"": 1, ""secs_since_round_starts"": 258, ""market"": ""A""}",110.0,48.0,12.0,wrahuh7u,vmu7c279,FULL STUDY,225.0,s2,1,125,120.0,-1,,1,sell,0,sell,0.4599698795591006,19,0,0,block 2 (G first),20.0,12.0,Female,1.0,0.0,1.0,"[3, 'block 2 (G first)']",1,0,0,0.5,8.0,-0.19999999999999996,0.7,0.0,1.0,0.0,4,1.0,1.0,Design 2,Design 2,"Have an option between Design #1 and Design #2,",4.0,,
2732,1968,3,Player object (1017),sell,2023-03-08 01:54:25.097580+00:00,"{""priceA"": 130, ""sharesA"": 0, ""secs_since_round_starts"": 285, ""market"": ""A""}",240.0,53.0,13.0,wrahuh7u,vmu7c279,FULL STUDY,225.0,s2,1,130,125.0,1,5.0,1,buy,0,sell,0.4905868559773416,19,0,0,block 2 (G first),20.0,12.0,Female,1.0,0.0,1.0,"[3, 'block 2 (G first)']",1,0,0,0.5,8.0,-0.19999999999999996,0.7,0.0,1.0,0.0,4,1.0,1.0,Design 2,Design 2,"Have an option between Design #1 and Design #2,",4.0,,
2733,1969,3,Player object (1017),buy,2023-03-08 01:54:46.975966+00:00,"{""priceA"": 130, ""sharesA"": 1, ""secs_since_round_starts"": 307, ""market"": ""A""}",110.0,57.0,14.0,wrahuh7u,vmu7c279,FULL STUDY,225.0,s2,1,130,130.0,-1,,1,sell,0,sell,0.46726452652799,19,0,0,block 2 (G first),20.0,12.0,Female,1.0,0.0,1.0,"[3, 'block 2 (G first)']",1,0,0,0.5,8.0,-0.19999999999999996,0.7,0.0,1.0,0.0,4,1.0,1.0,Design 2,Design 2,"Have an option between Design #1 and Design #2,",4.0,,
2734,1973,4,Player object (1137),sell,2023-03-08 01:55:52.191239+00:00,"{""priceA"": 70, ""sharesA"": 0, ""secs_since_round_starts"": 41, ""market"": ""A""}",120.0,9.0,1.0,wrahuh7u,vmu7c279,FULL STUDY,130.0,s2,1,70,,1,,1,,0,sell,0.5440818519127735,14,0,1,block 2 (G first),20.0,12.0,Female,1.0,0.0,1.0,"[4, 'block 2 (G first)']",0,1,0,0.5,8.0,-0.19999999999999996,1.0,0.03333333333333333,,0.125,2,1.0,0.5,Design 2,Design 2,"Have an option between Design #1 and Design #2,",4.0,,
2735,1974,4,Player object (1137),buy,2023-03-08 01:56:30.444671+00:00,"{""priceA"": 90, ""sharesA"": 1, ""secs_since_round_starts"": 79, ""market"": ""A""}",30.0,16.0,2.0,wrahuh7u,vmu7c279,FULL STUDY,130.0,s2,1,90,70.0,-1,,1,sell,0,sell,0.4995738325599586,14,0,0,block 2 (G first),20.0,12.0,Female,1.0,0.0,1.0,"[4, 'block 2 (G first)']",0,1,0,0.5,8.0,-0.19999999999999996,1.0,0.03333333333333333,,0.125,2,1.0,0.5,Design 2,Design 2,"Have an option between Design #1 and Design #2,",4.0,,
2736,1975,4,Player object (1137),sell,2023-03-08 01:57:42.080192+00:00,"{""priceA"": 90, ""sharesA"": 0, ""secs_since_round_starts"": 151, ""market"": ""A""}",120.0,29.0,3.0,wrahuh7u,vmu7c279,FULL STUDY,130.0,s2,1,90,90.0,1,0.0,1,buy,0,sell,0.5712793841154561,14,0,0,block 2 (G first),20.0,12.0,Female,1.0,0.0,1.0,"[4, 'block 2 (G first)']",0,1,0,0.5,8.0,-0.19999999999999996,1.0,0.03333333333333333,,0.125,2,1.0,0.5,Design 2,Design 2,"Have an option between Design #1 and Design #2,",4.0,,
2737,1977,4,Player object (1137),buy,2023-03-08 01:58:25.268035+00:00,"{""priceA"": 85, ""sharesA"": 1, ""secs_since_round_starts"": 194, ""market"": ""A""}",35.0,36.0,4.0,wrahuh7u,vmu7c279,FULL STUDY,130.0,s2,1,85,90.0,-1,,1,sell,0,sell,0.4885269486642424,14,0,0,block 2 (G first),20.0,12.0,Female,1.0,0.0,1.0,"[4, 'block 2 (G first)']",0,1,0,0.5,8.0,-0.19999999999999996,1.0,0.03333333333333333,,0.125,2,1.0,0.5,Design 2,Design 2,"Have an option between Design #1 and Design #2,",4.0,,
2738,1978,4,Player object (1137),sell,2023-03-08 01:58:57.845576+00:00,"{""priceA"": 95, ""sharesA"": 0, ""secs_since_round_starts"": 227, ""market"": ""A""}",130.0,42.0,5.0,wrahuh7u,vmu7c279,FULL STUDY,130.0,s2,1,95,85.0,1,10.0,1,buy,0,sell,0.5388552795609507,14,0,0,block 2 (G first),20.0,12.0,Female,1.0,0.0,1.0,"[4, 'block 2 (G first)']",0,1,0,0.5,8.0,-0.19999999999999996,1.0,0.03333333333333333,,0.125,2,1.0,0.5,Design 2,Design 2,"Have an option between Design #1 and Design #2,",4.0,,
2739,1979,4,Player object (1137),buy,2023-03-08 01:59:24.714119+00:00,"{""priceA"": 85, ""sharesA"": 1, ""secs_since_round_starts"": 254, ""market"": ""A""}",45.0,47.0,6.0,wrahuh7u,vmu7c279,FULL STUDY,130.0,s2,1,85,95.0,-1,,1,sell,0,sell,0.4501495476988393,14,1,0,block 2 (G first),20.0,12.0,Female,1.0,0.0,1.0,"[4, 'block 2 (G first)']",0,1,0,0.5,8.0,-0.19999999999999996,1.0,0.03333333333333333,,0.125,2,1.0,0.5,Design 2,Design 2,"Have an option between Design #1 and Design #2,",4.0,,
2740,1980,4,Player object (1137),sell,2023-03-08 01:59:30.754305+00:00,"{""priceA"": 100, ""sharesA"": 0, ""secs_since_round_starts"": 260, ""market"": ""A""}",145.0,48.0,7.0,wrahuh7u,vmu7c279,FULL STUDY,130.0,s2,1,100,85.0,1,15.0,1,buy,0,sell,0.500105737602651,14,0,0,block 2 (G first),20.0,12.0,Female,1.0,0.0,1.0,"[4, 'block 2 (G first)']",0,1,0,0.5,8.0,-0.19999999999999996,1.0,0.03333333333333333,,0.125,2,1.0,0.5,Design 2,Design 2,"Have an option between Design #1 and Design #2,",4.0,,
2741,1981,4,Player object (1137),buy,2023-03-08 01:59:52.531537+00:00,"{""priceA"": 90, ""sharesA"": 1, ""secs_since_round_starts"": 281, ""market"": ""A""}",55.0,52.0,8.0,wrahuh7u,vmu7c279,FULL STUDY,130.0,s2,1,90,100.0,-1,,1,sell,0,sell,0.4694909620846048,14,0,0,block 2 (G first),20.0,12.0,Female,1.0,0.0,1.0,"[4, 'block 2 (G first)']",0,1,0,0.5,8.0,-0.19999999999999996,1.0,0.03333333333333333,,0.125,2,1.0,0.5,Design 2,Design 2,"Have an option between Design #1 and Design #2,",4.0,,
2742,1985,5,Player object (1257),sell,2023-03-08 02:01:16.231530+00:00,"{""priceA"": 100, ""sharesA"": 0, ""secs_since_round_starts"": 32, ""market"": ""A""}",150.0,7.0,1.0,wrahuh7u,vmu7c279,FULL STUDY,215.0,s2,1,100,,1,,1,,0,sell,0.5733994727268583,17,0,0,block 2 (G first),20.0,12.0,Female,1.0,0.0,1.0,"[5, 'block 2 (G first)']",0,0,0,0.5,8.0,-0.19999999999999996,0.4166666666666667,0.0,1.0,0.0,2,1.0,0.5,Design 2,Design 2,"Have an option between Design #1 and Design #2,",4.0,,
2743,1986,5,Player object (1257),buy,2023-03-08 02:01:25.242554+00:00,"{""priceA"": 80, ""sharesA"": 1, ""secs_since_round_starts"": 41, ""market"": ""A""}",70.0,9.0,2.0,wrahuh7u,vmu7c279,FULL STUDY,215.0,s2,1,80,100.0,-1,,1,sell,0,sell,0.4765586288879626,17,0,0,block 2 (G first),20.0,12.0,Female,1.0,0.0,1.0,"[5, 'block 2 (G first)']",0,0,0,0.5,8.0,-0.19999999999999996,0.4166666666666667,0.0,1.0,0.0,2,1.0,0.5,Design 2,Design 2,"Have an option between Design #1 and Design #2,",4.0,,
2744,1987,5,Player object (1257),sell,2023-03-08 02:01:41.763283+00:00,"{""priceA"": 100, ""sharesA"": 0, ""secs_since_round_starts"": 58, ""market"": ""A""}",170.0,12.0,3.0,wrahuh7u,vmu7c279,FULL STUDY,215.0,s2,1,100,80.0,1,20.0,1,buy,0,sell,0.5344269279803172,17,0,0,block 2 (G first),20.0,12.0,Female,1.0,0.0,1.0,"[5, 'block 2 (G first)']",0,0,0,0.5,8.0,-0.19999999999999996,0.4166666666666667,0.0,1.0,0.0,2,1.0,0.5,Design 2,Design 2,"Have an option between Design #1 and Design #2,",4.0,,
2745,1988,5,Player object (1257),buy,2023-03-08 02:01:47.843898+00:00,"{""priceA"": 85, ""sharesA"": 1, ""secs_since_round_starts"": 64, ""market"": ""A""}",85.0,13.0,4.0,wrahuh7u,vmu7c279,FULL STUDY,215.0,s2,1,85,100.0,-1,,1,sell,0,sell,0.4890232705715233,17,0,0,block 2 (G first),20.0,12.0,Female,1.0,0.0,1.0,"[5, 'block 2 (G first)']",0,0,0,0.5,8.0,-0.19999999999999996,0.4166666666666667,0.0,1.0,0.0,2,1.0,0.5,Design 2,Design 2,"Have an option between Design #1 and Design #2,",4.0,,
2746,1989,5,Player object (1257),sell,2023-03-08 02:02:26.286857+00:00,"{""priceA"": 95, ""sharesA"": 0, ""secs_since_round_starts"": 103, ""market"": ""A""}",180.0,20.0,5.0,wrahuh7u,vmu7c279,FULL STUDY,215.0,s2,1,95,85.0,1,10.0,1,buy,0,sell,0.5232479875730728,17,0,0,block 2 (G first),20.0,12.0,Female,1.0,0.0,1.0,"[5, 'block 2 (G first)']",0,0,0,0.5,8.0,-0.19999999999999996,0.4166666666666667,0.0,1.0,0.0,2,1.0,0.5,Design 2,Design 2,"Have an option between Design #1 and Design #2,",4.0,,
2747,1990,5,Player object (1257),buy,2023-03-08 02:03:09.880334+00:00,"{""priceA"": 85, ""sharesA"": 1, ""secs_since_round_starts"": 146, ""market"": ""A""}",95.0,28.0,6.0,wrahuh7u,vmu7c279,FULL STUDY,215.0,s2,1,85,95.0,-1,,1,sell,0,sell,0.4496194529460131,17,1,0,block 2 (G first),20.0,12.0,Female,1.0,0.0,1.0,"[5, 'block 2 (G first)']",0,0,0,0.5,8.0,-0.19999999999999996,0.4166666666666667,0.0,1.0,0.0,2,1.0,0.5,Design 2,Design 2,"Have an option between Design #1 and Design #2,",4.0,,
2748,1992,5,Player object (1257),sell,2023-03-08 02:03:38.354773+00:00,"{""priceA"": 110, ""sharesA"": 0, ""secs_since_round_starts"": 175, ""market"": ""A""}",205.0,33.0,7.0,wrahuh7u,vmu7c279,FULL STUDY,215.0,s2,1,110,85.0,1,25.0,1,buy,0,sell,0.5480287979668599,17,0,1,block 2 (G first),20.0,12.0,Female,1.0,0.0,1.0,"[5, 'block 2 (G first)']",0,0,0,0.5,8.0,-0.19999999999999996,0.4166666666666667,0.0,1.0,0.0,2,1.0,0.5,Design 2,Design 2,"Have an option between Design #1 and Design #2,",4.0,,
2749,1993,5,Player object (1257),buy,2023-03-08 02:04:04.486926+00:00,"{""priceA"": 80, ""sharesA"": 1, ""secs_since_round_starts"": 201, ""market"": ""A""}",125.0,38.0,8.0,wrahuh7u,vmu7c279,FULL STUDY,215.0,s2,1,80,110.0,-1,,1,sell,0,sell,0.4515999245786187,17,1,0,block 2 (G first),20.0,12.0,Female,1.0,0.0,1.0,"[5, 'block 2 (G first)']",0,0,0,0.5,8.0,-0.19999999999999996,0.4166666666666667,0.0,1.0,0.0,2,1.0,0.5,Design 2,Design 2,"Have an option between Design #1 and Design #2,",4.0,,
2750,1994,5,Player object (1257),sell,2023-03-08 02:04:26.705061+00:00,"{""priceA"": 100, ""sharesA"": 0, ""secs_since_round_starts"": 223, ""market"": ""A""}",225.0,42.0,9.0,wrahuh7u,vmu7c279,FULL STUDY,215.0,s2,1,100,80.0,1,20.0,1,buy,0,sell,0.5529358605422235,17,0,1,block 2 (G first),20.0,12.0,Female,1.0,0.0,1.0,"[5, 'block 2 (G first)']",0,0,0,0.5,8.0,-0.19999999999999996,0.4166666666666667,0.0,1.0,0.0,2,1.0,0.5,Design 2,Design 2,"Have an option between Design #1 and Design #2,",4.0,,
2751,1995,5,Player object (1257),buy,2023-03-08 02:04:54.848535+00:00,"{""priceA"": 90, ""sharesA"": 1, ""secs_since_round_starts"": 251, ""market"": ""A""}",135.0,47.0,10.0,wrahuh7u,vmu7c279,FULL STUDY,215.0,s2,1,90,100.0,-1,,1,sell,0,sell,0.4627742743797309,17,0,0,block 2 (G first),20.0,12.0,Female,1.0,0.0,1.0,"[5, 'block 2 (G first)']",0,0,0,0.5,8.0,-0.19999999999999996,0.4166666666666667,0.0,1.0,0.0,2,1.0,0.5,Design 2,Design 2,"Have an option between Design #1 and Design #2,",4.0,,
2752,1996,5,Player object (1257),sell,2023-03-08 02:05:34.699384+00:00,"{""priceA"": 95, ""sharesA"": 0, ""secs_since_round_starts"": 291, ""market"": ""A""}",230.0,54.0,11.0,wrahuh7u,vmu7c279,FULL STUDY,215.0,s2,1,95,90.0,1,5.0,1,buy,0,sell,0.5299980248683189,17,0,0,block 2 (G first),20.0,12.0,Female,1.0,0.0,1.0,"[5, 'block 2 (G first)']",0,0,0,0.5,8.0,-0.19999999999999996,0.4166666666666667,0.0,1.0,0.0,2,1.0,0.5,Design 2,Design 2,"Have an option between Design #1 and Design #2,",4.0,,
2753,1997,5,Player object (1257),buy,2023-03-08 02:05:39.717641+00:00,"{""priceA"": 80, ""sharesA"": 1, ""secs_since_round_starts"": 296, ""market"": ""A""}",150.0,55.0,12.0,wrahuh7u,vmu7c279,FULL STUDY,215.0,s2,1,80,95.0,-1,,1,sell,0,sell,0.4859141076178286,17,0,0,block 2 (G first),20.0,12.0,Female,1.0,0.0,1.0,"[5, 'block 2 (G first)']",0,0,0,0.5,8.0,-0.19999999999999996,0.4166666666666667,0.0,1.0,0.0,2,1.0,0.5,Design 2,Design 2,"Have an option between Design #1 and Design #2,",4.0,,
2754,1698,2,Player object (884),sell,2023-03-07 04:22:32.937815+00:00,"{""priceA"": 75, ""sharesA"": 0, ""secs_since_round_starts"": 92, ""market"": ""A""}",125.0,10.0,1.0,y0d7uk3z,vmu7c279,FULL STUDY,190.0,s1,1,75,,1,,1,,0,sell,0.4825575314143953,16,0,0,block 4 (G second),21.0,12.0,Female,1.0,0.0,0.0,"[2, 'block 4 (G second)']",0,1,1,0.0,7.0,-0.30000000000000004,0.18181818181818182,0.041666666666666664,0.5,0.0,4,1.0,1.0,Design 2,Design 2,"Have an option between Design #1 and Design #2,",,4.0,3.0
2755,1700,2,Player object (884),buy,2023-03-07 04:22:39.660909+00:00,"{""priceA"": 65, ""sharesA"": 1, ""secs_since_round_starts"": 99, ""market"": ""A""}",60.0,11.0,2.0,y0d7uk3z,vmu7c279,FULL STUDY,190.0,s1,1,65,75.0,-1,,1,sell,0,sell,0.4529543903039196,16,0,0,block 4 (G second),21.0,12.0,Female,1.0,0.0,0.0,"[2, 'block 4 (G second)']",0,1,1,0.0,7.0,-0.30000000000000004,0.18181818181818182,0.041666666666666664,0.5,0.0,4,1.0,1.0,Design 2,Design 2,"Have an option between Design #1 and Design #2,",,4.0,3.0
2756,1701,2,Player object (884),sell,2023-03-07 04:23:00.404775+00:00,"{""priceA"": 120, ""sharesA"": 0, ""secs_since_round_starts"": 119, ""market"": ""A""}",180.0,15.0,3.0,y0d7uk3z,vmu7c279,FULL STUDY,190.0,s1,1,120,65.0,1,55.0,1,buy,0,sell,0.5761373211134116,16,0,0,block 4 (G second),21.0,12.0,Female,1.0,0.0,0.0,"[2, 'block 4 (G second)']",0,1,1,0.0,7.0,-0.30000000000000004,0.18181818181818182,0.041666666666666664,0.5,0.0,4,1.0,1.0,Design 2,Design 2,"Have an option between Design #1 and Design #2,",,4.0,3.0
2757,1703,2,Player object (884),buy,2023-03-07 04:23:55.900121+00:00,"{""priceA"": 145, ""sharesA"": 1, ""secs_since_round_starts"": 175, ""market"": ""A""}",35.0,25.0,4.0,y0d7uk3z,vmu7c279,FULL STUDY,190.0,s1,1,145,120.0,-1,,1,sell,0,sell,0.5294358264188312,16,0,0,block 4 (G second),21.0,12.0,Female,1.0,0.0,0.0,"[2, 'block 4 (G second)']",0,1,1,0.0,7.0,-0.30000000000000004,0.18181818181818182,0.041666666666666664,0.5,0.0,4,1.0,1.0,Design 2,Design 2,"Have an option between Design #1 and Design #2,",,4.0,3.0
2758,1711,2,Player object (884),sell,2023-03-07 04:26:05.906899+00:00,"{""priceA"": 155, ""sharesA"": 0, ""secs_since_round_starts"": 305, ""market"": ""A""}",190.0,46.0,5.0,y0d7uk3z,vmu7c279,FULL STUDY,190.0,s1,1,155,145.0,1,10.0,1,buy,0,sell,0.5495494947508355,16,0,1,block 4 (G second),21.0,12.0,Female,1.0,0.0,0.0,"[2, 'block 4 (G second)']",0,1,1,0.0,7.0,-0.30000000000000004,0.18181818181818182,0.041666666666666664,0.5,0.0,4,1.0,1.0,Design 2,Design 2,"Have an option between Design #1 and Design #2,",,4.0,3.0
2759,1713,2,Player object (884),buy,2023-03-07 04:26:39.142456+00:00,"{""priceA"": 125, ""sharesA"": 1, ""secs_since_round_starts"": 338, ""market"": ""A""}",65.0,52.0,6.0,y0d7uk3z,vmu7c279,FULL STUDY,190.0,s1,1,125,155.0,-1,,1,sell,0,sell,0.4439176376077041,16,1,0,block 4 (G second),21.0,12.0,Female,1.0,0.0,0.0,"[2, 'block 4 (G second)']",0,1,1,0.0,7.0,-0.30000000000000004,0.18181818181818182,0.041666666666666664,0.5,0.0,4,1.0,1.0,Design 2,Design 2,"Have an option between Design #1 and Design #2,",,4.0,3.0
2760,1723,3,Player object (1004),sell,2023-03-07 04:28:25.561368+00:00,"{""priceA"": 110, ""sharesA"": 0, ""secs_since_round_starts"": 55, ""market"": ""A""}",160.0,11.0,1.0,y0d7uk3z,vmu7c279,FULL STUDY,225.0,s1,1,110,,1,,1,,0,sell,0.5295922419004607,19,0,0,block 4 (G second),21.0,12.0,Female,1.0,0.0,0.0,"[3, 'block 4 (G second)']",0,0,1,0.5,7.0,-0.30000000000000004,0.2631578947368421,0.1111111111111111,0.5,0.0,4,1.0,0.5,Design 2,Design 2,"Have an option between Design #1 and Design #2,",,4.0,3.0
2761,1724,3,Player object (1004),buy,2023-03-07 04:28:53.236230+00:00,"{""priceA"": 100, ""sharesA"": 1, ""secs_since_round_starts"": 82, ""market"": ""A""}",60.0,16.0,2.0,y0d7uk3z,vmu7c279,FULL STUDY,225.0,s1,1,100,110.0,-1,,1,sell,0,sell,0.4486815727575955,19,1,0,block 4 (G second),21.0,12.0,Female,1.0,0.0,0.0,"[3, 'block 4 (G second)']",0,0,1,0.5,7.0,-0.30000000000000004,0.2631578947368421,0.1111111111111111,0.5,0.0,4,1.0,0.5,Design 2,Design 2,"Have an option between Design #1 and Design #2,",,4.0,3.0
2762,1725,3,Player object (1004),sell,2023-03-07 04:29:16.886523+00:00,"{""priceA"": 115, ""sharesA"": 0, ""secs_since_round_starts"": 106, ""market"": ""A""}",175.0,20.0,3.0,y0d7uk3z,vmu7c279,FULL STUDY,225.0,s1,1,115,100.0,1,15.0,1,buy,0,sell,0.5061230669509241,19,0,0,block 4 (G second),21.0,12.0,Female,1.0,0.0,0.0,"[3, 'block 4 (G second)']",0,0,1,0.5,7.0,-0.30000000000000004,0.2631578947368421,0.1111111111111111,0.5,0.0,4,1.0,0.5,Design 2,Design 2,"Have an option between Design #1 and Design #2,",,4.0,3.0
2763,1726,3,Player object (1004),buy,2023-03-07 04:29:21.754304+00:00,"{""priceA"": 100, ""sharesA"": 1, ""secs_since_round_starts"": 111, ""market"": ""A""}",75.0,21.0,4.0,y0d7uk3z,vmu7c279,FULL STUDY,225.0,s1,1,100,115.0,-1,,1,sell,0,sell,0.4692484881524699,19,0,0,block 4 (G second),21.0,12.0,Female,1.0,0.0,0.0,"[3, 'block 4 (G second)']",0,0,1,0.5,7.0,-0.30000000000000004,0.2631578947368421,0.1111111111111111,0.5,0.0,4,1.0,0.5,Design 2,Design 2,"Have an option between Design #1 and Design #2,",,4.0,3.0
2764,1727,3,Player object (1004),sell,2023-03-07 04:30:10.637123+00:00,"{""priceA"": 120, ""sharesA"": 0, ""secs_since_round_starts"": 160, ""market"": ""A""}",195.0,30.0,5.0,y0d7uk3z,vmu7c279,FULL STUDY,225.0,s1,1,120,100.0,1,20.0,1,buy,0,sell,0.570054331362491,19,0,1,block 4 (G second),21.0,12.0,Female,1.0,0.0,0.0,"[3, 'block 4 (G second)']",0,0,1,0.5,7.0,-0.30000000000000004,0.2631578947368421,0.1111111111111111,0.5,0.0,4,1.0,0.5,Design 2,Design 2,"Have an option between Design #1 and Design #2,",,4.0,3.0
2765,1729,3,Player object (1004),buy,2023-03-07 04:30:34.208551+00:00,"{""priceA"": 100, ""sharesA"": 1, ""secs_since_round_starts"": 183, ""market"": ""A""}",95.0,33.0,6.0,y0d7uk3z,vmu7c279,FULL STUDY,225.0,s1,1,100,120.0,-1,,1,sell,0,sell,0.4476889957041811,19,1,0,block 4 (G second),21.0,12.0,Female,1.0,0.0,0.0,"[3, 'block 4 (G second)']",0,0,1,0.5,7.0,-0.30000000000000004,0.2631578947368421,0.1111111111111111,0.5,0.0,4,1.0,0.5,Design 2,Design 2,"Have an option between Design #1 and Design #2,",,4.0,3.0
2766,1730,3,Player object (1004),sell,2023-03-07 04:31:29.507567+00:00,"{""priceA"": 120, ""sharesA"": 0, ""secs_since_round_starts"": 239, ""market"": ""A""}",215.0,43.0,7.0,y0d7uk3z,vmu7c279,FULL STUDY,225.0,s1,1,120,100.0,1,20.0,1,buy,0,sell,0.5357259670782416,19,0,0,block 4 (G second),21.0,12.0,Female,1.0,0.0,0.0,"[3, 'block 4 (G second)']",0,0,1,0.5,7.0,-0.30000000000000004,0.2631578947368421,0.1111111111111111,0.5,0.0,4,1.0,0.5,Design 2,Design 2,"Have an option between Design #1 and Design #2,",,4.0,3.0
2767,1731,3,Player object (1004),buy,2023-03-07 04:32:19.687282+00:00,"{""priceA"": 115, ""sharesA"": 1, ""secs_since_round_starts"": 289, ""market"": ""A""}",100.0,52.0,8.0,y0d7uk3z,vmu7c279,FULL STUDY,225.0,s1,1,115,120.0,-1,,1,sell,0,sell,0.4367228334197354,19,0,0,block 4 (G second),21.0,12.0,Female,1.0,0.0,0.0,"[3, 'block 4 (G second)']",0,0,1,0.5,7.0,-0.30000000000000004,0.2631578947368421,0.1111111111111111,0.5,0.0,4,1.0,0.5,Design 2,Design 2,"Have an option between Design #1 and Design #2,",,4.0,3.0
2768,1732,3,Player object (1004),sell,2023-03-07 04:32:24.783143+00:00,"{""priceA"": 130, ""sharesA"": 0, ""secs_since_round_starts"": 294, ""market"": ""A""}",230.0,53.0,9.0,y0d7uk3z,vmu7c279,FULL STUDY,225.0,s1,1,130,115.0,1,15.0,1,buy,0,sell,0.4905868559773416,19,0,0,block 4 (G second),21.0,12.0,Female,1.0,0.0,0.0,"[3, 'block 4 (G second)']",0,0,1,0.5,7.0,-0.30000000000000004,0.2631578947368421,0.1111111111111111,0.5,0.0,4,1.0,0.5,Design 2,Design 2,"Have an option between Design #1 and Design #2,",,4.0,3.0
2769,1733,3,Player object (1004),buy,2023-03-07 04:32:49.335806+00:00,"{""priceA"": 130, ""sharesA"": 1, ""secs_since_round_starts"": 318, ""market"": ""A""}",100.0,57.0,10.0,y0d7uk3z,vmu7c279,FULL STUDY,225.0,s1,1,130,130.0,-1,,1,sell,0,sell,0.46726452652799,19,0,0,block 4 (G second),21.0,12.0,Female,1.0,0.0,0.0,"[3, 'block 4 (G second)']",0,0,1,0.5,7.0,-0.30000000000000004,0.2631578947368421,0.1111111111111111,0.5,0.0,4,1.0,0.5,Design 2,Design 2,"Have an option between Design #1 and Design #2,",,4.0,3.0
2770,1734,3,Player object (1004),sell,2023-03-07 04:32:57.854691+00:00,"{""priceA"": 125, ""sharesA"": 0, ""secs_since_round_starts"": 327, ""market"": ""A""}",225.0,59.0,11.0,y0d7uk3z,vmu7c279,FULL STUDY,225.0,s1,1,125,130.0,1,-5.0,1,buy,0,sell,0.4946618842475483,19,0,0,block 4 (G second),21.0,12.0,Female,1.0,0.0,0.0,"[3, 'block 4 (G second)']",0,0,1,0.5,7.0,-0.30000000000000004,0.2631578947368421,0.1111111111111111,0.5,0.0,4,1.0,0.5,Design 2,Design 2,"Have an option between Design #1 and Design #2,",,4.0,3.0
2771,1735,3,Player object (1004),buy,2023-03-07 04:33:03.494213+00:00,"{""priceA"": 115, ""sharesA"": 1, ""secs_since_round_starts"": 333, ""market"": ""A""}",110.0,60.0,12.0,y0d7uk3z,vmu7c279,FULL STUDY,225.0,s1,1,115,125.0,-1,,1,sell,0,sell,0.4613046310449969,19,0,0,block 4 (G second),21.0,12.0,Female,1.0,0.0,0.0,"[3, 'block 4 (G second)']",0,0,1,0.5,7.0,-0.30000000000000004,0.2631578947368421,0.1111111111111111,0.5,0.0,4,1.0,0.5,Design 2,Design 2,"Have an option between Design #1 and Design #2,",,4.0,3.0
2772,1739,4,Player object (1124),sell,2023-03-07 04:35:51.162154+00:00,"{""priceA"": 85, ""sharesA"": 0, ""secs_since_round_starts"": 159, ""market"": ""A""}",135.0,30.0,1.0,y0d7uk3z,vmu7c279,FULL STUDY,155.0,s1,1,85,,1,,1,,0,sell,0.5151109892827086,14,0,0,block 4 (G second),21.0,12.0,Female,1.0,0.0,0.0,"[4, 'block 4 (G second)']",1,1,1,0.5,7.0,-0.30000000000000004,0.3333333333333333,0.023809523809523808,1.0,0.0,2,1.0,1.0,Design 2,Design 2,"Have an option between Design #1 and Design #2,",,4.0,3.0
2773,1741,4,Player object (1124),buy,2023-03-07 04:36:14.893640+00:00,"{""priceA"": 100, ""sharesA"": 1, ""secs_since_round_starts"": 182, ""market"": ""A""}",35.0,33.0,2.0,y0d7uk3z,vmu7c279,FULL STUDY,155.0,s1,1,100,85.0,-1,,1,sell,0,sell,0.5473882863317556,14,0,0,block 4 (G second),21.0,12.0,Female,1.0,0.0,0.0,"[4, 'block 4 (G second)']",1,1,1,0.5,7.0,-0.30000000000000004,0.3333333333333333,0.023809523809523808,1.0,0.0,2,1.0,1.0,Design 2,Design 2,"Have an option between Design #1 and Design #2,",,4.0,3.0
2774,1742,4,Player object (1124),sell,2023-03-07 04:37:07.292501+00:00,"{""priceA"": 100, ""sharesA"": 0, ""secs_since_round_starts"": 235, ""market"": ""A""}",135.0,43.0,3.0,y0d7uk3z,vmu7c279,FULL STUDY,155.0,s1,1,100,100.0,1,0.0,1,buy,0,sell,0.5617190733230237,14,0,1,block 4 (G second),21.0,12.0,Female,1.0,0.0,0.0,"[4, 'block 4 (G second)']",1,1,1,0.5,7.0,-0.30000000000000004,0.3333333333333333,0.023809523809523808,1.0,0.0,2,1.0,1.0,Design 2,Design 2,"Have an option between Design #1 and Design #2,",,4.0,3.0
2775,1743,4,Player object (1124),buy,2023-03-07 04:37:29.349791+00:00,"{""priceA"": 85, ""sharesA"": 1, ""secs_since_round_starts"": 257, ""market"": ""A""}",50.0,47.0,4.0,y0d7uk3z,vmu7c279,FULL STUDY,155.0,s1,1,85,100.0,-1,,1,sell,0,sell,0.4501495476988393,14,1,0,block 4 (G second),21.0,12.0,Female,1.0,0.0,0.0,"[4, 'block 4 (G second)']",1,1,1,0.5,7.0,-0.30000000000000004,0.3333333333333333,0.023809523809523808,1.0,0.0,2,1.0,1.0,Design 2,Design 2,"Have an option between Design #1 and Design #2,",,4.0,3.0
2776,1744,4,Player object (1124),sell,2023-03-07 04:37:45.589584+00:00,"{""priceA"": 120, ""sharesA"": 0, ""secs_since_round_starts"": 273, ""market"": ""A""}",170.0,50.0,5.0,y0d7uk3z,vmu7c279,FULL STUDY,155.0,s1,1,120,85.0,1,35.0,1,buy,0,sell,0.5591364702939366,14,0,1,block 4 (G second),21.0,12.0,Female,1.0,0.0,0.0,"[4, 'block 4 (G second)']",1,1,1,0.5,7.0,-0.30000000000000004,0.3333333333333333,0.023809523809523808,1.0,0.0,2,1.0,1.0,Design 2,Design 2,"Have an option between Design #1 and Design #2,",,4.0,3.0
2777,1745,4,Player object (1124),buy,2023-03-07 04:37:58.374830+00:00,"{""priceA"": 90, ""sharesA"": 1, ""secs_since_round_starts"": 286, ""market"": ""A""}",80.0,52.0,6.0,y0d7uk3z,vmu7c279,FULL STUDY,155.0,s1,1,90,120.0,-1,,1,sell,0,sell,0.4694909620846048,14,0,0,block 4 (G second),21.0,12.0,Female,1.0,0.0,0.0,"[4, 'block 4 (G second)']",1,1,1,0.5,7.0,-0.30000000000000004,0.3333333333333333,0.023809523809523808,1.0,0.0,2,1.0,1.0,Design 2,Design 2,"Have an option between Design #1 and Design #2,",,4.0,3.0
2778,1749,5,Player object (1244),sell,2023-03-07 04:39:26.000308+00:00,"{""priceA"": 100, ""sharesA"": 0, ""secs_since_round_starts"": 38, ""market"": ""A""}",150.0,7.0,1.0,y0d7uk3z,vmu7c279,FULL STUDY,230.0,s1,1,100,,1,,1,,0,sell,0.5733994727268583,17,0,0,block 4 (G second),21.0,12.0,Female,1.0,0.0,0.0,"[5, 'block 4 (G second)']",1,0,1,0.5,7.0,-0.30000000000000004,0.21052631578947367,0.0,0.0,0.0,4,0.5,0.0,Design 2,Design 2,"Have an option between Design #1 and Design #2,",,4.0,3.0
2779,1750,5,Player object (1244),buy,2023-03-07 04:39:36.507057+00:00,"{""priceA"": 80, ""sharesA"": 1, ""secs_since_round_starts"": 48, ""market"": ""A""}",70.0,9.0,2.0,y0d7uk3z,vmu7c279,FULL STUDY,230.0,s1,1,80,100.0,-1,,1,sell,0,sell,0.4765586288879626,17,0,0,block 4 (G second),21.0,12.0,Female,1.0,0.0,0.0,"[5, 'block 4 (G second)']",1,0,1,0.5,7.0,-0.30000000000000004,0.21052631578947367,0.0,0.0,0.0,4,0.5,0.0,Design 2,Design 2,"Have an option between Design #1 and Design #2,",,4.0,3.0
2780,1751,5,Player object (1244),sell,2023-03-07 04:40:38.514373+00:00,"{""priceA"": 95, ""sharesA"": 0, ""secs_since_round_starts"": 110, ""market"": ""A""}",165.0,20.0,3.0,y0d7uk3z,vmu7c279,FULL STUDY,230.0,s1,1,95,80.0,1,15.0,1,buy,0,sell,0.5232479875730728,17,0,0,block 4 (G second),21.0,12.0,Female,1.0,0.0,0.0,"[5, 'block 4 (G second)']",1,0,1,0.5,7.0,-0.30000000000000004,0.21052631578947367,0.0,0.0,0.0,4,0.5,0.0,Design 2,Design 2,"Have an option between Design #1 and Design #2,",,4.0,3.0
2781,1752,5,Player object (1244),buy,2023-03-07 04:41:16.414690+00:00,"{""priceA"": 100, ""sharesA"": 1, ""secs_since_round_starts"": 148, ""market"": ""A""}",65.0,27.0,4.0,y0d7uk3z,vmu7c279,FULL STUDY,230.0,s1,1,100,95.0,-1,,1,sell,0,sell,0.4777068930880888,17,0,0,block 4 (G second),21.0,12.0,Female,1.0,0.0,0.0,"[5, 'block 4 (G second)']",1,0,1,0.5,7.0,-0.30000000000000004,0.21052631578947367,0.0,0.0,0.0,4,0.5,0.0,Design 2,Design 2,"Have an option between Design #1 and Design #2,",,4.0,3.0
2782,1754,5,Player object (1244),sell,2023-03-07 04:42:16.100474+00:00,"{""priceA"": 120, ""sharesA"": 0, ""secs_since_round_starts"": 208, ""market"": ""A""}",185.0,34.0,5.0,y0d7uk3z,vmu7c279,FULL STUDY,230.0,s1,1,120,100.0,1,20.0,1,buy,0,sell,0.5679672812132522,17,0,0,block 4 (G second),21.0,12.0,Female,1.0,0.0,0.0,"[5, 'block 4 (G second)']",1,0,1,0.5,7.0,-0.30000000000000004,0.21052631578947367,0.0,0.0,0.0,4,0.5,0.0,Design 2,Design 2,"Have an option between Design #1 and Design #2,",,4.0,3.0
2783,1755,5,Player object (1244),buy,2023-03-07 04:42:43.059801+00:00,"{""priceA"": 70, ""sharesA"": 1, ""secs_since_round_starts"": 235, ""market"": ""A""}",115.0,39.0,6.0,y0d7uk3z,vmu7c279,FULL STUDY,230.0,s1,1,70,120.0,-1,,1,sell,0,sell,0.4317803147869401,17,0,0,block 4 (G second),21.0,12.0,Female,1.0,0.0,0.0,"[5, 'block 4 (G second)']",1,0,1,0.5,7.0,-0.30000000000000004,0.21052631578947367,0.0,0.0,0.0,4,0.5,0.0,Design 2,Design 2,"Have an option between Design #1 and Design #2,",,4.0,3.0
2784,1756,5,Player object (1244),sell,2023-03-07 04:43:05.701768+00:00,"{""priceA"": 110, ""sharesA"": 0, ""secs_since_round_starts"": 257, ""market"": ""A""}",225.0,43.0,7.0,y0d7uk3z,vmu7c279,FULL STUDY,230.0,s1,1,110,70.0,1,40.0,1,buy,0,sell,0.571300234525265,17,0,0,block 4 (G second),21.0,12.0,Female,1.0,0.0,0.0,"[5, 'block 4 (G second)']",1,0,1,0.5,7.0,-0.30000000000000004,0.21052631578947367,0.0,0.0,0.0,4,0.5,0.0,Design 2,Design 2,"Have an option between Design #1 and Design #2,",,4.0,3.0
2785,1757,5,Player object (1244),buy,2023-03-07 04:43:32.820298+00:00,"{""priceA"": 75, ""sharesA"": 1, ""secs_since_round_starts"": 284, ""market"": ""A""}",150.0,48.0,8.0,y0d7uk3z,vmu7c279,FULL STUDY,230.0,s1,1,75,110.0,-1,,1,sell,0,sell,0.4393932183506925,17,1,0,block 4 (G second),21.0,12.0,Female,1.0,0.0,0.0,"[5, 'block 4 (G second)']",1,0,1,0.5,7.0,-0.30000000000000004,0.21052631578947367,0.0,0.0,0.0,4,0.5,0.0,Design 2,Design 2,"Have an option between Design #1 and Design #2,",,4.0,3.0
2786,1758,5,Player object (1244),sell,2023-03-07 04:44:06.372620+00:00,"{""priceA"": 95, ""sharesA"": 0, ""secs_since_round_starts"": 318, ""market"": ""A""}",245.0,54.0,9.0,y0d7uk3z,vmu7c279,FULL STUDY,230.0,s1,1,95,75.0,1,20.0,1,buy,0,sell,0.5299980248683189,17,0,0,block 4 (G second),21.0,12.0,Female,1.0,0.0,0.0,"[5, 'block 4 (G second)']",1,0,1,0.5,7.0,-0.30000000000000004,0.21052631578947367,0.0,0.0,0.0,4,0.5,0.0,Design 2,Design 2,"Have an option between Design #1 and Design #2,",,4.0,3.0
2787,1759,5,Player object (1244),buy,2023-03-07 04:44:12.687744+00:00,"{""priceA"": 80, ""sharesA"": 1, ""secs_since_round_starts"": 324, ""market"": ""A""}",165.0,55.0,10.0,y0d7uk3z,vmu7c279,FULL STUDY,230.0,s1,1,80,95.0,-1,,1,sell,0,sell,0.4859141076178286,17,0,0,block 4 (G second),21.0,12.0,Female,1.0,0.0,0.0,"[5, 'block 4 (G second)']",1,0,1,0.5,7.0,-0.30000000000000004,0.21052631578947367,0.0,0.0,0.0,4,0.5,0.0,Design 2,Design 2,"Have an option between Design #1 and Design #2,",,4.0,3.0
2788,2365,2,Player object (909),sell,2023-03-08 04:55:49.795506+00:00,"{""priceA"": 120, ""sharesA"": 0, ""secs_since_round_starts"": 135, ""market"": ""A""}",170.0,15.0,1.0,yq3wii2n,vmu7c279,FULL STUDY,210.0,s2,1,120,,1,,1,,0,sell,0.5761373211134116,16,0,0,block 4 (G second),21.0,11.0,Female,1.0,0.0,0.0,"[2, 'block 4 (G second)']",0,1,1,0.5,5.0,-0.41666666666666663,0.4,0.0,0.0,0.0,4,1.0,0.25,Design 1,Design 1,"Have an option between Design #1 and Design #2,",3.0,,
2789,2366,2,Player object (909),buy,2023-03-08 04:56:52.022427+00:00,"{""priceA"": 140, ""sharesA"": 1, ""secs_since_round_starts"": 197, ""market"": ""A""}",30.0,26.0,2.0,yq3wii2n,vmu7c279,FULL STUDY,210.0,s2,1,140,120.0,-1,,1,sell,0,sell,0.4855198313469848,16,0,0,block 4 (G second),21.0,11.0,Female,1.0,0.0,0.0,"[2, 'block 4 (G second)']",0,1,1,0.5,5.0,-0.41666666666666663,0.4,0.0,0.0,0.0,4,1.0,0.25,Design 1,Design 1,"Have an option between Design #1 and Design #2,",3.0,,
2790,2368,2,Player object (909),sell,2023-03-08 04:57:56.192895+00:00,"{""priceA"": 145, ""sharesA"": 0, ""secs_since_round_starts"": 262, ""market"": ""A""}",175.0,37.0,3.0,yq3wii2n,vmu7c279,FULL STUDY,210.0,s2,1,145,140.0,1,5.0,1,buy,0,sell,0.494384744736363,16,0,0,block 4 (G second),21.0,11.0,Female,1.0,0.0,0.0,"[2, 'block 4 (G second)']",0,1,1,0.5,5.0,-0.41666666666666663,0.4,0.0,0.0,0.0,4,1.0,0.25,Design 1,Design 1,"Have an option between Design #1 and Design #2,",3.0,,
2791,2369,2,Player object (909),buy,2023-03-08 04:58:26.979743+00:00,"{""priceA"": 125, ""sharesA"": 1, ""secs_since_round_starts"": 292, ""market"": ""A""}",50.0,43.0,4.0,yq3wii2n,vmu7c279,FULL STUDY,210.0,s2,1,125,145.0,-1,,1,sell,0,sell,0.4218732662739463,16,1,0,block 4 (G second),21.0,11.0,Female,1.0,0.0,0.0,"[2, 'block 4 (G second)']",0,1,1,0.5,5.0,-0.41666666666666663,0.4,0.0,0.0,0.0,4,1.0,0.25,Design 1,Design 1,"Have an option between Design #1 and Design #2,",3.0,,
2792,2370,2,Player object (909),sell,2023-03-08 04:58:38.289625+00:00,"{""priceA"": 140, ""sharesA"": 0, ""secs_since_round_starts"": 304, ""market"": ""A""}",190.0,45.0,5.0,yq3wii2n,vmu7c279,FULL STUDY,210.0,s2,1,140,125.0,1,15.0,1,buy,0,sell,0.5210834711709403,16,0,0,block 4 (G second),21.0,11.0,Female,1.0,0.0,0.0,"[2, 'block 4 (G second)']",0,1,1,0.5,5.0,-0.41666666666666663,0.4,0.0,0.0,0.0,4,1.0,0.25,Design 1,Design 1,"Have an option between Design #1 and Design #2,",3.0,,
2793,2371,2,Player object (909),buy,2023-03-08 04:59:16.538262+00:00,"{""priceA"": 125, ""sharesA"": 1, ""secs_since_round_starts"": 342, ""market"": ""A""}",65.0,52.0,6.0,yq3wii2n,vmu7c279,FULL STUDY,210.0,s2,1,125,140.0,-1,,1,sell,0,sell,0.4439176376077041,16,1,0,block 4 (G second),21.0,11.0,Female,1.0,0.0,0.0,"[2, 'block 4 (G second)']",0,1,1,0.5,5.0,-0.41666666666666663,0.4,0.0,0.0,0.0,4,1.0,0.25,Design 1,Design 1,"Have an option between Design #1 and Design #2,",3.0,,
2794,2372,2,Player object (909),sell,2023-03-08 04:59:30.840044+00:00,"{""priceA"": 145, ""sharesA"": 0, ""secs_since_round_starts"": 356, ""market"": ""A""}",210.0,54.0,7.0,yq3wii2n,vmu7c279,FULL STUDY,210.0,s2,1,145,125.0,1,20.0,1,buy,0,sell,0.5320134037503595,16,0,0,block 4 (G second),21.0,11.0,Female,1.0,0.0,0.0,"[2, 'block 4 (G second)']",0,1,1,0.5,5.0,-0.41666666666666663,0.4,0.0,0.0,0.0,4,1.0,0.25,Design 1,Design 1,"Have an option between Design #1 and Design #2,",3.0,,
2795,2373,2,Player object (909),buy,2023-03-08 04:59:40.374767+00:00,"{""priceA"": 125, ""sharesA"": 1, ""secs_since_round_starts"": 366, ""market"": ""A""}",85.0,56.0,8.0,yq3wii2n,vmu7c279,FULL STUDY,210.0,s2,1,125,145.0,-1,,1,sell,0,sell,0.4562406760637778,16,0,0,block 4 (G second),21.0,11.0,Female,1.0,0.0,0.0,"[2, 'block 4 (G second)']",0,1,1,0.5,5.0,-0.41666666666666663,0.4,0.0,0.0,0.0,4,1.0,0.25,Design 1,Design 1,"Have an option between Design #1 and Design #2,",3.0,,
2796,2377,3,Player object (1029),sell,2023-03-08 05:01:00.714340+00:00,"{""priceA"": 110, ""sharesA"": 0, ""secs_since_round_starts"": 45, ""market"": ""A""}",160.0,9.0,1.0,yq3wii2n,vmu7c279,FULL STUDY,270.0,s2,1,110,,1,,1,,0,sell,0.5389563723055646,19,0,0,block 4 (G second),21.0,11.0,Female,1.0,0.0,0.0,"[3, 'block 4 (G second)']",0,0,1,0.5,5.0,-0.41666666666666663,0.375,0.0,1.0,0.0,2,0.5,0.5,Design 1,Design 1,"Have an option between Design #1 and Design #2,",3.0,,
2797,2378,3,Player object (1029),buy,2023-03-08 05:01:38.919557+00:00,"{""priceA"": 100, ""sharesA"": 1, ""secs_since_round_starts"": 83, ""market"": ""A""}",60.0,16.0,2.0,yq3wii2n,vmu7c279,FULL STUDY,270.0,s2,1,100,110.0,-1,,1,sell,0,sell,0.4486815727575955,19,1,0,block 4 (G second),21.0,11.0,Female,1.0,0.0,0.0,"[3, 'block 4 (G second)']",0,0,1,0.5,5.0,-0.41666666666666663,0.375,0.0,1.0,0.0,2,0.5,0.5,Design 1,Design 1,"Have an option between Design #1 and Design #2,",3.0,,
2798,2379,3,Player object (1029),sell,2023-03-08 05:01:57.747379+00:00,"{""priceA"": 120, ""sharesA"": 0, ""secs_since_round_starts"": 102, ""market"": ""A""}",180.0,19.0,3.0,yq3wii2n,vmu7c279,FULL STUDY,270.0,s2,1,120,100.0,1,20.0,1,buy,0,sell,0.5586446427659006,19,0,1,block 4 (G second),21.0,11.0,Female,1.0,0.0,0.0,"[3, 'block 4 (G second)']",0,0,1,0.5,5.0,-0.41666666666666663,0.375,0.0,1.0,0.0,2,0.5,0.5,Design 1,Design 1,"Have an option between Design #1 and Design #2,",3.0,,
2799,2380,3,Player object (1029),buy,2023-03-08 05:02:07.642375+00:00,"{""priceA"": 100, ""sharesA"": 1, ""secs_since_round_starts"": 112, ""market"": ""A""}",80.0,21.0,4.0,yq3wii2n,vmu7c279,FULL STUDY,270.0,s2,1,100,120.0,-1,,1,sell,0,sell,0.4692484881524699,19,0,0,block 4 (G second),21.0,11.0,Female,1.0,0.0,0.0,"[3, 'block 4 (G second)']",0,0,1,0.5,5.0,-0.41666666666666663,0.375,0.0,1.0,0.0,2,0.5,0.5,Design 1,Design 1,"Have an option between Design #1 and Design #2,",3.0,,
2800,2381,3,Player object (1029),sell,2023-03-08 05:02:26.080645+00:00,"{""priceA"": 115, ""sharesA"": 0, ""secs_since_round_starts"": 130, ""market"": ""A""}",195.0,24.0,5.0,yq3wii2n,vmu7c279,FULL STUDY,270.0,s2,1,115,100.0,1,15.0,1,buy,0,sell,0.5319650978870379,19,0,0,block 4 (G second),21.0,11.0,Female,1.0,0.0,0.0,"[3, 'block 4 (G second)']",0,0,1,0.5,5.0,-0.41666666666666663,0.375,0.0,1.0,0.0,2,0.5,0.5,Design 1,Design 1,"Have an option between Design #1 and Design #2,",3.0,,
2801,2383,3,Player object (1029),buy,2023-03-08 05:03:17.365033+00:00,"{""priceA"": 100, ""sharesA"": 1, ""secs_since_round_starts"": 182, ""market"": ""A""}",95.0,33.0,6.0,yq3wii2n,vmu7c279,FULL STUDY,270.0,s2,1,100,115.0,-1,,1,sell,0,sell,0.4476889957041811,19,1,0,block 4 (G second),21.0,11.0,Female,1.0,0.0,0.0,"[3, 'block 4 (G second)']",0,0,1,0.5,5.0,-0.41666666666666663,0.375,0.0,1.0,0.0,2,0.5,0.5,Design 1,Design 1,"Have an option between Design #1 and Design #2,",3.0,,
2802,2384,3,Player object (1029),sell,2023-03-08 05:03:48.682774+00:00,"{""priceA"": 115, ""sharesA"": 0, ""secs_since_round_starts"": 213, ""market"": ""A""}",210.0,39.0,7.0,yq3wii2n,vmu7c279,FULL STUDY,270.0,s2,1,115,100.0,1,15.0,1,buy,0,sell,0.5221490272476892,19,0,0,block 4 (G second),21.0,11.0,Female,1.0,0.0,0.0,"[3, 'block 4 (G second)']",0,0,1,0.5,5.0,-0.41666666666666663,0.375,0.0,1.0,0.0,2,0.5,0.5,Design 1,Design 1,"Have an option between Design #1 and Design #2,",3.0,,
2803,2385,3,Player object (1029),buy,2023-03-08 05:04:01.014275+00:00,"{""priceA"": 95, ""sharesA"": 1, ""secs_since_round_starts"": 225, ""market"": ""A""}",115.0,41.0,8.0,yq3wii2n,vmu7c279,FULL STUDY,270.0,s2,1,95,115.0,-1,,1,sell,0,sell,0.4514823197003955,19,0,0,block 4 (G second),21.0,11.0,Female,1.0,0.0,0.0,"[3, 'block 4 (G second)']",0,0,1,0.5,5.0,-0.41666666666666663,0.375,0.0,1.0,0.0,2,0.5,0.5,Design 1,Design 1,"Have an option between Design #1 and Design #2,",3.0,,
2804,2386,3,Player object (1029),sell,2023-03-08 05:04:11.379899+00:00,"{""priceA"": 120, ""sharesA"": 0, ""secs_since_round_starts"": 236, ""market"": ""A""}",235.0,43.0,9.0,yq3wii2n,vmu7c279,FULL STUDY,270.0,s2,1,120,95.0,1,25.0,1,buy,0,sell,0.5357259670782416,19,0,0,block 4 (G second),21.0,11.0,Female,1.0,0.0,0.0,"[3, 'block 4 (G second)']",0,0,1,0.5,5.0,-0.41666666666666663,0.375,0.0,1.0,0.0,2,0.5,0.5,Design 1,Design 1,"Have an option between Design #1 and Design #2,",3.0,,
2805,2387,3,Player object (1029),buy,2023-03-08 05:04:42.501218+00:00,"{""priceA"": 110, ""sharesA"": 1, ""secs_since_round_starts"": 267, ""market"": ""A""}",125.0,49.0,10.0,yq3wii2n,vmu7c279,FULL STUDY,270.0,s2,1,110,120.0,-1,,1,sell,0,sell,0.4374794566672981,19,1,0,block 4 (G second),21.0,11.0,Female,1.0,0.0,0.0,"[3, 'block 4 (G second)']",0,0,1,0.5,5.0,-0.41666666666666663,0.375,0.0,1.0,0.0,2,0.5,0.5,Design 1,Design 1,"Have an option between Design #1 and Design #2,",3.0,,
2806,2388,3,Player object (1029),sell,2023-03-08 05:05:10.223262+00:00,"{""priceA"": 145, ""sharesA"": 0, ""secs_since_round_starts"": 294, ""market"": ""A""}",270.0,54.0,11.0,yq3wii2n,vmu7c279,FULL STUDY,270.0,s2,1,145,110.0,1,35.0,1,buy,0,sell,0.52846438705912,19,0,0,block 4 (G second),21.0,11.0,Female,1.0,0.0,0.0,"[3, 'block 4 (G second)']",0,0,1,0.5,5.0,-0.41666666666666663,0.375,0.0,1.0,0.0,2,0.5,0.5,Design 1,Design 1,"Have an option between Design #1 and Design #2,",3.0,,
2807,2389,3,Player object (1029),buy,2023-03-08 05:05:33.397163+00:00,"{""priceA"": 115, ""sharesA"": 1, ""secs_since_round_starts"": 318, ""market"": ""A""}",155.0,58.0,12.0,yq3wii2n,vmu7c279,FULL STUDY,270.0,s2,1,115,145.0,-1,,1,sell,0,sell,0.442461876115205,19,1,0,block 4 (G second),21.0,11.0,Female,1.0,0.0,0.0,"[3, 'block 4 (G second)']",0,0,1,0.5,5.0,-0.41666666666666663,0.375,0.0,1.0,0.0,2,0.5,0.5,Design 1,Design 1,"Have an option between Design #1 and Design #2,",3.0,,
2808,2396,4,Player object (1149),sell,2023-03-08 05:07:18.420093+00:00,"{""priceA"": 90, ""sharesA"": 0, ""secs_since_round_starts"": 76, ""market"": ""A""}",140.0,14.0,1.0,yq3wii2n,vmu7c279,FULL STUDY,195.0,s2,1,90,,1,,1,,0,sell,0.5208618681016636,14,0,0,block 4 (G second),21.0,11.0,Female,1.0,0.0,0.0,"[4, 'block 4 (G second)']",1,1,1,0.5,5.0,-0.41666666666666663,0.3333333333333333,0.043478260869565216,1.0,0.0,2,1.0,0.5,Design 1,Design 1,"Have an option between Design #1 and Design #2,",3.0,,
2809,2399,4,Player object (1149),buy,2023-03-08 05:07:40.721498+00:00,"{""priceA"": 70, ""sharesA"": 1, ""secs_since_round_starts"": 99, ""market"": ""A""}",70.0,18.0,2.0,yq3wii2n,vmu7c279,FULL STUDY,195.0,s2,1,70,90.0,-1,,1,sell,0,sell,0.4407118028401492,14,1,0,block 4 (G second),21.0,11.0,Female,1.0,0.0,0.0,"[4, 'block 4 (G second)']",1,1,1,0.5,5.0,-0.41666666666666663,0.3333333333333333,0.043478260869565216,1.0,0.0,2,1.0,0.5,Design 1,Design 1,"Have an option between Design #1 and Design #2,",3.0,,
2810,2403,4,Player object (1149),sell,2023-03-08 05:08:34.141126+00:00,"{""priceA"": 80, ""sharesA"": 0, ""secs_since_round_starts"": 152, ""market"": ""A""}",150.0,28.0,3.0,yq3wii2n,vmu7c279,FULL STUDY,195.0,s2,1,80,70.0,1,10.0,1,buy,0,sell,0.5529051331090981,14,0,1,block 4 (G second),21.0,11.0,Female,1.0,0.0,0.0,"[4, 'block 4 (G second)']",1,1,1,0.5,5.0,-0.41666666666666663,0.3333333333333333,0.043478260869565216,1.0,0.0,2,1.0,0.5,Design 1,Design 1,"Have an option between Design #1 and Design #2,",3.0,,
2811,2406,4,Player object (1149),buy,2023-03-08 05:09:21.664132+00:00,"{""priceA"": 70, ""sharesA"": 1, ""secs_since_round_starts"": 200, ""market"": ""A""}",80.0,37.0,4.0,yq3wii2n,vmu7c279,FULL STUDY,195.0,s2,1,70,80.0,-1,,1,sell,0,sell,0.4570673777008929,14,0,0,block 4 (G second),21.0,11.0,Female,1.0,0.0,0.0,"[4, 'block 4 (G second)']",1,1,1,0.5,5.0,-0.41666666666666663,0.3333333333333333,0.043478260869565216,1.0,0.0,2,1.0,0.5,Design 1,Design 1,"Have an option between Design #1 and Design #2,",3.0,,
2812,2407,4,Player object (1149),sell,2023-03-08 05:09:49.394653+00:00,"{""priceA"": 95, ""sharesA"": 0, ""secs_since_round_starts"": 227, ""market"": ""A""}",175.0,42.0,5.0,yq3wii2n,vmu7c279,FULL STUDY,195.0,s2,1,95,70.0,1,25.0,1,buy,0,sell,0.5388552795609507,14,0,0,block 4 (G second),21.0,11.0,Female,1.0,0.0,0.0,"[4, 'block 4 (G second)']",1,1,1,0.5,5.0,-0.41666666666666663,0.3333333333333333,0.043478260869565216,1.0,0.0,2,1.0,0.5,Design 1,Design 1,"Have an option between Design #1 and Design #2,",3.0,,
2813,2409,4,Player object (1149),buy,2023-03-08 05:10:18.185276+00:00,"{""priceA"": 85, ""sharesA"": 1, ""secs_since_round_starts"": 256, ""market"": ""A""}",90.0,47.0,6.0,yq3wii2n,vmu7c279,FULL STUDY,195.0,s2,1,85,95.0,-1,,1,sell,0,sell,0.4501495476988393,14,1,0,block 4 (G second),21.0,11.0,Female,1.0,0.0,0.0,"[4, 'block 4 (G second)']",1,1,1,0.5,5.0,-0.41666666666666663,0.3333333333333333,0.043478260869565216,1.0,0.0,2,1.0,0.5,Design 1,Design 1,"Have an option between Design #1 and Design #2,",3.0,,
2814,2410,4,Player object (1149),sell,2023-03-08 05:10:30.561185+00:00,"{""priceA"": 105, ""sharesA"": 0, ""secs_since_round_starts"": 269, ""market"": ""A""}",195.0,49.0,7.0,yq3wii2n,vmu7c279,FULL STUDY,195.0,s2,1,105,85.0,1,20.0,1,buy,0,sell,0.5350732746090608,14,0,0,block 4 (G second),21.0,11.0,Female,1.0,0.0,0.0,"[4, 'block 4 (G second)']",1,1,1,0.5,5.0,-0.41666666666666663,0.3333333333333333,0.043478260869565216,1.0,0.0,2,1.0,0.5,Design 1,Design 1,"Have an option between Design #1 and Design #2,",3.0,,
2815,2412,4,Player object (1149),buy,2023-03-08 05:10:51.773735+00:00,"{""priceA"": 75, ""sharesA"": 1, ""secs_since_round_starts"": 290, ""market"": ""A""}",120.0,53.0,8.0,yq3wii2n,vmu7c279,FULL STUDY,195.0,s2,1,75,105.0,-1,,1,sell,0,sell,0.4439854633835125,14,1,0,block 4 (G second),21.0,11.0,Female,1.0,0.0,0.0,"[4, 'block 4 (G second)']",1,1,1,0.5,5.0,-0.41666666666666663,0.3333333333333333,0.043478260869565216,1.0,0.0,2,1.0,0.5,Design 1,Design 1,"Have an option between Design #1 and Design #2,",3.0,,
2816,2419,5,Player object (1269),sell,2023-03-08 05:12:25.831279+00:00,"{""priceA"": 100, ""sharesA"": 0, ""secs_since_round_starts"": 44, ""market"": ""A""}",150.0,7.0,1.0,yq3wii2n,vmu7c279,FULL STUDY,200.0,s2,1,100,,1,,1,,0,sell,0.5733994727268583,17,0,0,block 4 (G second),21.0,11.0,Female,1.0,0.0,0.0,"[5, 'block 4 (G second)']",1,0,1,0.5,5.0,-0.41666666666666663,0.3076923076923077,0.0,0.5,0.0,4,0.5,0.75,Design 1,Design 1,"Have an option between Design #1 and Design #2,",3.0,,
2817,2420,5,Player object (1269),buy,2023-03-08 05:12:35.383941+00:00,"{""priceA"": 80, ""sharesA"": 1, ""secs_since_round_starts"": 53, ""market"": ""A""}",70.0,9.0,2.0,yq3wii2n,vmu7c279,FULL STUDY,200.0,s2,1,80,100.0,-1,,1,sell,0,sell,0.4765586288879626,17,0,0,block 4 (G second),21.0,11.0,Female,1.0,0.0,0.0,"[5, 'block 4 (G second)']",1,0,1,0.5,5.0,-0.41666666666666663,0.3076923076923077,0.0,0.5,0.0,4,0.5,0.75,Design 1,Design 1,"Have an option between Design #1 and Design #2,",3.0,,
2818,2425,5,Player object (1269),sell,2023-03-08 05:13:36.183140+00:00,"{""priceA"": 95, ""sharesA"": 0, ""secs_since_round_starts"": 114, ""market"": ""A""}",165.0,20.0,3.0,yq3wii2n,vmu7c279,FULL STUDY,200.0,s2,1,95,80.0,1,15.0,1,buy,0,sell,0.5232479875730728,17,0,0,block 4 (G second),21.0,11.0,Female,1.0,0.0,0.0,"[5, 'block 4 (G second)']",1,0,1,0.5,5.0,-0.41666666666666663,0.3076923076923077,0.0,0.5,0.0,4,0.5,0.75,Design 1,Design 1,"Have an option between Design #1 and Design #2,",3.0,,
2819,2426,5,Player object (1269),buy,2023-03-08 05:14:17.974631+00:00,"{""priceA"": 85, ""sharesA"": 1, ""secs_since_round_starts"": 156, ""market"": ""A""}",80.0,28.0,4.0,yq3wii2n,vmu7c279,FULL STUDY,200.0,s2,1,85,95.0,-1,,1,sell,0,sell,0.4496194529460131,17,1,0,block 4 (G second),21.0,11.0,Female,1.0,0.0,0.0,"[5, 'block 4 (G second)']",1,0,1,0.5,5.0,-0.41666666666666663,0.3076923076923077,0.0,0.5,0.0,4,0.5,0.75,Design 1,Design 1,"Have an option between Design #1 and Design #2,",3.0,,
2820,2429,5,Player object (1269),sell,2023-03-08 05:14:44.476297+00:00,"{""priceA"": 110, ""sharesA"": 0, ""secs_since_round_starts"": 182, ""market"": ""A""}",190.0,33.0,5.0,yq3wii2n,vmu7c279,FULL STUDY,200.0,s2,1,110,85.0,1,25.0,1,buy,0,sell,0.5480287979668599,17,0,1,block 4 (G second),21.0,11.0,Female,1.0,0.0,0.0,"[5, 'block 4 (G second)']",1,0,1,0.5,5.0,-0.41666666666666663,0.3076923076923077,0.0,0.5,0.0,4,0.5,0.75,Design 1,Design 1,"Have an option between Design #1 and Design #2,",3.0,,
2821,2431,5,Player object (1269),buy,2023-03-08 05:15:08.107444+00:00,"{""priceA"": 95, ""sharesA"": 1, ""secs_since_round_starts"": 206, ""market"": ""A""}",95.0,37.0,6.0,yq3wii2n,vmu7c279,FULL STUDY,200.0,s2,1,95,110.0,-1,,1,sell,0,sell,0.4805886028013266,17,0,0,block 4 (G second),21.0,11.0,Female,1.0,0.0,0.0,"[5, 'block 4 (G second)']",1,0,1,0.5,5.0,-0.41666666666666663,0.3076923076923077,0.0,0.5,0.0,4,0.5,0.75,Design 1,Design 1,"Have an option between Design #1 and Design #2,",3.0,,
2822,2432,5,Player object (1269),sell,2023-03-08 05:15:39.331556+00:00,"{""priceA"": 110, ""sharesA"": 0, ""secs_since_round_starts"": 237, ""market"": ""A""}",205.0,43.0,7.0,yq3wii2n,vmu7c279,FULL STUDY,200.0,s2,1,110,95.0,1,15.0,1,buy,0,sell,0.571300234525265,17,0,0,block 4 (G second),21.0,11.0,Female,1.0,0.0,0.0,"[5, 'block 4 (G second)']",1,0,1,0.5,5.0,-0.41666666666666663,0.3076923076923077,0.0,0.5,0.0,4,0.5,0.75,Design 1,Design 1,"Have an option between Design #1 and Design #2,",3.0,,
2823,2433,5,Player object (1269),buy,2023-03-08 05:16:03.104140+00:00,"{""priceA"": 90, ""sharesA"": 1, ""secs_since_round_starts"": 261, ""market"": ""A""}",115.0,47.0,8.0,yq3wii2n,vmu7c279,FULL STUDY,200.0,s2,1,90,110.0,-1,,1,sell,0,sell,0.4627742743797309,17,0,0,block 4 (G second),21.0,11.0,Female,1.0,0.0,0.0,"[5, 'block 4 (G second)']",1,0,1,0.5,5.0,-0.41666666666666663,0.3076923076923077,0.0,0.5,0.0,4,0.5,0.75,Design 1,Design 1,"Have an option between Design #1 and Design #2,",3.0,,
2824,2435,5,Player object (1269),sell,2023-03-08 05:16:51.252937+00:00,"{""priceA"": 95, ""sharesA"": 0, ""secs_since_round_starts"": 309, ""market"": ""A""}",210.0,56.0,9.0,yq3wii2n,vmu7c279,FULL STUDY,200.0,s2,1,95,90.0,1,5.0,1,buy,0,sell,0.5252108989343294,17,0,0,block 4 (G second),21.0,11.0,Female,1.0,0.0,0.0,"[5, 'block 4 (G second)']",1,0,1,0.5,5.0,-0.41666666666666663,0.3076923076923077,0.0,0.5,0.0,4,0.5,0.75,Design 1,Design 1,"Have an option between Design #1 and Design #2,",3.0,,
2825,2436,5,Player object (1269),buy,2023-03-08 05:17:02.915532+00:00,"{""priceA"": 75, ""sharesA"": 1, ""secs_since_round_starts"": 321, ""market"": ""A""}",135.0,58.0,10.0,yq3wii2n,vmu7c279,FULL STUDY,200.0,s2,1,75,95.0,-1,,1,sell,0,sell,0.4529558772574278,17,0,0,block 4 (G second),21.0,11.0,Female,1.0,0.0,0.0,"[5, 'block 4 (G second)']",1,0,1,0.5,5.0,-0.41666666666666663,0.3076923076923077,0.0,0.5,0.0,4,0.5,0.75,Design 1,Design 1,"Have an option between Design #1 and Design #2,",3.0,,
2826,1076,2,Player object (870),sell,2023-03-04 23:18:51.776235+00:00,"{""priceA"": 65, ""sharesA"": 0, ""secs_since_round_starts"": 120, ""market"": ""A""}",115.0,15.0,1.0,yt3h0how,vmu7c279,FULL STUDY,140.0,s4,1,65,,1,,1,,0,sell,0.5,0,1,0,block 1 (G first),21.0,12.0,Male,1.0,1.0,1.0,"[2, 'block 1 (G first)']",1,0,0,0.0,5.0,-0.5,0.18181818181818182,0.09090909090909091,0.0,0.4,2,0.75,0.5,Design 2,Design 2,"Have an option between Design #1 and Design #2,",3.0,,
2827,1077,2,Player object (870),buy,2023-03-04 23:18:55.668355+00:00,"{""priceA"": 55, ""sharesA"": 1, ""secs_since_round_starts"": 124, ""market"": ""A""}",60.0,16.0,2.0,yt3h0how,vmu7c279,FULL STUDY,140.0,s4,1,55,65.0,-1,,1,sell,0,sell,0.5,0,0,0,block 1 (G first),21.0,12.0,Male,1.0,1.0,1.0,"[2, 'block 1 (G first)']",1,0,0,0.0,5.0,-0.5,0.18181818181818182,0.09090909090909091,0.0,0.4,2,0.75,0.5,Design 2,Design 2,"Have an option between Design #1 and Design #2,",3.0,,
2828,1078,2,Player object (870),sell,2023-03-04 23:19:34.694733+00:00,"{""priceA"": 90, ""sharesA"": 0, ""secs_since_round_starts"": 163, ""market"": ""A""}",150.0,23.0,3.0,yt3h0how,vmu7c279,FULL STUDY,140.0,s4,1,90,55.0,1,35.0,1,buy,0,sell,0.5,0,0,0,block 1 (G first),21.0,12.0,Male,1.0,1.0,1.0,"[2, 'block 1 (G first)']",1,0,0,0.0,5.0,-0.5,0.18181818181818182,0.09090909090909091,0.0,0.4,2,0.75,0.5,Design 2,Design 2,"Have an option between Design #1 and Design #2,",3.0,,
2829,1080,2,Player object (870),buy,2023-03-04 23:20:35.832621+00:00,"{""priceA"": 90, ""sharesA"": 1, ""secs_since_round_starts"": 224, ""market"": ""A""}",60.0,33.0,4.0,yt3h0how,vmu7c279,FULL STUDY,140.0,s4,1,90,90.0,-1,,1,sell,0,sell,0.5,0,0,0,block 1 (G first),21.0,12.0,Male,1.0,1.0,1.0,"[2, 'block 1 (G first)']",1,0,0,0.0,5.0,-0.5,0.18181818181818182,0.09090909090909091,0.0,0.4,2,0.75,0.5,Design 2,Design 2,"Have an option between Design #1 and Design #2,",3.0,,
2830,1081,2,Player object (870),sell,2023-03-04 23:22:03.817396+00:00,"{""priceA"": 65, ""sharesA"": 0, ""secs_since_round_starts"": 312, ""market"": ""A""}",125.0,49.0,5.0,yt3h0how,vmu7c279,FULL STUDY,140.0,s4,1,65,90.0,1,-25.0,1,buy,0,sell,0.5,0,0,1,block 1 (G first),21.0,12.0,Male,1.0,1.0,1.0,"[2, 'block 1 (G first)']",1,0,0,0.0,5.0,-0.5,0.18181818181818182,0.09090909090909091,0.0,0.4,2,0.75,0.5,Design 2,Design 2,"Have an option between Design #1 and Design #2,",3.0,,
2831,1082,2,Player object (870),buy,2023-03-04 23:22:36.198690+00:00,"{""priceA"": 80, ""sharesA"": 1, ""secs_since_round_starts"": 344, ""market"": ""A""}",45.0,55.0,6.0,yt3h0how,vmu7c279,FULL STUDY,140.0,s4,1,80,65.0,-1,,1,sell,0,sell,0.5,0,0,0,block 1 (G first),21.0,12.0,Male,1.0,1.0,1.0,"[2, 'block 1 (G first)']",1,0,0,0.0,5.0,-0.5,0.18181818181818182,0.09090909090909091,0.0,0.4,2,0.75,0.5,Design 2,Design 2,"Have an option between Design #1 and Design #2,",3.0,,
2832,1083,2,Player object (870),sell,2023-03-04 23:22:48.703860+00:00,"{""priceA"": 95, ""sharesA"": 0, ""secs_since_round_starts"": 357, ""market"": ""A""}",140.0,57.0,7.0,yt3h0how,vmu7c279,FULL STUDY,140.0,s4,1,95,80.0,1,15.0,1,buy,0,sell,0.5,0,0,0,block 1 (G first),21.0,12.0,Male,1.0,1.0,1.0,"[2, 'block 1 (G first)']",1,0,0,0.0,5.0,-0.5,0.18181818181818182,0.09090909090909091,0.0,0.4,2,0.75,0.5,Design 2,Design 2,"Have an option between Design #1 and Design #2,",3.0,,
2833,1087,3,Player object (990),sell,2023-03-04 23:23:54.720637+00:00,"{""priceA"": 120, ""sharesA"": 0, ""secs_since_round_starts"": 44, ""market"": ""A""}",170.0,8.0,1.0,yt3h0how,vmu7c279,FULL STUDY,245.0,s4,1,120,,1,,1,,0,sell,0.5,0,0,0,block 1 (G first),21.0,12.0,Male,1.0,1.0,1.0,"[3, 'block 1 (G first)']",1,1,0,0.0,5.0,-0.5,0.17647058823529413,0.0,0.25,0.0,3,1.0,0.5,Design 2,Design 2,"Have an option between Design #1 and Design #2,",3.0,,
2834,1088,3,Player object (990),buy,2023-03-04 23:25:06.112311+00:00,"{""priceA"": 130, ""sharesA"": 1, ""secs_since_round_starts"": 116, ""market"": ""A""}",40.0,21.0,2.0,yt3h0how,vmu7c279,FULL STUDY,245.0,s4,1,130,120.0,-1,,1,sell,0,sell,0.5,0,1,0,block 1 (G first),21.0,12.0,Male,1.0,1.0,1.0,"[3, 'block 1 (G first)']",1,1,0,0.0,5.0,-0.5,0.17647058823529413,0.0,0.25,0.0,3,1.0,0.5,Design 2,Design 2,"Have an option between Design #1 and Design #2,",3.0,,
2835,1089,3,Player object (990),sell,2023-03-04 23:25:33.672693+00:00,"{""priceA"": 170, ""sharesA"": 0, ""secs_since_round_starts"": 143, ""market"": ""A""}",210.0,26.0,3.0,yt3h0how,vmu7c279,FULL STUDY,245.0,s4,1,170,130.0,1,40.0,1,buy,0,sell,0.5,0,0,0,block 1 (G first),21.0,12.0,Male,1.0,1.0,1.0,"[3, 'block 1 (G first)']",1,1,0,0.0,5.0,-0.5,0.17647058823529413,0.0,0.25,0.0,3,1.0,0.5,Design 2,Design 2,"Have an option between Design #1 and Design #2,",3.0,,
2836,1091,3,Player object (990),buy,2023-03-04 23:26:14.123740+00:00,"{""priceA"": 140, ""sharesA"": 1, ""secs_since_round_starts"": 184, ""market"": ""A""}",70.0,33.0,4.0,yt3h0how,vmu7c279,FULL STUDY,245.0,s4,1,140,170.0,-1,,1,sell,0,sell,0.5,0,1,0,block 1 (G first),21.0,12.0,Male,1.0,1.0,1.0,"[3, 'block 1 (G first)']",1,1,0,0.0,5.0,-0.5,0.17647058823529413,0.0,0.25,0.0,3,1.0,0.5,Design 2,Design 2,"Have an option between Design #1 and Design #2,",3.0,,
2837,1092,3,Player object (990),sell,2023-03-04 23:27:48.106827+00:00,"{""priceA"": 170, ""sharesA"": 0, ""secs_since_round_starts"": 278, ""market"": ""A""}",240.0,50.0,5.0,yt3h0how,vmu7c279,FULL STUDY,245.0,s4,1,170,140.0,1,30.0,1,buy,0,sell,0.5,0,0,1,block 1 (G first),21.0,12.0,Male,1.0,1.0,1.0,"[3, 'block 1 (G first)']",1,1,0,0.0,5.0,-0.5,0.17647058823529413,0.0,0.25,0.0,3,1.0,0.5,Design 2,Design 2,"Have an option between Design #1 and Design #2,",3.0,,
2838,1093,3,Player object (990),buy,2023-03-04 23:28:21.176925+00:00,"{""priceA"": 175, ""sharesA"": 1, ""secs_since_round_starts"": 311, ""market"": ""A""}",65.0,56.0,6.0,yt3h0how,vmu7c279,FULL STUDY,245.0,s4,1,175,170.0,-1,,1,sell,0,sell,0.5,0,1,0,block 1 (G first),21.0,12.0,Male,1.0,1.0,1.0,"[3, 'block 1 (G first)']",1,1,0,0.0,5.0,-0.5,0.17647058823529413,0.0,0.25,0.0,3,1.0,0.5,Design 2,Design 2,"Have an option between Design #1 and Design #2,",3.0,,
2839,1097,4,Player object (1110),sell,2023-03-04 23:29:46.412069+00:00,"{""priceA"": 120, ""sharesA"": 0, ""secs_since_round_starts"": 57, ""market"": ""A""}",170.0,11.0,1.0,yt3h0how,vmu7c279,FULL STUDY,125.0,s4,1,120,,1,,1,,0,sell,0.5,0,0,0,block 1 (G first),21.0,12.0,Male,1.0,1.0,1.0,"[4, 'block 1 (G first)']",0,0,0,0.0,5.0,-0.5,0.14285714285714285,0.2857142857142857,,0.5,4,0.75,0.5,Design 2,Design 2,"Have an option between Design #1 and Design #2,",3.0,,
2840,1098,4,Player object (1110),buy,2023-03-04 23:30:06.700133+00:00,"{""priceA"": 100, ""sharesA"": 1, ""secs_since_round_starts"": 78, ""market"": ""A""}",70.0,15.0,2.0,yt3h0how,vmu7c279,FULL STUDY,125.0,s4,1,100,120.0,-1,,1,sell,0,sell,0.5,0,0,0,block 1 (G first),21.0,12.0,Male,1.0,1.0,1.0,"[4, 'block 1 (G first)']",0,0,0,0.0,5.0,-0.5,0.14285714285714285,0.2857142857142857,,0.5,4,0.75,0.5,Design 2,Design 2,"Have an option between Design #1 and Design #2,",3.0,,
2841,1099,4,Player object (1110),sell,2023-03-04 23:30:34.173488+00:00,"{""priceA"": 75, ""sharesA"": 0, ""secs_since_round_starts"": 105, ""market"": ""A""}",145.0,20.0,3.0,yt3h0how,vmu7c279,FULL STUDY,125.0,s4,1,75,100.0,1,-25.0,1,buy,0,sell,0.5,0,0,0,block 1 (G first),21.0,12.0,Male,1.0,1.0,1.0,"[4, 'block 1 (G first)']",0,0,0,0.0,5.0,-0.5,0.14285714285714285,0.2857142857142857,,0.5,4,0.75,0.5,Design 2,Design 2,"Have an option between Design #1 and Design #2,",3.0,,
2842,1100,4,Player object (1110),buy,2023-03-04 23:30:55.896255+00:00,"{""priceA"": 50, ""sharesA"": 1, ""secs_since_round_starts"": 127, ""market"": ""A""}",95.0,24.0,4.0,yt3h0how,vmu7c279,FULL STUDY,125.0,s4,1,50,75.0,-1,,1,sell,0,sell,0.5,0,0,0,block 1 (G first),21.0,12.0,Male,1.0,1.0,1.0,"[4, 'block 1 (G first)']",0,0,0,0.0,5.0,-0.5,0.14285714285714285,0.2857142857142857,,0.5,4,0.75,0.5,Design 2,Design 2,"Have an option between Design #1 and Design #2,",3.0,,
2843,1101,4,Player object (1110),sell,2023-03-04 23:31:08.331170+00:00,"{""priceA"": 30, ""sharesA"": 0, ""secs_since_round_starts"": 139, ""market"": ""A""}",125.0,26.0,5.0,yt3h0how,vmu7c279,FULL STUDY,125.0,s4,1,30,50.0,1,-20.0,1,buy,0,sell,0.5,0,1,0,block 1 (G first),21.0,12.0,Male,1.0,1.0,1.0,"[4, 'block 1 (G first)']",0,0,0,0.0,5.0,-0.5,0.14285714285714285,0.2857142857142857,,0.5,4,0.75,0.5,Design 2,Design 2,"Have an option between Design #1 and Design #2,",3.0,,
2844,1106,5,Player object (1230),sell,2023-03-04 23:36:23.610658+00:00,"{""priceA"": 150, ""sharesA"": 0, ""secs_since_round_starts"": 121, ""market"": ""A""}",200.0,23.0,1.0,yt3h0how,vmu7c279,FULL STUDY,170.0,s4,1,150,,1,,1,,0,sell,0.5,0,0,0,block 1 (G first),21.0,12.0,Male,1.0,1.0,1.0,"[5, 'block 1 (G first)']",0,1,0,0.5,5.0,-0.5,0.03333333333333333,0.09090909090909091,0.0,1.0,4,0.75,0.75,Design 2,Design 2,"Have an option between Design #1 and Design #2,",3.0,,
2845,1107,5,Player object (1230),buy,2023-03-04 23:37:03.690650+00:00,"{""priceA"": 125, ""sharesA"": 1, ""secs_since_round_starts"": 161, ""market"": ""A""}",75.0,30.0,2.0,yt3h0how,vmu7c279,FULL STUDY,170.0,s4,1,125,150.0,-1,,1,sell,0,sell,0.5,0,1,0,block 1 (G first),21.0,12.0,Male,1.0,1.0,1.0,"[5, 'block 1 (G first)']",0,1,0,0.5,5.0,-0.5,0.03333333333333333,0.09090909090909091,0.0,1.0,4,0.75,0.75,Design 2,Design 2,"Have an option between Design #1 and Design #2,",3.0,,
2846,1109,5,Player object (1230),sell,2023-03-04 23:38:48.206406+00:00,"{""priceA"": 100, ""sharesA"": 0, ""secs_since_round_starts"": 266, ""market"": ""A""}",175.0,49.0,3.0,yt3h0how,vmu7c279,FULL STUDY,170.0,s4,1,100,125.0,1,-25.0,1,buy,0,sell,0.5,0,1,0,block 1 (G first),21.0,12.0,Male,1.0,1.0,1.0,"[5, 'block 1 (G first)']",0,1,0,0.5,5.0,-0.5,0.03333333333333333,0.09090909090909091,0.0,1.0,4,0.75,0.75,Design 2,Design 2,"Have an option between Design #1 and Design #2,",3.0,,
2847,1110,5,Player object (1230),buy,2023-03-04 23:38:59.828025+00:00,"{""priceA"": 100, ""sharesA"": 1, ""secs_since_round_starts"": 277, ""market"": ""A""}",75.0,51.0,4.0,yt3h0how,vmu7c279,FULL STUDY,170.0,s4,1,100,100.0,-1,,1,sell,0,sell,0.5,0,0,0,block 1 (G first),21.0,12.0,Male,1.0,1.0,1.0,"[5, 'block 1 (G first)']",0,1,0,0.5,5.0,-0.5,0.03333333333333333,0.09090909090909091,0.0,1.0,4,0.75,0.75,Design 2,Design 2,"Have an option between Design #1 and Design #2,",3.0,,
2848,1116,2,Player object (872),sell,2023-03-05 01:43:45.596000+00:00,"{""priceA"": 130, ""sharesA"": 0, ""secs_since_round_starts"": 127, ""market"": ""A""}",180.0,19.0,1.0,zzc584nm,vmu7c279,FULL STUDY,210.0,s1,1,130,,1,,1,,0,sell,0.5813773703663461,16,0,1,block 2 (G first),21.0,11.0,Male,1.0,1.0,0.0,"[2, 'block 2 (G first)']",1,1,0,0.5,7.0,-0.21666666666666667,0.10526315789473684,0.0,0.3333333333333333,0.0,4,1.0,0.5,Design 1,Design 1,"Have an option between Design #1 and Design #2,",,3.0,3.0
2849,1117,2,Player object (872),buy,2023-03-05 01:44:40.269018+00:00,"{""priceA"": 115, ""sharesA"": 1, ""secs_since_round_starts"": 181, ""market"": ""A""}",65.0,29.0,2.0,zzc584nm,vmu7c279,FULL STUDY,210.0,s1,1,115,130.0,-1,,1,sell,0,sell,0.41991811093665,16,0,0,block 2 (G first),21.0,11.0,Male,1.0,1.0,0.0,"[2, 'block 2 (G first)']",1,1,0,0.5,7.0,-0.21666666666666667,0.10526315789473684,0.0,0.3333333333333333,0.0,4,1.0,0.5,Design 1,Design 1,"Have an option between Design #1 and Design #2,",,3.0,3.0
2850,1119,2,Player object (872),sell,2023-03-05 01:46:02.034587+00:00,"{""priceA"": 145, ""sharesA"": 0, ""secs_since_round_starts"": 263, ""market"": ""A""}",210.0,37.0,3.0,zzc584nm,vmu7c279,FULL STUDY,210.0,s1,1,145,115.0,1,30.0,1,buy,0,sell,0.494384744736363,16,0,0,block 2 (G first),21.0,11.0,Male,1.0,1.0,0.0,"[2, 'block 2 (G first)']",1,1,0,0.5,7.0,-0.21666666666666667,0.10526315789473684,0.0,0.3333333333333333,0.0,4,1.0,0.5,Design 1,Design 1,"Have an option between Design #1 and Design #2,",,3.0,3.0
2851,1120,2,Player object (872),buy,2023-03-05 01:47:24.262123+00:00,"{""priceA"": 125, ""sharesA"": 1, ""secs_since_round_starts"": 345, ""market"": ""A""}",85.0,52.0,4.0,zzc584nm,vmu7c279,FULL STUDY,210.0,s1,1,125,145.0,-1,,1,sell,0,sell,0.4439176376077041,16,1,0,block 2 (G first),21.0,11.0,Male,1.0,1.0,0.0,"[2, 'block 2 (G first)']",1,1,0,0.5,7.0,-0.21666666666666667,0.10526315789473684,0.0,0.3333333333333333,0.0,4,1.0,0.5,Design 1,Design 1,"Have an option between Design #1 and Design #2,",,3.0,3.0
2852,1124,3,Player object (992),sell,2023-03-05 01:49:18.034179+00:00,"{""priceA"": 130, ""sharesA"": 0, ""secs_since_round_starts"": 64, ""market"": ""A""}",180.0,13.0,1.0,zzc584nm,vmu7c279,FULL STUDY,230.0,s1,1,130,,1,,1,,0,sell,0.5729625045047859,19,0,1,block 2 (G first),21.0,11.0,Male,1.0,1.0,0.0,"[3, 'block 2 (G first)']",1,0,0,0.5,7.0,-0.21666666666666667,0.07692307692307693,0.0,0.4,0.0,4,1.0,0.25,Design 1,Design 1,"Have an option between Design #1 and Design #2,",,3.0,3.0
2853,1125,3,Player object (992),buy,2023-03-05 01:50:06.899409+00:00,"{""priceA"": 85, ""sharesA"": 1, ""secs_since_round_starts"": 113, ""market"": ""A""}",95.0,22.0,2.0,zzc584nm,vmu7c279,FULL STUDY,230.0,s1,1,85,130.0,-1,,1,sell,0,sell,0.443819468959905,19,1,0,block 2 (G first),21.0,11.0,Male,1.0,1.0,0.0,"[3, 'block 2 (G first)']",1,0,0,0.5,7.0,-0.21666666666666667,0.07692307692307693,0.0,0.4,0.0,4,1.0,0.25,Design 1,Design 1,"Have an option between Design #1 and Design #2,",,3.0,3.0
2854,1127,3,Player object (992),sell,2023-03-05 01:52:08.629648+00:00,"{""priceA"": 135, ""sharesA"": 0, ""secs_since_round_starts"": 235, ""market"": ""A""}",230.0,44.0,3.0,zzc584nm,vmu7c279,FULL STUDY,230.0,s1,1,135,85.0,1,50.0,1,buy,0,sell,0.5595824488336746,19,0,1,block 2 (G first),21.0,11.0,Male,1.0,1.0,0.0,"[3, 'block 2 (G first)']",1,0,0,0.5,7.0,-0.21666666666666667,0.07692307692307693,0.0,0.4,0.0,4,1.0,0.25,Design 1,Design 1,"Have an option between Design #1 and Design #2,",,3.0,3.0
2855,1132,4,Player object (1112),sell,2023-03-05 01:56:34.963349+00:00,"{""priceA"": 100, ""sharesA"": 0, ""secs_since_round_starts"": 173, ""market"": ""A""}",150.0,33.0,1.0,zzc584nm,vmu7c279,FULL STUDY,185.0,s1,1,100,,1,,1,,0,sell,0.5473882863317556,14,0,0,block 2 (G first),21.0,11.0,Male,1.0,1.0,0.0,"[4, 'block 2 (G first)']",0,1,0,0.5,7.0,-0.21666666666666667,0.16666666666666666,0.0,1.0,0.0,4,0.5,1.0,Design 1,Design 1,"Have an option between Design #1 and Design #2,",,3.0,3.0
2856,1133,4,Player object (1112),buy,2023-03-05 01:57:00.370215+00:00,"{""priceA"": 65, ""sharesA"": 1, ""secs_since_round_starts"": 198, ""market"": ""A""}",85.0,38.0,2.0,zzc584nm,vmu7c279,FULL STUDY,185.0,s1,1,65,100.0,-1,,1,sell,0,sell,0.4355009867455686,14,1,0,block 2 (G first),21.0,11.0,Male,1.0,1.0,0.0,"[4, 'block 2 (G first)']",0,1,0,0.5,7.0,-0.21666666666666667,0.16666666666666666,0.0,1.0,0.0,4,0.5,1.0,Design 1,Design 1,"Have an option between Design #1 and Design #2,",,3.0,3.0
2857,1134,4,Player object (1112),sell,2023-03-05 01:57:27.298159+00:00,"{""priceA"": 100, ""sharesA"": 0, ""secs_since_round_starts"": 225, ""market"": ""A""}",185.0,43.0,3.0,zzc584nm,vmu7c279,FULL STUDY,185.0,s1,1,100,65.0,1,35.0,1,buy,0,sell,0.5617190733230237,14,0,1,block 2 (G first),21.0,11.0,Male,1.0,1.0,0.0,"[4, 'block 2 (G first)']",0,1,0,0.5,7.0,-0.21666666666666667,0.16666666666666666,0.0,1.0,0.0,4,0.5,1.0,Design 1,Design 1,"Have an option between Design #1 and Design #2,",,3.0,3.0
2858,1135,4,Player object (1112),buy,2023-03-05 01:58:23.360111+00:00,"{""priceA"": 75, ""sharesA"": 1, ""secs_since_round_starts"": 281, ""market"": ""A""}",110.0,53.0,4.0,zzc584nm,vmu7c279,FULL STUDY,185.0,s1,1,75,100.0,-1,,1,sell,0,sell,0.4439854633835125,14,1,0,block 2 (G first),21.0,11.0,Male,1.0,1.0,0.0,"[4, 'block 2 (G first)']",0,1,0,0.5,7.0,-0.21666666666666667,0.16666666666666666,0.0,1.0,0.0,4,0.5,1.0,Design 1,Design 1,"Have an option between Design #1 and Design #2,",,3.0,3.0
2859,1139,5,Player object (1232),sell,2023-03-05 02:01:17.286806+00:00,"{""priceA"": 115, ""sharesA"": 0, ""secs_since_round_starts"": 130, ""market"": ""A""}",165.0,25.0,1.0,zzc584nm,vmu7c279,FULL STUDY,195.0,s1,1,115,,1,,1,,0,sell,0.5757035170695836,17,0,1,block 2 (G first),21.0,11.0,Male,1.0,1.0,0.0,"[5, 'block 2 (G first)']",0,0,0,0.5,7.0,-0.21666666666666667,0.375,0.0,0.6666666666666666,0.0,4,0.5,0.25,Design 1,Design 1,"Have an option between Design #1 and Design #2,",,3.0,3.0
2860,1141,5,Player object (1232),buy,2023-03-05 02:02:31.930425+00:00,"{""priceA"": 70, ""sharesA"": 1, ""secs_since_round_starts"": 204, ""market"": ""A""}",95.0,39.0,2.0,zzc584nm,vmu7c279,FULL STUDY,195.0,s1,1,70,115.0,-1,,1,sell,0,sell,0.4317803147869401,17,0,0,block 2 (G first),21.0,11.0,Male,1.0,1.0,0.0,"[5, 'block 2 (G first)']",0,0,0,0.5,7.0,-0.21666666666666667,0.375,0.0,0.6666666666666666,0.0,4,0.5,0.25,Design 1,Design 1,"Have an option between Design #1 and Design #2,",,3.0,3.0
2861,1142,5,Player object (1232),sell,2023-03-05 02:02:48.902682+00:00,"{""priceA"": 100, ""sharesA"": 0, ""secs_since_round_starts"": 221, ""market"": ""A""}",195.0,42.0,3.0,zzc584nm,vmu7c279,FULL STUDY,195.0,s1,1,100,70.0,1,30.0,1,buy,0,sell,0.5529358605422235,17,0,1,block 2 (G first),21.0,11.0,Male,1.0,1.0,0.0,"[5, 'block 2 (G first)']",0,0,0,0.5,7.0,-0.21666666666666667,0.375,0.0,0.6666666666666666,0.0,4,0.5,0.25,Design 1,Design 1,"Have an option between Design #1 and Design #2,",,3.0,3.0
2862,1143,5,Player object (1232),buy,2023-03-05 02:03:22.188615+00:00,"{""priceA"": 75, ""sharesA"": 1, ""secs_since_round_starts"": 255, ""market"": ""A""}",120.0,48.0,4.0,zzc584nm,vmu7c279,FULL STUDY,195.0,s1,1,75,100.0,-1,,1,sell,0,sell,0.4393932183506925,17,1,0,block 2 (G first),21.0,11.0,Male,1.0,1.0,0.0,"[5, 'block 2 (G first)']",0,0,0,0.5,7.0,-0.21666666666666667,0.375,0.0,0.6666666666666666,0.0,4,0.5,0.25,Design 1,Design 1,"Have an option between Design #1 and Design #2,",,3.0,3.0
2863,1144,5,Player object (1232),sell,2023-03-05 02:03:37.553987+00:00,"{""priceA"": 85, ""sharesA"": 0, ""secs_since_round_starts"": 270, ""market"": ""A""}",205.0,51.0,5.0,zzc584nm,vmu7c279,FULL STUDY,195.0,s1,1,85,75.0,1,10.0,1,buy,0,sell,0.5069151322589074,17,0,0,block 2 (G first),21.0,11.0,Male,1.0,1.0,0.0,"[5, 'block 2 (G first)']",0,0,0,0.5,7.0,-0.21666666666666667,0.375,0.0,0.6666666666666666,0.0,4,0.5,0.25,Design 1,Design 1,"Have an option between Design #1 and Design #2,",,3.0,3.0
2864,1145,5,Player object (1232),buy,2023-03-05 02:04:17.537388+00:00,"{""priceA"": 75, ""sharesA"": 1, ""secs_since_round_starts"": 310, ""market"": ""A""}",130.0,58.0,6.0,zzc584nm,vmu7c279,FULL STUDY,195.0,s1,1,75,85.0,-1,,1,sell,0,sell,0.4529558772574278,17,0,0,block 2 (G first),21.0,11.0,Male,1.0,1.0,0.0,"[5, 'block 2 (G first)']",0,0,0,0.5,7.0,-0.21666666666666667,0.375,0.0,0.6666666666666666,0.0,4,0.5,0.25,Design 1,Design 1,"Have an option between Design #1 and Design #2,",,3.0,3.0
